FECHA_CORTE,ANIO,COD_DPTO,NOM_DPTO,NOM_MUSEO,COD_MES,NOM_MES,COD_TIPO,ADU_BOLESPPAGANTES,EST_BOLESPPAGANTES,NIN_BOLESPPAGANTES,MIL_BOLESPPAGANTES,ADM_BOLESPPAGANTES,ADU_PAGANTES,EST_PAGANTES,NIN_PAGANTES,TOTAL_PAGANTES,ADU_BOLESPNOPAGANTES,EST_BOLESPNOPAGANTES,NIN_BOLESPNOPAGANTES,MIL_BOLESPNOPAGANTES,ADM_BOLESPNOPAGANTES,ADU_NOPAGANTES,EST_NOPAGANTES,NIN_NOPAGANTES,TOTAL_NOPAGANTES,TOTAL,TIPO_cat_cod
20240315,2021,1,Amazonas,Zona Arqueologica Monumental Kuelap,1,Enero,0,0,0,0,147,442,3492,975,1137,6193,0,0,0,24,47,291,132,84,578,6771,Sitio Arqueológico
20240315,2021,1,Amazonas,Zona Arqueologica Monumental Kuelap,1,Enero,1,0,0,0,0,0,38,0,4,42,0,0,0,0,0,0,0,0,0,42,Sitio Arqueológico
20240315,2021,1,Amazonas,Zona Arqueologica Monumental Kuelap,1,Enero,2,0,0,0,147,442,3530,975,1141,6235,0,0,0,24,47,291,132,84,578,6813,Sitio Arqueológico
20240315,2021,1,Amazonas,Zona Arqueologica Monumental Kuelap,2,Febrero,0,0,0,0,0,0,0,0,0,0,0,0,0,0,0,0,0,0,0,0,Sitio Arqueológico
20240315,2021,1,Amazonas,Zona Arqueologica Monumental Kuelap,2,Febrero,1,0,0,0,0,0,0,0,0,0,0,0,0,0,0,0,0,0,0,0,Sitio Arqueológico
20240315,2021,1,Amazonas,Zona Arqueologica Monumental Kuelap,2,Febrero,2,0,0,0,0,0,0,0,0,0,0,0,0,0,0,0,0,0,0,0,Sitio Arqueológico
20240315,2021,1,Amazonas,Zona Arqueologica Monumental Kuelap,3,Marzo,0,0,0,0,11,48,390,115,76,640,0,0,0,0,0,0,0,0,0,640,Sitio Arqueológico
20240315,2021,1,Amazonas,Zona Arqueologica Monumental Kuelap,3,Marzo,1,0,0,0,0,0,12,0,0,12,0,0,0,0,0,0,0,0,0,12,Sitio Arqueológico
20240315,2021,1,Amazonas,Zona Arqueologica Monumental Kuelap,3,Marzo,2,0,0,0,11,48,402,115,76,652,0,0,0,0,0,0,0,0,0,652,Sitio Arqueológico
20240315,2021,1,Amazonas,Zona Arqueologica Monumental Kuelap,4,Abril,0,0,0,0,46,76,717,115,61,1015,0,0,0,0,0,0,0,0,0,1015,Sitio Arqueológico
20240315,2021,1,Amazonas,Zona Arqueologica Monumental Kuelap,4,Abril,1,0,0,0,0,0,32,0,0,32,0,0,0,0,0,0,0,0,0,32,Sitio Arqueológico
20240315,2021,1,Amazonas,Zona Arqueologica Monumental Kuelap,4,Abril,2,0,0,0,46,76,749,115,61,1047,0,0,0,0,0,0,0,0,0,1047,Sitio Arqueológico
20240315,2021,1,Amazonas,Zona Arqueologica Monumental Kuelap,5,Mayo,0,0,0,0,85,191,1369,292,297,2234,0,0,0,4,6,47,12,10,79,2313,Sitio Arqueológico
20240315,2021,1,Amazonas,Zona Arqueologica Monumental Kuelap,5,Mayo,1,0,0,0,0,0,75,0,5,80,0,0,0,0,0,0,0,0,0,80,Sitio Arqueológico
20240315,2021,1,Amazonas,Zona Arqueologica Monumental Kuelap,5,Mayo,2,0,0,0,85,191,1444,292,302,2314,0,0,0,4,6,47,12,10,79,2393,Sitio Arqueológico
20240315,2021,1,Amazonas,Zona Arqueologica Monumental Kuelap,6,Junio,0,0,0,0,108,196,2081,430,438,3253,0,0,0,0,0,0,0,0,0,3253,Sitio Arqueológico
20240315,2021,1,Amazonas,Zona Arqueologica Monumental Kuelap,6,Junio,1,0,0,0,0,0,63,5,6,74,0,0,0,0,0,0,0,0,0,74,Sitio Arqueológico
20240315,2021,1,Amazonas,Zona Arqueologica Monumental Kuelap,6,Junio,2,0,0,0,108,196,2144,435,444,3327,0,0,0,0,0,0,0,0,0,3327,Sitio Arqueológico
20240315,2021,1,Amazonas,Zona Arqueologica Monumental Kuelap,7,Julio,0,0,0,0,216,654,5765,1498,1927,10060,0,0,0,7,16,188,31,21,263,10323,Sitio Arqueológico
20240315,2021,1,Amazonas,Zona Arqueologica Monumental Kuelap,7,Julio,1,0,0,0,0,0,142,2,10,154,0,0,0,0,0,0,0,0,0,154,Sitio Arqueológico
20240315,2021,1,Amazonas,Zona Arqueologica Monumental Kuelap,7,Julio,2,0,0,0,216,654,5907,1500,1937,10214,0,0,0,7,16,188,31,21,263,10477,Sitio Arqueológico
20240315,2021,1,Amazonas,Zona Arqueologica Monumental Kuelap,8,Agosto,0,0,0,0,271,864,5821,1712,1745,10413,0,0,0,0,0,0,0,0,0,10413,Sitio Arqueológico
20240315,2021,1,Amazonas,Zona Arqueologica Monumental Kuelap,8,Agosto,1,0,0,0,0,0,138,1,0,139,0,0,0,0,0,0,0,0,0,139,Sitio Arqueológico
20240315,2021,1,Amazonas,Zona Arqueologica Monumental Kuelap,8,Agosto,2,0,0,0,271,864,5959,1713,1745,10552,0,0,0,0,0,0,0,0,0,10552,Sitio Arqueológico
20240315,2021,1,Amazonas,Zona Arqueologica Monumental Kuelap,9,Setiembre,0,0,0,0,206,807,3933,846,796,6588,0,0,0,15,47,315,37,26,440,7028,Sitio Arqueológico
20240315,2021,1,Amazonas,Zona Arqueologica Monumental Kuelap,9,Setiembre,1,0,1,0,0,4,171,21,4,201,0,0,0,0,0,0,0,0,0,201,Sitio Arqueológico
20240315,2021,1,Amazonas,Zona Arqueologica Monumental Kuelap,9,Setiembre,2,0,1,0,206,811,4104,867,800,6789,0,0,0,15,47,315,37,26,440,7229,Sitio Arqueológico
20240315,2021,1,Amazonas,Zona Arqueologica Monumental Kuelap,10,Octubre,0,0,0,0,233,1079,4966,1109,1623,9010,0,0,0,16,79,388,142,47,672,9682,Sitio Arqueológico
20240315,2021,1,Amazonas,Zona Arqueologica Monumental Kuelap,10,Octubre,1,0,0,0,0,25,207,36,0,268,0,0,0,0,0,0,0,0,0,268,Sitio Arqueológico
20240315,2021,1,Amazonas,Zona Arqueologica Monumental Kuelap,10,Octubre,2,0,0,0,233,1104,5173,1145,1623,9278,0,0,0,16,79,388,142,47,672,9950,Sitio Arqueológico
20240315,2021,1,Amazonas,Zona Arqueologica Monumental Kuelap,11,Noviembre,0,0,0,0,161,594,2753,698,713,4919,0,0,0,0,0,0,0,0,0,4919,Sitio Arqueológico
20240315,2021,1,Amazonas,Zona Arqueologica Monumental Kuelap,11,Noviembre,1,0,0,0,0,6,183,25,8,222,0,0,0,0,0,0,0,0,0,222,Sitio Arqueológico
20240315,2021,1,Amazonas,Zona Arqueologica Monumental Kuelap,11,Noviembre,2,0,0,0,161,600,2936,723,721,5141,0,0,0,0,0,0,0,0,0,5141,Sitio Arqueológico
20240315,2021,1,Amazonas,Zona Arqueologica Monumental Kuelap,12,Diciembre,0,0,0,0,34,194,1035,285,307,1855,0,0,0,0,0,0,0,0,0,1855,Sitio Arqueológico
20240315,2021,1,Amazonas,Zona Arqueologica Monumental Kuelap,12,Diciembre,1,0,0,0,0,9,141,21,6,177,0,0,0,0,0,0,0,0,0,177,Sitio Arqueológico
20240315,2021,1,Amazonas,Zona Arqueologica Monumental Kuelap,12,Diciembre,2,0,0,0,34,203,1176,306,313,2032,0,0,0,0,0,0,0,0,0,2032,Sitio Arqueológico
20240315,2021,2,Ancash,Zona Arqueologica Monumental Chavin de Huantar,1,Enero,0,0,0,0,0,140,369,108,163,780,0,0,0,0,16,345,0,58,419,1199,Sitio Arqueológico
20240315,2021,2,Ancash,Zona Arqueologica Monumental Chavin de Huantar,1,Enero,1,0,0,0,0,0,17,0,1,18,0,0,0,0,0,0,0,0,0,18,Sitio Arqueológico
20240315,2021,2,Ancash,Zona Arqueologica Monumental Chavin de Huantar,1,Enero,2,0,0,0,0,140,386,108,164,798,0,0,0,0,16,345,0,58,419,1217,Sitio Arqueológico
20240315,2021,2,Ancash,Zona Arqueologica Monumental Chavin de Huantar,2,Febrero,0,0,0,0,0,0,0,0,0,0,0,0,0,0,0,0,0,0,0,0,Sitio Arqueológico
20240315,2021,2,Ancash,Zona Arqueologica Monumental Chavin de Huantar,2,Febrero,1,0,0,0,0,0,0,0,0,0,0,0,0,0,0,0,0,0,0,0,Sitio Arqueológico
20240315,2021,2,Ancash,Zona Arqueologica Monumental Chavin de Huantar,2,Febrero,2,0,0,0,0,0,0,0,0,0,0,0,0,0,0,0,0,0,0,0,Sitio Arqueológico
20240315,2021,2,Ancash,Zona Arqueologica Monumental Chavin de Huantar,3,Marzo,0,0,0,0,0,0,0,0,0,0,0,0,0,0,0,0,0,0,0,0,Sitio Arqueológico
20240315,2021,2,Ancash,Zona Arqueologica Monumental Chavin de Huantar,3,Marzo,1,0,0,0,0,0,0,0,0,0,0,0,0,0,0,0,0,0,0,0,Sitio Arqueológico
20240315,2021,2,Ancash,Zona Arqueologica Monumental Chavin de Huantar,3,Marzo,2,0,0,0,0,0,0,0,0,0,0,0,0,0,0,0,0,0,0,0,Sitio Arqueológico
20240315,2021,2,Ancash,Zona Arqueologica Monumental Chavin de Huantar,4,Abril,0,0,0,0,0,13,148,14,12,187,0,0,0,0,0,0,0,0,0,187,Sitio Arqueológico
20240315,2021,2,Ancash,Zona Arqueologica Monumental Chavin de Huantar,4,Abril,1,0,0,0,0,0,13,0,0,13,0,0,0,0,0,0,0,0,0,13,Sitio Arqueológico
20240315,2021,2,Ancash,Zona Arqueologica Monumental Chavin de Huantar,4,Abril,2,0,0,0,0,13,161,14,12,200,0,0,0,0,0,0,0,0,0,200,Sitio Arqueológico
20240315,2021,2,Ancash,Zona Arqueologica Monumental Chavin de Huantar,5,Mayo,0,0,0,0,0,66,890,91,192,1239,0,0,0,0,3,63,0,10,76,1315,Sitio Arqueológico
20240315,2021,2,Ancash,Zona Arqueologica Monumental Chavin de Huantar,5,Mayo,1,0,0,0,0,0,35,1,1,37,0,0,0,0,0,0,0,0,0,37,Sitio Arqueológico
20240315,2021,2,Ancash,Zona Arqueologica Monumental Chavin de Huantar,5,Mayo,2,0,0,0,0,66,925,92,193,1276,0,0,0,0,3,63,0,10,76,1352,Sitio Arqueológico
20240315,2021,2,Ancash,Zona Arqueologica Monumental Chavin de Huantar,6,Junio,0,0,0,0,0,85,1335,123,235,1778,0,0,0,0,1,41,0,5,47,1825,Sitio Arqueológico
20240315,2021,2,Ancash,Zona Arqueologica Monumental Chavin de Huantar,6,Junio,1,0,0,0,0,0,67,0,0,67,0,0,0,0,0,0,0,0,0,67,Sitio Arqueológico
20240315,2021,2,Ancash,Zona Arqueologica Monumental Chavin de Huantar,6,Junio,2,0,0,0,0,85,1402,123,235,1845,0,0,0,0,1,41,0,5,47,1892,Sitio Arqueológico
20240315,2021,2,Ancash,Zona Arqueologica Monumental Chavin de Huantar,7,Julio,0,0,0,0,0,365,4321,339,1311,6336,0,0,0,1,13,140,3,33,190,6526,Sitio Arqueológico
20240315,2021,2,Ancash,Zona Arqueologica Monumental Chavin de Huantar,7,Julio,1,0,0,0,0,0,35,0,0,35,0,0,0,0,0,0,0,0,0,35,Sitio Arqueológico
20240315,2021,2,Ancash,Zona Arqueologica Monumental Chavin de Huantar,7,Julio,2,0,0,0,0,365,4356,339,1311,6371,0,0,0,1,13,140,3,33,190,6561,Sitio Arqueológico
20240315,2021,2,Ancash,Zona Arqueologica Monumental Chavin de Huantar,8,Agosto,0,0,0,0,0,711,4756,336,1197,7000,0,0,0,6,53,569,8,229,865,7865,Sitio Arqueológico
20240315,2021,2,Ancash,Zona Arqueologica Monumental Chavin de Huantar,8,Agosto,1,0,0,0,0,0,45,0,0,45,0,0,0,0,0,0,0,0,0,45,Sitio Arqueológico
20240315,2021,2,Ancash,Zona Arqueologica Monumental Chavin de Huantar,8,Agosto,2,0,0,0,0,711,4801,336,1197,7045,0,0,0,6,53,569,8,229,865,7910,Sitio Arqueológico
20240315,2021,2,Ancash,Zona Arqueologica Monumental Chavin de Huantar,9,Setiembre,0,0,0,0,0,481,3891,384,666,5422,0,0,0,0,45,199,6,48,298,5720,Sitio Arqueológico
20240315,2021,2,Ancash,Zona Arqueologica Monumental Chavin de Huantar,9,Setiembre,1,0,0,0,0,0,68,3,0,71,0,0,0,0,0,0,0,0,0,71,Sitio Arqueológico
20240315,2021,2,Ancash,Zona Arqueologica Monumental Chavin de Huantar,9,Setiembre,2,0,0,0,0,481,3959,387,666,5493,0,0,0,0,45,199,6,48,298,5791,Sitio Arqueológico
20240315,2021,2,Ancash,Zona Arqueologica Monumental Chavin de Huantar,10,Octubre,0,0,0,0,0,840,6271,855,1606,9572,0,0,0,0,30,301,0,86,417,9989,Sitio Arqueológico
20240315,2021,2,Ancash,Zona Arqueologica Monumental Chavin de Huantar,10,Octubre,1,0,0,0,0,0,65,0,0,65,0,0,0,0,0,0,0,0,0,65,Sitio Arqueológico
20240315,2021,2,Ancash,Zona Arqueologica Monumental Chavin de Huantar,10,Octubre,2,0,0,0,0,840,6336,855,1606,9637,0,0,0,0,30,301,0,86,417,10054,Sitio Arqueológico
20240315,2021,2,Ancash,Zona Arqueologica Monumental Chavin de Huantar,11,Noviembre,0,0,0,0,0,358,2563,368,516,3805,0,0,0,0,24,331,16,132,503,4308,Sitio Arqueológico
20240315,2021,2,Ancash,Zona Arqueologica Monumental Chavin de Huantar,11,Noviembre,1,0,0,0,0,0,89,0,0,89,0,0,0,0,0,0,0,0,0,89,Sitio Arqueológico
20240315,2021,2,Ancash,Zona Arqueologica Monumental Chavin de Huantar,11,Noviembre,2,0,0,0,0,358,2652,368,516,3894,0,0,0,0,24,331,16,132,503,4397,Sitio Arqueológico
20240315,2021,2,Ancash,Zona Arqueologica Monumental Chavin de Huantar,12,Diciembre,0,0,0,0,0,152,1481,229,313,2175,0,0,0,0,51,747,7,270,1075,3250,Sitio Arqueológico
20240315,2021,2,Ancash,Zona Arqueologica Monumental Chavin de Huantar,12,Diciembre,1,0,0,0,0,0,103,0,2,105,0,0,0,0,0,0,0,0,0,105,Sitio Arqueológico
20240315,2021,2,Ancash,Zona Arqueologica Monumental Chavin de Huantar,12,Diciembre,2,0,0,0,0,152,1584,229,315,2280,0,0,0,0,51,747,7,270,1075,3355,Sitio Arqueológico
20240315,2021,2,Ancash,Sitio Arqueologico Pañamarca,1,Enero,0,0,0,0,0,0,0,0,0,0,0,0,0,0,0,0,0,0,0,0,Sitio Arqueológico
20240315,2021,2,Ancash,Sitio Arqueologico Pañamarca,1,Enero,1,0,0,0,0,0,0,0,0,0,0,0,0,0,0,0,0,0,0,0,Sitio Arqueológico
20240315,2021,2,Ancash,Sitio Arqueologico Pañamarca,1,Enero,2,0,0,0,0,0,0,0,0,0,0,0,0,0,0,0,0,0,0,0,Sitio Arqueológico
20240315,2021,2,Ancash,Sitio Arqueologico Pañamarca,2,Febrero,0,0,0,0,0,0,0,0,0,0,0,0,0,0,0,0,0,0,0,0,Sitio Arqueológico
20240315,2021,2,Ancash,Sitio Arqueologico Pañamarca,2,Febrero,1,0,0,0,0,0,0,0,0,0,0,0,0,0,0,0,0,0,0,0,Sitio Arqueológico
20240315,2021,2,Ancash,Sitio Arqueologico Pañamarca,2,Febrero,2,0,0,0,0,0,0,0,0,0,0,0,0,0,0,0,0,0,0,0,Sitio Arqueológico
20240315,2021,2,Ancash,Sitio Arqueologico Pañamarca,3,Marzo,0,0,0,0,0,0,0,0,0,0,0,0,0,0,0,0,0,0,0,0,Sitio Arqueológico
20240315,2021,2,Ancash,Sitio Arqueologico Pañamarca,3,Marzo,1,0,0,0,0,0,0,0,0,0,0,0,0,0,0,0,0,0,0,0,Sitio Arqueológico
20240315,2021,2,Ancash,Sitio Arqueologico Pañamarca,3,Marzo,2,0,0,0,0,0,0,0,0,0,0,0,0,0,0,0,0,0,0,0,Sitio Arqueológico
20240315,2021,2,Ancash,Sitio Arqueologico Pañamarca,4,Abril,0,0,0,0,0,0,31,1,14,46,0,0,0,0,0,0,0,0,0,46,Sitio Arqueológico
20240315,2021,2,Ancash,Sitio Arqueologico Pañamarca,4,Abril,1,0,0,0,0,0,0,0,0,0,0,0,0,0,0,0,0,0,0,0,Sitio Arqueológico
20240315,2021,2,Ancash,Sitio Arqueologico Pañamarca,4,Abril,2,0,0,0,0,0,31,1,14,46,0,0,0,0,0,0,0,0,0,46,Sitio Arqueológico
20240315,2021,2,Ancash,Sitio Arqueologico Pañamarca,5,Mayo,0,0,0,0,0,0,0,0,0,0,0,0,0,0,0,0,0,0,0,0,Sitio Arqueológico
20240315,2021,2,Ancash,Sitio Arqueologico Pañamarca,5,Mayo,1,0,0,0,0,0,0,0,0,0,0,0,0,0,0,0,0,0,0,0,Sitio Arqueológico
20240315,2021,2,Ancash,Sitio Arqueologico Pañamarca,5,Mayo,2,0,0,0,0,0,0,0,0,0,0,0,0,0,0,0,0,0,0,0,Sitio Arqueológico
20240315,2021,2,Ancash,Sitio Arqueologico Pañamarca,6,Junio,0,0,0,0,0,0,0,0,0,0,0,0,0,0,0,0,0,0,0,0,Sitio Arqueológico
20240315,2021,2,Ancash,Sitio Arqueologico Pañamarca,6,Junio,1,0,0,0,0,0,0,0,0,0,0,0,0,0,0,0,0,0,0,0,Sitio Arqueológico
20240315,2021,2,Ancash,Sitio Arqueologico Pañamarca,6,Junio,2,0,0,0,0,0,0,0,0,0,0,0,0,0,0,0,0,0,0,0,Sitio Arqueológico
20240315,2021,2,Ancash,Sitio Arqueologico Pañamarca,7,Julio,0,0,0,0,0,0,117,11,8,136,0,0,0,0,0,0,0,0,0,136,Sitio Arqueológico
20240315,2021,2,Ancash,Sitio Arqueologico Pañamarca,7,Julio,1,0,0,0,0,0,0,0,0,0,0,0,0,0,0,0,0,0,0,0,Sitio Arqueológico
20240315,2021,2,Ancash,Sitio Arqueologico Pañamarca,7,Julio,2,0,0,0,0,0,117,11,8,136,0,0,0,0,0,0,0,0,0,136,Sitio Arqueológico
20240315,2021,2,Ancash,Sitio Arqueologico Pañamarca,8,Agosto,0,0,0,0,0,0,90,12,3,105,0,0,0,0,0,5,0,5,10,115,Sitio Arqueológico
20240315,2021,2,Ancash,Sitio Arqueologico Pañamarca,8,Agosto,1,0,0,0,0,0,0,0,0,0,0,0,0,0,0,0,0,0,0,0,Sitio Arqueológico
20240315,2021,2,Ancash,Sitio Arqueologico Pañamarca,8,Agosto,2,0,0,0,0,0,90,12,3,105,0,0,0,0,0,5,0,5,10,115,Sitio Arqueológico
20240315,2021,2,Ancash,Sitio Arqueologico Pañamarca,9,Setiembre,0,0,0,0,0,0,110,15,0,125,0,0,0,0,0,0,0,0,0,125,Sitio Arqueológico
20240315,2021,2,Ancash,Sitio Arqueologico Pañamarca,9,Setiembre,1,0,0,0,0,0,0,0,0,0,0,0,0,0,0,0,0,0,0,0,Sitio Arqueológico
20240315,2021,2,Ancash,Sitio Arqueologico Pañamarca,9,Setiembre,2,0,0,0,0,0,110,15,0,125,0,0,0,0,0,0,0,0,0,125,Sitio Arqueológico
20240315,2021,2,Ancash,Sitio Arqueologico Pañamarca,10,Octubre,0,0,0,0,0,0,75,10,14,99,0,0,0,0,0,6,0,5,11,110,Sitio Arqueológico
20240315,2021,2,Ancash,Sitio Arqueologico Pañamarca,10,Octubre,1,0,0,0,0,0,0,0,0,0,0,0,0,0,0,0,0,0,0,0,Sitio Arqueológico
20240315,2021,2,Ancash,Sitio Arqueologico Pañamarca,10,Octubre,2,0,0,0,0,0,75,10,14,99,0,0,0,0,0,6,0,5,11,110,Sitio Arqueológico
20240315,2021,2,Ancash,Sitio Arqueologico Pañamarca,11,Noviembre,0,0,0,0,0,0,33,15,22,70,0,0,0,0,0,30,0,20,50,120,Sitio Arqueológico
20240315,2021,2,Ancash,Sitio Arqueologico Pañamarca,11,Noviembre,1,0,0,0,0,0,0,0,0,0,0,0,0,0,0,0,0,0,0,0,Sitio Arqueológico
20240315,2021,2,Ancash,Sitio Arqueologico Pañamarca,11,Noviembre,2,0,0,0,0,0,33,15,22,70,0,0,0,0,0,30,0,20,50,120,Sitio Arqueológico
20240315,2021,2,Ancash,Sitio Arqueologico Pañamarca,12,Diciembre,0,0,0,0,0,0,15,13,0,28,0,0,0,0,0,0,0,0,0,28,Sitio Arqueológico
20240315,2021,2,Ancash,Sitio Arqueologico Pañamarca,12,Diciembre,1,0,0,0,0,0,0,0,0,0,0,0,0,0,0,0,0,0,0,0,Sitio Arqueológico
20240315,2021,2,Ancash,Sitio Arqueologico Pañamarca,12,Diciembre,2,0,0,0,0,0,15,13,0,28,0,0,0,0,0,0,0,0,0,28,Sitio Arqueológico
20240315,2021,3,Apurimac,Sitio Arqueologico Saihuite,1,Enero,0,0,0,0,0,0,0,0,0,0,0,0,0,0,0,0,0,0,0,0,Sitio Arqueológico
20240315,2021,3,Apurimac,Sitio Arqueologico Saihuite,1,Enero,1,0,0,0,0,0,0,0,0,0,0,0,0,0,0,0,0,0,0,0,Sitio Arqueológico
20240315,2021,3,Apurimac,Sitio Arqueologico Saihuite,1,Enero,2,0,0,0,0,0,0,0,0,0,0,0,0,0,0,0,0,0,0,0,Sitio Arqueológico
20240315,2021,3,Apurimac,Sitio Arqueologico Saihuite,2,Febrero,0,0,0,0,0,0,0,0,0,0,0,0,0,0,0,0,0,0,0,0,Sitio Arqueológico
20240315,2021,3,Apurimac,Sitio Arqueologico Saihuite,2,Febrero,1,0,0,0,0,0,0,0,0,0,0,0,0,0,0,0,0,0,0,0,Sitio Arqueológico
20240315,2021,3,Apurimac,Sitio Arqueologico Saihuite,2,Febrero,2,0,0,0,0,0,0,0,0,0,0,0,0,0,0,0,0,0,0,0,Sitio Arqueológico
20240315,2021,3,Apurimac,Sitio Arqueologico Saihuite,3,Marzo,0,0,0,0,0,0,0,0,0,0,0,0,0,0,0,0,0,0,0,0,Sitio Arqueológico
20240315,2021,3,Apurimac,Sitio Arqueologico Saihuite,3,Marzo,1,0,0,0,0,0,0,0,0,0,0,0,0,0,0,0,0,0,0,0,Sitio Arqueológico
20240315,2021,3,Apurimac,Sitio Arqueologico Saihuite,3,Marzo,2,0,0,0,0,0,0,0,0,0,0,0,0,0,0,0,0,0,0,0,Sitio Arqueológico
20240315,2021,3,Apurimac,Sitio Arqueologico Saihuite,4,Abril,0,0,0,0,0,0,0,0,0,0,0,0,0,0,0,0,0,0,0,0,Sitio Arqueológico
20240315,2021,3,Apurimac,Sitio Arqueologico Saihuite,4,Abril,1,0,0,0,0,0,0,0,0,0,0,0,0,0,0,0,0,0,0,0,Sitio Arqueológico
20240315,2021,3,Apurimac,Sitio Arqueologico Saihuite,4,Abril,2,0,0,0,0,0,0,0,0,0,0,0,0,0,0,0,0,0,0,0,Sitio Arqueológico
20240315,2021,3,Apurimac,Sitio Arqueologico Saihuite,5,Mayo,0,0,0,0,0,0,0,0,0,0,0,0,0,0,0,0,0,0,0,0,Sitio Arqueológico
20240315,2021,3,Apurimac,Sitio Arqueologico Saihuite,5,Mayo,1,0,0,0,0,0,0,0,0,0,0,0,0,0,0,0,0,0,0,0,Sitio Arqueológico
20240315,2021,3,Apurimac,Sitio Arqueologico Saihuite,5,Mayo,2,0,0,0,0,0,0,0,0,0,0,0,0,0,0,0,0,0,0,0,Sitio Arqueológico
20240315,2021,3,Apurimac,Sitio Arqueologico Saihuite,6,Junio,0,0,0,0,0,0,0,0,0,0,0,0,0,0,0,0,0,0,0,0,Sitio Arqueológico
20240315,2021,3,Apurimac,Sitio Arqueologico Saihuite,6,Junio,1,0,0,0,0,0,0,0,0,0,0,0,0,0,0,0,0,0,0,0,Sitio Arqueológico
20240315,2021,3,Apurimac,Sitio Arqueologico Saihuite,6,Junio,2,0,0,0,0,0,0,0,0,0,0,0,0,0,0,0,0,0,0,0,Sitio Arqueológico
20240315,2021,3,Apurimac,Sitio Arqueologico Saihuite,7,Julio,0,0,0,0,0,0,166,119,41,326,0,0,0,0,0,46,16,15,77,403,Sitio Arqueológico
20240315,2021,3,Apurimac,Sitio Arqueologico Saihuite,7,Julio,1,0,0,0,0,0,0,0,0,0,0,0,0,0,0,0,0,0,0,0,Sitio Arqueológico
20240315,2021,3,Apurimac,Sitio Arqueologico Saihuite,7,Julio,2,0,0,0,0,0,166,119,41,326,0,0,0,0,0,46,16,15,77,403,Sitio Arqueológico
20240315,2021,3,Apurimac,Sitio Arqueologico Saihuite,8,Agosto,0,0,0,0,0,0,172,129,60,361,0,0,0,0,0,59,28,18,105,466,Sitio Arqueológico
20240315,2021,3,Apurimac,Sitio Arqueologico Saihuite,8,Agosto,1,0,0,0,0,0,0,0,0,0,0,0,0,0,0,0,0,0,0,0,Sitio Arqueológico
20240315,2021,3,Apurimac,Sitio Arqueologico Saihuite,8,Agosto,2,0,0,0,0,0,172,129,60,361,0,0,0,0,0,59,28,18,105,466,Sitio Arqueológico
20240315,2021,3,Apurimac,Sitio Arqueologico Saihuite,9,Setiembre,0,0,0,0,0,0,93,110,47,250,0,0,0,0,0,29,45,15,89,339,Sitio Arqueológico
20240315,2021,3,Apurimac,Sitio Arqueologico Saihuite,9,Setiembre,1,0,0,0,0,0,0,0,0,0,0,0,0,0,0,0,0,0,0,0,Sitio Arqueológico
20240315,2021,3,Apurimac,Sitio Arqueologico Saihuite,9,Setiembre,2,0,0,0,0,0,93,110,47,250,0,0,0,0,0,29,45,15,89,339,Sitio Arqueológico
20240315,2021,3,Apurimac,Sitio Arqueologico Saihuite,10,Octubre,0,0,0,0,0,0,166,151,21,338,0,0,0,0,9,29,21,9,68,406,Sitio Arqueológico
20240315,2021,3,Apurimac,Sitio Arqueologico Saihuite,10,Octubre,1,0,0,0,0,0,0,0,0,0,0,0,0,0,0,0,0,0,0,0,Sitio Arqueológico
20240315,2021,3,Apurimac,Sitio Arqueologico Saihuite,10,Octubre,2,0,0,0,0,0,166,151,21,338,0,0,0,0,9,29,21,9,68,406,Sitio Arqueológico
20240315,2021,3,Apurimac,Sitio Arqueologico Saihuite,11,Noviembre,0,0,0,0,0,0,199,149,50,398,0,0,0,0,5,4,2,7,18,416,Sitio Arqueológico
20240315,2021,3,Apurimac,Sitio Arqueologico Saihuite,11,Noviembre,1,0,0,0,0,0,0,0,0,0,0,0,0,0,0,0,0,0,0,0,Sitio Arqueológico
20240315,2021,3,Apurimac,Sitio Arqueologico Saihuite,11,Noviembre,2,0,0,0,0,0,199,149,50,398,0,0,0,0,5,4,2,7,18,416,Sitio Arqueológico
20240315,2021,3,Apurimac,Sitio Arqueologico Saihuite,12,Diciembre,0,0,0,0,0,0,0,0,0,0,0,0,0,0,4,15,13,5,37,37,Sitio Arqueológico
20240315,2021,3,Apurimac,Sitio Arqueologico Saihuite,12,Diciembre,1,0,0,0,0,0,0,0,0,0,0,0,0,0,0,0,0,0,0,0,Sitio Arqueológico
20240315,2021,3,Apurimac,Sitio Arqueologico Saihuite,12,Diciembre,2,0,0,0,0,0,0,0,0,0,0,0,0,0,4,15,13,5,37,37,Sitio Arqueológico
20240315,2021,4,Arequipa,Complejo Arqueologico Toro Muerto,1,Enero,0,0,0,0,0,0,81,6,20,107,0,0,0,0,0,0,0,0,0,107,Sitio Arqueológico
20240315,2021,4,Arequipa,Complejo Arqueologico Toro Muerto,1,Enero,1,0,0,0,0,0,0,0,0,0,0,0,0,0,0,0,0,0,0,0,Sitio Arqueológico
20240315,2021,4,Arequipa,Complejo Arqueologico Toro Muerto,1,Enero,2,0,0,0,0,0,81,6,20,107,0,0,0,0,0,0,0,0,0,107,Sitio Arqueológico
20240315,2021,4,Arequipa,Complejo Arqueologico Toro Muerto,2,Febrero,0,0,0,0,0,0,0,0,0,0,0,0,0,0,0,0,0,0,0,0,Sitio Arqueológico
20240315,2021,4,Arequipa,Complejo Arqueologico Toro Muerto,2,Febrero,1,0,0,0,0,0,0,0,0,0,0,0,0,0,0,0,0,0,0,0,Sitio Arqueológico
20240315,2021,4,Arequipa,Complejo Arqueologico Toro Muerto,2,Febrero,2,0,0,0,0,0,0,0,0,0,0,0,0,0,0,0,0,0,0,0,Sitio Arqueológico
20240315,2021,4,Arequipa,Complejo Arqueologico Toro Muerto,3,Marzo,0,0,0,0,0,0,0,0,0,0,0,0,0,0,0,0,0,0,0,0,Sitio Arqueológico
20240315,2021,4,Arequipa,Complejo Arqueologico Toro Muerto,3,Marzo,1,0,0,0,0,0,0,0,0,0,0,0,0,0,0,0,0,0,0,0,Sitio Arqueológico
20240315,2021,4,Arequipa,Complejo Arqueologico Toro Muerto,3,Marzo,2,0,0,0,0,0,0,0,0,0,0,0,0,0,0,0,0,0,0,0,Sitio Arqueológico
20240315,2021,4,Arequipa,Complejo Arqueologico Toro Muerto,4,Abril,0,0,0,0,0,0,0,0,0,0,0,0,0,0,0,0,0,0,0,0,Sitio Arqueológico
20240315,2021,4,Arequipa,Complejo Arqueologico Toro Muerto,4,Abril,1,0,0,0,0,0,0,0,0,0,0,0,0,0,0,0,0,0,0,0,Sitio Arqueológico
20240315,2021,4,Arequipa,Complejo Arqueologico Toro Muerto,4,Abril,2,0,0,0,0,0,0,0,0,0,0,0,0,0,0,0,0,0,0,0,Sitio Arqueológico
20240315,2021,4,Arequipa,Complejo Arqueologico Toro Muerto,5,Mayo,0,0,0,0,0,0,0,0,0,0,0,0,0,0,0,0,0,0,0,0,Sitio Arqueológico
20240315,2021,4,Arequipa,Complejo Arqueologico Toro Muerto,5,Mayo,1,0,0,0,0,0,0,0,0,0,0,0,0,0,0,0,0,0,0,0,Sitio Arqueológico
20240315,2021,4,Arequipa,Complejo Arqueologico Toro Muerto,5,Mayo,2,0,0,0,0,0,0,0,0,0,0,0,0,0,0,0,0,0,0,0,Sitio Arqueológico
20240315,2021,4,Arequipa,Complejo Arqueologico Toro Muerto,6,Junio,0,0,0,0,0,0,0,0,0,0,0,0,0,0,0,0,0,0,0,0,Sitio Arqueológico
20240315,2021,4,Arequipa,Complejo Arqueologico Toro Muerto,6,Junio,1,0,0,0,0,0,0,0,0,0,0,0,0,0,0,0,0,0,0,0,Sitio Arqueológico
20240315,2021,4,Arequipa,Complejo Arqueologico Toro Muerto,6,Junio,2,0,0,0,0,0,0,0,0,0,0,0,0,0,0,0,0,0,0,0,Sitio Arqueológico
20240315,2021,4,Arequipa,Complejo Arqueologico Toro Muerto,7,Julio,0,0,0,0,0,0,0,0,0,0,0,0,0,0,0,0,0,0,0,0,Sitio Arqueológico
20240315,2021,4,Arequipa,Complejo Arqueologico Toro Muerto,7,Julio,1,0,0,0,0,0,0,0,0,0,0,0,0,0,0,0,0,0,0,0,Sitio Arqueológico
20240315,2021,4,Arequipa,Complejo Arqueologico Toro Muerto,7,Julio,2,0,0,0,0,0,0,0,0,0,0,0,0,0,0,0,0,0,0,0,Sitio Arqueológico
20240315,2021,4,Arequipa,Complejo Arqueologico Toro Muerto,8,Agosto,0,0,0,0,0,0,147,41,48,236,0,0,0,0,0,0,0,0,0,236,Sitio Arqueológico
20240315,2021,4,Arequipa,Complejo Arqueologico Toro Muerto,8,Agosto,1,0,0,0,0,0,0,0,0,0,0,0,0,0,0,0,0,0,0,0,Sitio Arqueológico
20240315,2021,4,Arequipa,Complejo Arqueologico Toro Muerto,8,Agosto,2,0,0,0,0,0,147,41,48,236,0,0,0,0,0,0,0,0,0,236,Sitio Arqueológico
20240315,2021,4,Arequipa,Complejo Arqueologico Toro Muerto,9,Setiembre,0,0,0,0,0,0,163,29,28,220,0,0,0,0,0,0,0,0,0,220,Sitio Arqueológico
20240315,2021,4,Arequipa,Complejo Arqueologico Toro Muerto,9,Setiembre,1,0,0,0,0,0,0,0,0,0,0,0,0,0,0,0,0,0,0,0,Sitio Arqueológico
20240315,2021,4,Arequipa,Complejo Arqueologico Toro Muerto,9,Setiembre,2,0,0,0,0,0,163,29,28,220,0,0,0,0,0,0,0,0,0,220,Sitio Arqueológico
20240315,2021,4,Arequipa,Complejo Arqueologico Toro Muerto,10,Octubre,0,0,0,0,0,0,203,31,82,316,0,0,0,0,0,0,0,0,0,316,Sitio Arqueológico
20240315,2021,4,Arequipa,Complejo Arqueologico Toro Muerto,10,Octubre,1,0,0,0,0,0,0,0,0,0,0,0,0,0,0,0,0,0,0,0,Sitio Arqueológico
20240315,2021,4,Arequipa,Complejo Arqueologico Toro Muerto,10,Octubre,2,0,0,0,0,0,203,31,82,316,0,0,0,0,0,0,0,0,0,316,Sitio Arqueológico
20240315,2021,4,Arequipa,Complejo Arqueologico Toro Muerto,11,Noviembre,0,0,0,0,0,0,199,20,23,242,0,0,0,0,0,0,0,0,0,242,Sitio Arqueológico
20240315,2021,4,Arequipa,Complejo Arqueologico Toro Muerto,11,Noviembre,1,0,0,0,0,0,0,0,0,0,0,0,0,0,0,0,0,0,0,0,Sitio Arqueológico
20240315,2021,4,Arequipa,Complejo Arqueologico Toro Muerto,11,Noviembre,2,0,0,0,0,0,199,20,23,242,0,0,0,0,0,0,0,0,0,242,Sitio Arqueológico
20240315,2021,4,Arequipa,Complejo Arqueologico Toro Muerto,12,Diciembre,0,0,0,0,0,0,120,19,31,170,0,0,0,0,0,0,0,0,0,170,Sitio Arqueológico
20240315,2021,4,Arequipa,Complejo Arqueologico Toro Muerto,12,Diciembre,1,0,0,0,0,0,0,0,0,0,0,0,0,0,0,0,0,0,0,0,Sitio Arqueológico
20240315,2021,4,Arequipa,Complejo Arqueologico Toro Muerto,12,Diciembre,2,0,0,0,0,0,120,19,31,170,0,0,0,0,0,0,0,0,0,170,Sitio Arqueológico
20240315,2021,4,Arequipa,Complejo Arqueologico de Uyo Uyo,1,Enero,0,0,0,0,0,0,0,0,0,0,0,0,0,0,0,0,0,0,0,0,Sitio Arqueológico
20240315,2021,4,Arequipa,Complejo Arqueologico de Uyo Uyo,1,Enero,1,0,0,0,0,0,0,0,0,0,0,0,0,0,0,0,0,0,0,0,Sitio Arqueológico
20240315,2021,4,Arequipa,Complejo Arqueologico de Uyo Uyo,1,Enero,2,0,0,0,0,0,0,0,0,0,0,0,0,0,0,0,0,0,0,0,Sitio Arqueológico
20240315,2021,4,Arequipa,Complejo Arqueologico de Uyo Uyo,2,Febrero,0,0,0,0,0,0,0,0,0,0,0,0,0,0,0,0,0,0,0,0,Sitio Arqueológico
20240315,2021,4,Arequipa,Complejo Arqueologico de Uyo Uyo,2,Febrero,1,0,0,0,0,0,0,0,0,0,0,0,0,0,0,0,0,0,0,0,Sitio Arqueológico
20240315,2021,4,Arequipa,Complejo Arqueologico de Uyo Uyo,2,Febrero,2,0,0,0,0,0,0,0,0,0,0,0,0,0,0,0,0,0,0,0,Sitio Arqueológico
20240315,2021,4,Arequipa,Complejo Arqueologico de Uyo Uyo,3,Marzo,0,0,0,0,0,0,0,0,0,0,0,0,0,0,0,0,0,0,0,0,Sitio Arqueológico
20240315,2021,4,Arequipa,Complejo Arqueologico de Uyo Uyo,3,Marzo,1,0,0,0,0,0,0,0,0,0,0,0,0,0,0,0,0,0,0,0,Sitio Arqueológico
20240315,2021,4,Arequipa,Complejo Arqueologico de Uyo Uyo,3,Marzo,2,0,0,0,0,0,0,0,0,0,0,0,0,0,0,0,0,0,0,0,Sitio Arqueológico
20240315,2021,4,Arequipa,Complejo Arqueologico de Uyo Uyo,4,Abril,0,0,0,0,0,0,0,0,0,0,0,0,0,0,0,0,0,0,0,0,Sitio Arqueológico
20240315,2021,4,Arequipa,Complejo Arqueologico de Uyo Uyo,4,Abril,1,0,0,0,0,0,0,0,0,0,0,0,0,0,0,0,0,0,0,0,Sitio Arqueológico
20240315,2021,4,Arequipa,Complejo Arqueologico de Uyo Uyo,4,Abril,2,0,0,0,0,0,0,0,0,0,0,0,0,0,0,0,0,0,0,0,Sitio Arqueológico
20240315,2021,4,Arequipa,Complejo Arqueologico de Uyo Uyo,5,Mayo,0,0,0,0,0,0,0,0,0,0,0,0,0,0,0,0,0,0,0,0,Sitio Arqueológico
20240315,2021,4,Arequipa,Complejo Arqueologico de Uyo Uyo,5,Mayo,1,0,0,0,0,0,0,0,0,0,0,0,0,0,0,0,0,0,0,0,Sitio Arqueológico
20240315,2021,4,Arequipa,Complejo Arqueologico de Uyo Uyo,5,Mayo,2,0,0,0,0,0,0,0,0,0,0,0,0,0,0,0,0,0,0,0,Sitio Arqueológico
20240315,2021,4,Arequipa,Complejo Arqueologico de Uyo Uyo,6,Junio,0,0,0,0,0,0,0,0,0,0,0,0,0,0,0,0,0,0,0,0,Sitio Arqueológico
20240315,2021,4,Arequipa,Complejo Arqueologico de Uyo Uyo,6,Junio,1,0,0,0,0,0,0,0,0,0,0,0,0,0,0,0,0,0,0,0,Sitio Arqueológico
20240315,2021,4,Arequipa,Complejo Arqueologico de Uyo Uyo,6,Junio,2,0,0,0,0,0,0,0,0,0,0,0,0,0,0,0,0,0,0,0,Sitio Arqueológico
20240315,2021,4,Arequipa,Complejo Arqueologico de Uyo Uyo,7,Julio,0,0,0,0,0,0,0,0,0,0,0,0,0,0,0,0,0,0,0,0,Sitio Arqueológico
20240315,2021,4,Arequipa,Complejo Arqueologico de Uyo Uyo,7,Julio,1,0,0,0,0,0,0,0,0,0,0,0,0,0,0,0,0,0,0,0,Sitio Arqueológico
20240315,2021,4,Arequipa,Complejo Arqueologico de Uyo Uyo,7,Julio,2,0,0,0,0,0,0,0,0,0,0,0,0,0,0,0,0,0,0,0,Sitio Arqueológico
20240315,2021,4,Arequipa,Complejo Arqueologico de Uyo Uyo,8,Agosto,0,0,0,0,0,0,0,0,0,0,0,0,0,0,0,0,0,0,0,0,Sitio Arqueológico
20240315,2021,4,Arequipa,Complejo Arqueologico de Uyo Uyo,8,Agosto,1,0,0,0,0,0,0,0,0,0,0,0,0,0,0,0,0,0,0,0,Sitio Arqueológico
20240315,2021,4,Arequipa,Complejo Arqueologico de Uyo Uyo,8,Agosto,2,0,0,0,0,0,0,0,0,0,0,0,0,0,0,0,0,0,0,0,Sitio Arqueológico
20240315,2021,4,Arequipa,Complejo Arqueologico de Uyo Uyo,9,Setiembre,0,0,0,0,0,0,16,0,0,16,0,0,0,0,0,0,0,0,0,16,Sitio Arqueológico
20240315,2021,4,Arequipa,Complejo Arqueologico de Uyo Uyo,9,Setiembre,1,0,0,0,0,0,0,0,0,0,0,0,0,0,0,0,0,0,0,0,Sitio Arqueológico
20240315,2021,4,Arequipa,Complejo Arqueologico de Uyo Uyo,9,Setiembre,2,0,0,0,0,0,16,0,0,16,0,0,0,0,0,0,0,0,0,16,Sitio Arqueológico
20240315,2021,4,Arequipa,Complejo Arqueologico de Uyo Uyo,10,Octubre,0,0,0,0,0,0,34,0,0,34,0,0,0,0,0,0,0,0,0,34,Sitio Arqueológico
20240315,2021,4,Arequipa,Complejo Arqueologico de Uyo Uyo,10,Octubre,1,0,0,0,0,0,0,0,0,0,0,0,0,0,0,0,0,0,0,0,Sitio Arqueológico
20240315,2021,4,Arequipa,Complejo Arqueologico de Uyo Uyo,10,Octubre,2,0,0,0,0,0,34,0,0,34,0,0,0,0,0,0,0,0,0,34,Sitio Arqueológico
20240315,2021,4,Arequipa,Complejo Arqueologico de Uyo Uyo,11,Noviembre,0,0,0,0,0,0,19,0,0,19,0,0,0,0,0,0,0,0,0,19,Sitio Arqueológico
20240315,2021,4,Arequipa,Complejo Arqueologico de Uyo Uyo,11,Noviembre,1,0,0,0,0,0,0,0,0,0,0,0,0,0,0,0,0,0,0,0,Sitio Arqueológico
20240315,2021,4,Arequipa,Complejo Arqueologico de Uyo Uyo,11,Noviembre,2,0,0,0,0,0,19,0,0,19,0,0,0,0,0,0,0,0,0,19,Sitio Arqueológico
20240315,2021,4,Arequipa,Complejo Arqueologico de Uyo Uyo,12,Diciembre,0,0,0,0,0,0,22,11,0,33,0,0,0,0,0,0,0,0,0,33,Sitio Arqueológico
20240315,2021,4,Arequipa,Complejo Arqueologico de Uyo Uyo,12,Diciembre,1,0,0,0,0,0,0,0,0,0,0,0,0,0,0,0,0,0,0,0,Sitio Arqueológico
20240315,2021,4,Arequipa,Complejo Arqueologico de Uyo Uyo,12,Diciembre,2,0,0,0,0,0,22,11,0,33,0,0,0,0,0,0,0,0,0,33,Sitio Arqueológico
20240315,2021,5,Ayacucho,Sitio Arqueologico Intihuatana,1,Enero,0,0,0,0,0,0,276,64,36,376,0,0,0,0,0,0,0,0,0,376,Sitio Arqueológico
20240315,2021,5,Ayacucho,Sitio Arqueologico Intihuatana,1,Enero,1,0,0,0,0,0,0,0,0,0,0,0,0,0,0,0,0,0,0,0,Sitio Arqueológico
20240315,2021,5,Ayacucho,Sitio Arqueologico Intihuatana,1,Enero,2,0,0,0,0,0,276,64,36,376,0,0,0,0,0,0,0,0,0,376,Sitio Arqueológico
20240315,2021,5,Ayacucho,Sitio Arqueologico Intihuatana,2,Febrero,0,0,0,0,0,0,0,0,0,0,0,0,0,0,0,0,0,0,0,0,Sitio Arqueológico
20240315,2021,5,Ayacucho,Sitio Arqueologico Intihuatana,2,Febrero,1,0,0,0,0,0,0,0,0,0,0,0,0,0,0,0,0,0,0,0,Sitio Arqueológico
20240315,2021,5,Ayacucho,Sitio Arqueologico Intihuatana,2,Febrero,2,0,0,0,0,0,0,0,0,0,0,0,0,0,0,0,0,0,0,0,Sitio Arqueológico
20240315,2021,5,Ayacucho,Sitio Arqueologico Intihuatana,3,Marzo,0,0,0,0,0,0,484,174,38,696,0,0,0,0,0,0,0,0,0,696,Sitio Arqueológico
20240315,2021,5,Ayacucho,Sitio Arqueologico Intihuatana,3,Marzo,1,0,0,0,0,0,0,0,0,0,0,0,0,0,0,0,0,0,0,0,Sitio Arqueológico
20240315,2021,5,Ayacucho,Sitio Arqueologico Intihuatana,3,Marzo,2,0,0,0,0,0,484,174,38,696,0,0,0,0,0,0,0,0,0,696,Sitio Arqueológico
20240315,2021,5,Ayacucho,Sitio Arqueologico Intihuatana,4,Abril,0,0,0,0,0,0,545,182,45,772,0,0,0,0,0,0,0,0,0,772,Sitio Arqueológico
20240315,2021,5,Ayacucho,Sitio Arqueologico Intihuatana,4,Abril,1,0,0,0,0,0,0,0,0,0,0,0,0,0,0,0,0,0,0,0,Sitio Arqueológico
20240315,2021,5,Ayacucho,Sitio Arqueologico Intihuatana,4,Abril,2,0,0,0,0,0,545,182,45,772,0,0,0,0,0,0,0,0,0,772,Sitio Arqueológico
20240315,2021,5,Ayacucho,Sitio Arqueologico Intihuatana,5,Mayo,0,0,0,0,0,0,1048,322,55,1425,0,0,0,0,0,80,62,2,144,1569,Sitio Arqueológico
20240315,2021,5,Ayacucho,Sitio Arqueologico Intihuatana,5,Mayo,1,0,0,0,0,0,0,0,0,0,0,0,0,0,0,0,0,0,0,0,Sitio Arqueológico
20240315,2021,5,Ayacucho,Sitio Arqueologico Intihuatana,5,Mayo,2,0,0,0,0,0,1048,322,55,1425,0,0,0,0,0,80,62,2,144,1569,Sitio Arqueológico
20240315,2021,5,Ayacucho,Sitio Arqueologico Intihuatana,6,Junio,0,0,0,0,0,0,499,1082,22,1603,0,0,0,0,0,141,23,2,166,1769,Sitio Arqueológico
20240315,2021,5,Ayacucho,Sitio Arqueologico Intihuatana,6,Junio,1,0,0,0,0,0,0,0,0,0,0,0,0,0,0,0,0,0,0,0,Sitio Arqueológico
20240315,2021,5,Ayacucho,Sitio Arqueologico Intihuatana,6,Junio,2,0,0,0,0,0,499,1082,22,1603,0,0,0,0,0,141,23,2,166,1769,Sitio Arqueológico
20240315,2021,5,Ayacucho,Sitio Arqueologico Intihuatana,7,Julio,0,0,0,0,0,0,2645,742,266,3653,0,0,0,0,0,360,59,30,449,4102,Sitio Arqueológico
20240315,2021,5,Ayacucho,Sitio Arqueologico Intihuatana,7,Julio,1,0,0,0,0,0,0,0,0,0,0,0,0,0,0,0,0,0,0,0,Sitio Arqueológico
20240315,2021,5,Ayacucho,Sitio Arqueologico Intihuatana,7,Julio,2,0,0,0,0,0,2645,742,266,3653,0,0,0,0,0,360,59,30,449,4102,Sitio Arqueológico
20240315,2021,5,Ayacucho,Sitio Arqueologico Intihuatana,8,Agosto,0,0,0,0,0,0,1783,2865,316,4964,0,0,0,0,0,377,43,29,449,5413,Sitio Arqueológico
20240315,2021,5,Ayacucho,Sitio Arqueologico Intihuatana,8,Agosto,1,0,0,0,0,0,0,0,0,0,0,0,0,0,0,0,0,0,0,0,Sitio Arqueológico
20240315,2021,5,Ayacucho,Sitio Arqueologico Intihuatana,8,Agosto,2,0,0,0,0,0,1783,2865,316,4964,0,0,0,0,0,377,43,29,449,5413,Sitio Arqueológico
20240315,2021,5,Ayacucho,Sitio Arqueologico Intihuatana,9,Setiembre,0,0,0,0,0,0,0,2684,176,2860,0,0,0,0,0,172,24,13,209,3069,Sitio Arqueológico
20240315,2021,5,Ayacucho,Sitio Arqueologico Intihuatana,9,Setiembre,1,0,0,0,0,0,0,0,0,0,0,0,0,0,0,0,0,0,0,0,Sitio Arqueológico
20240315,2021,5,Ayacucho,Sitio Arqueologico Intihuatana,9,Setiembre,2,0,0,0,0,0,0,2684,176,2860,0,0,0,0,0,172,24,13,209,3069,Sitio Arqueológico
20240315,2021,5,Ayacucho,Sitio Arqueologico Intihuatana,10,Octubre,0,0,0,0,0,0,0,3704,348,4052,0,0,0,0,0,147,25,23,195,4247,Sitio Arqueológico
20240315,2021,5,Ayacucho,Sitio Arqueologico Intihuatana,10,Octubre,1,0,0,0,0,0,0,0,0,0,0,0,0,0,0,0,0,0,0,0,Sitio Arqueológico
20240315,2021,5,Ayacucho,Sitio Arqueologico Intihuatana,10,Octubre,2,0,0,0,0,0,0,3704,348,4052,0,0,0,0,0,147,25,23,195,4247,Sitio Arqueológico
20240315,2021,5,Ayacucho,Sitio Arqueologico Intihuatana,11,Noviembre,0,0,0,0,0,0,0,98,294,392,0,0,0,0,0,147,19,6,172,564,Sitio Arqueológico
20240315,2021,5,Ayacucho,Sitio Arqueologico Intihuatana,11,Noviembre,1,0,0,0,0,0,0,0,0,0,0,0,0,0,0,0,0,0,0,0,Sitio Arqueológico
20240315,2021,5,Ayacucho,Sitio Arqueologico Intihuatana,11,Noviembre,2,0,0,0,0,0,0,98,294,392,0,0,0,0,0,147,19,6,172,564,Sitio Arqueológico
20240315,2021,5,Ayacucho,Sitio Arqueologico Intihuatana,12,Diciembre,0,0,0,0,0,0,1421,628,107,2156,0,0,0,0,0,0,0,0,0,2156,Sitio Arqueológico
20240315,2021,5,Ayacucho,Sitio Arqueologico Intihuatana,12,Diciembre,1,0,0,0,0,0,0,0,0,0,0,0,0,0,0,75,7,5,87,87,Sitio Arqueológico
20240315,2021,5,Ayacucho,Sitio Arqueologico Intihuatana,12,Diciembre,2,0,0,0,0,0,1421,628,107,2156,0,0,0,0,0,75,7,5,87,2243,Sitio Arqueológico
20240315,2021,6,Cajamarca,Paisaje Cultural Arqueologico Cumbemayo,1,Enero,0,0,0,0,0,0,839,334,206,1379,0,0,0,0,0,0,0,0,0,1379,Sitio Arqueológico
20240315,2021,6,Cajamarca,Paisaje Cultural Arqueologico Cumbemayo,1,Enero,1,0,0,0,0,0,0,0,0,0,0,0,0,0,0,0,0,0,0,0,Sitio Arqueológico
20240315,2021,6,Cajamarca,Paisaje Cultural Arqueologico Cumbemayo,1,Enero,2,0,0,0,0,0,839,334,206,1379,0,0,0,0,0,0,0,0,0,1379,Sitio Arqueológico
20240315,2021,6,Cajamarca,Paisaje Cultural Arqueologico Cumbemayo,2,Febrero,0,0,0,0,0,0,0,0,0,0,0,0,0,0,0,0,0,0,0,0,Sitio Arqueológico
20240315,2021,6,Cajamarca,Paisaje Cultural Arqueologico Cumbemayo,2,Febrero,1,0,0,0,0,0,0,0,0,0,0,0,0,0,0,0,0,0,0,0,Sitio Arqueológico
20240315,2021,6,Cajamarca,Paisaje Cultural Arqueologico Cumbemayo,2,Febrero,2,0,0,0,0,0,0,0,0,0,0,0,0,0,0,0,0,0,0,0,Sitio Arqueológico
20240315,2021,6,Cajamarca,Paisaje Cultural Arqueologico Cumbemayo,3,Marzo,0,0,0,0,0,0,344,188,61,593,0,0,0,0,0,0,0,0,0,593,Sitio Arqueológico
20240315,2021,6,Cajamarca,Paisaje Cultural Arqueologico Cumbemayo,3,Marzo,1,0,0,0,0,0,0,0,0,0,0,0,0,0,0,0,0,0,0,0,Sitio Arqueológico
20240315,2021,6,Cajamarca,Paisaje Cultural Arqueologico Cumbemayo,3,Marzo,2,0,0,0,0,0,344,188,61,593,0,0,0,0,0,0,0,0,0,593,Sitio Arqueológico
20240315,2021,6,Cajamarca,Paisaje Cultural Arqueologico Cumbemayo,4,Abril,0,0,0,0,0,0,240,112,21,373,0,0,0,0,0,0,0,0,0,373,Sitio Arqueológico
20240315,2021,6,Cajamarca,Paisaje Cultural Arqueologico Cumbemayo,4,Abril,1,0,0,0,0,0,0,0,0,0,0,0,0,0,0,0,0,0,0,0,Sitio Arqueológico
20240315,2021,6,Cajamarca,Paisaje Cultural Arqueologico Cumbemayo,4,Abril,2,0,0,0,0,0,240,112,21,373,0,0,0,0,0,0,0,0,0,373,Sitio Arqueológico
20240315,2021,6,Cajamarca,Paisaje Cultural Arqueologico Cumbemayo,5,Mayo,0,0,0,0,0,0,512,288,123,923,0,0,0,0,0,0,0,0,0,923,Sitio Arqueológico
20240315,2021,6,Cajamarca,Paisaje Cultural Arqueologico Cumbemayo,5,Mayo,1,0,0,0,0,0,0,0,0,0,0,0,0,0,0,0,0,0,0,0,Sitio Arqueológico
20240315,2021,6,Cajamarca,Paisaje Cultural Arqueologico Cumbemayo,5,Mayo,2,0,0,0,0,0,512,288,123,923,0,0,0,0,0,0,0,0,0,923,Sitio Arqueológico
20240315,2021,6,Cajamarca,Paisaje Cultural Arqueologico Cumbemayo,6,Junio,0,0,0,0,0,0,772,394,163,1329,0,0,0,0,0,0,0,0,0,1329,Sitio Arqueológico
20240315,2021,6,Cajamarca,Paisaje Cultural Arqueologico Cumbemayo,6,Junio,1,0,0,0,0,0,0,0,0,0,0,0,0,0,0,0,0,0,0,0,Sitio Arqueológico
20240315,2021,6,Cajamarca,Paisaje Cultural Arqueologico Cumbemayo,6,Junio,2,0,0,0,0,0,772,394,163,1329,0,0,0,0,0,0,0,0,0,1329,Sitio Arqueológico
20240315,2021,6,Cajamarca,Paisaje Cultural Arqueologico Cumbemayo,7,Julio,0,0,0,0,91,492,3538,592,1164,5877,0,0,0,0,0,0,0,0,0,5877,Sitio Arqueológico
20240315,2021,6,Cajamarca,Paisaje Cultural Arqueologico Cumbemayo,7,Julio,1,0,0,0,0,0,61,22,0,83,0,0,0,0,0,0,0,0,0,83,Sitio Arqueológico
20240315,2021,6,Cajamarca,Paisaje Cultural Arqueologico Cumbemayo,7,Julio,2,0,0,0,91,492,3599,614,1164,5960,0,0,0,0,0,0,0,0,0,5960,Sitio Arqueológico
20240315,2021,6,Cajamarca,Paisaje Cultural Arqueologico Cumbemayo,8,Agosto,0,0,0,0,102,597,3292,1600,1218,6809,0,0,0,0,43,314,88,185,630,7439,Sitio Arqueológico
20240315,2021,6,Cajamarca,Paisaje Cultural Arqueologico Cumbemayo,8,Agosto,1,0,0,0,0,1,75,13,6,95,0,0,0,0,0,0,0,0,0,95,Sitio Arqueológico
20240315,2021,6,Cajamarca,Paisaje Cultural Arqueologico Cumbemayo,8,Agosto,2,0,0,0,102,598,3367,1613,1224,6904,0,0,0,0,43,314,88,185,630,7534,Sitio Arqueológico
20240315,2021,6,Cajamarca,Paisaje Cultural Arqueologico Cumbemayo,9,Setiembre,0,0,0,0,55,354,1616,417,504,2946,0,0,0,0,28,192,39,55,314,3260,Sitio Arqueológico
20240315,2021,6,Cajamarca,Paisaje Cultural Arqueologico Cumbemayo,9,Setiembre,1,0,0,0,0,6,46,12,0,64,0,0,0,0,0,0,0,0,0,64,Sitio Arqueológico
20240315,2021,6,Cajamarca,Paisaje Cultural Arqueologico Cumbemayo,9,Setiembre,2,0,0,0,55,360,1662,429,504,3010,0,0,0,0,28,192,39,55,314,3324,Sitio Arqueológico
20240315,2021,6,Cajamarca,Paisaje Cultural Arqueologico Cumbemayo,10,Octubre,0,0,0,0,33,230,2147,479,714,3603,0,0,0,0,0,0,0,0,0,3603,Sitio Arqueológico
20240315,2021,6,Cajamarca,Paisaje Cultural Arqueologico Cumbemayo,10,Octubre,1,0,0,0,0,10,65,33,1,109,0,0,0,0,0,0,0,0,0,109,Sitio Arqueológico
20240315,2021,6,Cajamarca,Paisaje Cultural Arqueologico Cumbemayo,10,Octubre,2,0,0,0,33,240,2212,512,715,3712,0,0,0,0,0,0,0,0,0,3712,Sitio Arqueológico
20240315,2021,6,Cajamarca,Paisaje Cultural Arqueologico Cumbemayo,11,Noviembre,0,0,0,0,39,198,1337,503,375,2452,0,0,0,0,14,73,18,27,132,2584,Sitio Arqueológico
20240315,2021,6,Cajamarca,Paisaje Cultural Arqueologico Cumbemayo,11,Noviembre,1,0,0,0,0,10,58,16,1,85,0,0,0,0,0,0,0,0,0,85,Sitio Arqueológico
20240315,2021,6,Cajamarca,Paisaje Cultural Arqueologico Cumbemayo,11,Noviembre,2,0,0,0,39,208,1395,519,376,2537,0,0,0,0,14,73,18,27,132,2669,Sitio Arqueológico
20240315,2021,6,Cajamarca,Paisaje Cultural Arqueologico Cumbemayo,12,Diciembre,0,0,0,0,4,112,905,366,286,1673,0,0,0,1,20,108,35,31,195,1868,Sitio Arqueológico
20240315,2021,6,Cajamarca,Paisaje Cultural Arqueologico Cumbemayo,12,Diciembre,1,0,0,0,0,0,9,21,0,30,0,0,0,0,0,0,0,0,0,30,Sitio Arqueológico
20240315,2021,6,Cajamarca,Paisaje Cultural Arqueologico Cumbemayo,12,Diciembre,2,0,0,0,4,112,914,387,286,1703,0,0,0,1,20,108,35,31,195,1898,Sitio Arqueológico
20240315,2021,6,Cajamarca,Centro Arqueologico Ventanilla de Otuzco,1,Enero,0,0,0,0,0,0,0,0,0,0,0,0,0,0,0,0,0,0,0,0,Sitio Arqueológico
20240315,2021,6,Cajamarca,Centro Arqueologico Ventanilla de Otuzco,1,Enero,1,0,0,0,0,0,0,0,0,0,0,0,0,0,0,0,0,0,0,0,Sitio Arqueológico
20240315,2021,6,Cajamarca,Centro Arqueologico Ventanilla de Otuzco,1,Enero,2,0,0,0,0,0,0,0,0,0,0,0,0,0,0,0,0,0,0,0,Sitio Arqueológico
20240315,2021,6,Cajamarca,Centro Arqueologico Ventanilla de Otuzco,2,Febrero,0,0,0,0,0,0,0,0,0,0,0,0,0,0,0,0,0,0,0,0,Sitio Arqueológico
20240315,2021,6,Cajamarca,Centro Arqueologico Ventanilla de Otuzco,2,Febrero,1,0,0,0,0,0,0,0,0,0,0,0,0,0,0,0,0,0,0,0,Sitio Arqueológico
20240315,2021,6,Cajamarca,Centro Arqueologico Ventanilla de Otuzco,2,Febrero,2,0,0,0,0,0,0,0,0,0,0,0,0,0,0,0,0,0,0,0,Sitio Arqueológico
20240315,2021,6,Cajamarca,Centro Arqueologico Ventanilla de Otuzco,3,Marzo,0,0,0,0,0,0,0,0,0,0,0,0,0,0,0,0,0,0,0,0,Sitio Arqueológico
20240315,2021,6,Cajamarca,Centro Arqueologico Ventanilla de Otuzco,3,Marzo,1,0,0,0,0,0,0,0,0,0,0,0,0,0,0,0,0,0,0,0,Sitio Arqueológico
20240315,2021,6,Cajamarca,Centro Arqueologico Ventanilla de Otuzco,3,Marzo,2,0,0,0,0,0,0,0,0,0,0,0,0,0,0,0,0,0,0,0,Sitio Arqueológico
20240315,2021,6,Cajamarca,Centro Arqueologico Ventanilla de Otuzco,4,Abril,0,0,0,0,0,0,0,0,0,0,0,0,0,0,0,0,0,0,0,0,Sitio Arqueológico
20240315,2021,6,Cajamarca,Centro Arqueologico Ventanilla de Otuzco,4,Abril,1,0,0,0,0,0,0,0,0,0,0,0,0,0,0,0,0,0,0,0,Sitio Arqueológico
20240315,2021,6,Cajamarca,Centro Arqueologico Ventanilla de Otuzco,4,Abril,2,0,0,0,0,0,0,0,0,0,0,0,0,0,0,0,0,0,0,0,Sitio Arqueológico
20240315,2021,6,Cajamarca,Centro Arqueologico Ventanilla de Otuzco,5,Mayo,0,0,0,0,0,0,0,0,0,0,0,0,0,0,0,0,0,0,0,0,Sitio Arqueológico
20240315,2021,6,Cajamarca,Centro Arqueologico Ventanilla de Otuzco,5,Mayo,1,0,0,0,0,0,0,0,0,0,0,0,0,0,0,0,0,0,0,0,Sitio Arqueológico
20240315,2021,6,Cajamarca,Centro Arqueologico Ventanilla de Otuzco,5,Mayo,2,0,0,0,0,0,0,0,0,0,0,0,0,0,0,0,0,0,0,0,Sitio Arqueológico
20240315,2021,6,Cajamarca,Centro Arqueologico Ventanilla de Otuzco,6,Junio,0,0,0,0,0,0,473,59,83,615,0,0,0,0,0,0,0,0,0,615,Sitio Arqueológico
20240315,2021,6,Cajamarca,Centro Arqueologico Ventanilla de Otuzco,6,Junio,1,0,0,0,0,0,0,0,0,0,0,0,0,0,0,0,0,0,0,0,Sitio Arqueológico
20240315,2021,6,Cajamarca,Centro Arqueologico Ventanilla de Otuzco,6,Junio,2,0,0,0,0,0,473,59,83,615,0,0,0,0,0,0,0,0,0,615,Sitio Arqueológico
20240315,2021,6,Cajamarca,Centro Arqueologico Ventanilla de Otuzco,7,Julio,0,0,0,0,0,273,5478,624,1851,8226,0,0,0,0,0,0,0,0,0,8226,Sitio Arqueológico
20240315,2021,6,Cajamarca,Centro Arqueologico Ventanilla de Otuzco,7,Julio,1,0,0,0,0,0,61,7,0,68,0,0,0,0,0,0,0,0,0,68,Sitio Arqueológico
20240315,2021,6,Cajamarca,Centro Arqueologico Ventanilla de Otuzco,7,Julio,2,0,0,0,0,273,5539,631,1851,8294,0,0,0,0,0,0,0,0,0,8294,Sitio Arqueológico
20240315,2021,6,Cajamarca,Centro Arqueologico Ventanilla de Otuzco,8,Agosto,0,0,0,0,14,424,5038,1369,1732,8577,0,0,0,0,79,942,81,399,1501,10078,Sitio Arqueológico
20240315,2021,6,Cajamarca,Centro Arqueologico Ventanilla de Otuzco,8,Agosto,1,0,0,0,0,0,29,0,0,29,0,0,0,0,0,0,0,0,0,29,Sitio Arqueológico
20240315,2021,6,Cajamarca,Centro Arqueologico Ventanilla de Otuzco,8,Agosto,2,0,0,0,14,424,5067,1369,1732,8606,0,0,0,0,79,942,81,399,1501,10107,Sitio Arqueológico
20240315,2021,6,Cajamarca,Centro Arqueologico Ventanilla de Otuzco,9,Setiembre,0,0,0,0,5,70,901,153,195,1324,0,0,0,0,266,1769,173,392,2600,3924,Sitio Arqueológico
20240315,2021,6,Cajamarca,Centro Arqueologico Ventanilla de Otuzco,9,Setiembre,1,0,0,0,0,0,15,0,0,15,0,0,0,0,0,0,0,0,0,15,Sitio Arqueológico
20240315,2021,6,Cajamarca,Centro Arqueologico Ventanilla de Otuzco,9,Setiembre,2,0,0,0,5,70,916,153,195,1339,0,0,0,0,266,1769,173,392,2600,3939,Sitio Arqueológico
20240315,2021,6,Cajamarca,Centro Arqueologico Ventanilla de Otuzco,10,Octubre,0,0,0,0,18,316,2636,356,750,4076,0,0,0,0,0,0,0,0,0,4076,Sitio Arqueológico
20240315,2021,6,Cajamarca,Centro Arqueologico Ventanilla de Otuzco,10,Octubre,1,0,0,0,0,11,41,19,3,74,0,0,0,0,0,0,0,0,0,74,Sitio Arqueológico
20240315,2021,6,Cajamarca,Centro Arqueologico Ventanilla de Otuzco,10,Octubre,2,0,0,0,18,327,2677,375,753,4150,0,0,0,0,0,0,0,0,0,4150,Sitio Arqueológico
20240315,2021,6,Cajamarca,Centro Arqueologico Ventanilla de Otuzco,11,Noviembre,0,0,0,0,0,0,1967,711,406,3084,0,0,0,0,47,212,24,87,370,3454,Sitio Arqueológico
20240315,2021,6,Cajamarca,Centro Arqueologico Ventanilla de Otuzco,11,Noviembre,1,0,0,0,0,0,21,0,0,21,0,0,0,0,0,0,0,0,0,21,Sitio Arqueológico
20240315,2021,6,Cajamarca,Centro Arqueologico Ventanilla de Otuzco,11,Noviembre,2,0,0,0,0,0,1988,711,406,3105,0,0,0,0,47,212,24,87,370,3475,Sitio Arqueológico
20240315,2021,6,Cajamarca,Centro Arqueologico Ventanilla de Otuzco,12,Diciembre,0,0,0,0,4,0,1427,197,281,1909,0,0,0,2,19,23,133,48,225,2134,Sitio Arqueológico
20240315,2021,6,Cajamarca,Centro Arqueologico Ventanilla de Otuzco,12,Diciembre,1,0,0,0,0,0,0,33,0,33,0,0,0,0,0,0,0,0,0,33,Sitio Arqueológico
20240315,2021,6,Cajamarca,Centro Arqueologico Ventanilla de Otuzco,12,Diciembre,2,0,0,0,4,0,1427,230,281,1942,0,0,0,2,19,23,133,48,225,2167,Sitio Arqueológico
20240315,2021,6,Cajamarca,Monumento Arqueologico Kuntur Wasi,1,Enero,0,0,0,0,0,0,0,0,0,0,0,0,0,0,0,0,0,0,0,0,Sitio Arqueológico
20240315,2021,6,Cajamarca,Monumento Arqueologico Kuntur Wasi,1,Enero,1,0,0,0,0,0,0,0,0,0,0,0,0,0,0,0,0,0,0,0,Sitio Arqueológico
20240315,2021,6,Cajamarca,Monumento Arqueologico Kuntur Wasi,1,Enero,2,0,0,0,0,0,0,0,0,0,0,0,0,0,0,0,0,0,0,0,Sitio Arqueológico
20240315,2021,6,Cajamarca,Monumento Arqueologico Kuntur Wasi,2,Febrero,0,0,0,0,0,0,0,0,0,0,0,0,0,0,0,0,0,0,0,0,Sitio Arqueológico
20240315,2021,6,Cajamarca,Monumento Arqueologico Kuntur Wasi,2,Febrero,1,0,0,0,0,0,0,0,0,0,0,0,0,0,0,0,0,0,0,0,Sitio Arqueológico
20240315,2021,6,Cajamarca,Monumento Arqueologico Kuntur Wasi,2,Febrero,2,0,0,0,0,0,0,0,0,0,0,0,0,0,0,0,0,0,0,0,Sitio Arqueológico
20240315,2021,6,Cajamarca,Monumento Arqueologico Kuntur Wasi,3,Marzo,0,0,0,0,0,0,30,3,5,38,0,0,0,0,0,0,0,0,0,38,Sitio Arqueológico
20240315,2021,6,Cajamarca,Monumento Arqueologico Kuntur Wasi,3,Marzo,1,0,0,0,0,0,0,0,0,0,0,0,0,0,0,0,0,0,0,0,Sitio Arqueológico
20240315,2021,6,Cajamarca,Monumento Arqueologico Kuntur Wasi,3,Marzo,2,0,0,0,0,0,30,3,5,38,0,0,0,0,0,0,0,0,0,38,Sitio Arqueológico
20240315,2021,6,Cajamarca,Monumento Arqueologico Kuntur Wasi,4,Abril,0,0,0,0,2,0,20,4,3,29,0,0,0,0,0,0,0,0,0,29,Sitio Arqueológico
20240315,2021,6,Cajamarca,Monumento Arqueologico Kuntur Wasi,4,Abril,1,0,0,0,0,0,0,0,0,0,0,0,0,0,0,0,0,0,0,0,Sitio Arqueológico
20240315,2021,6,Cajamarca,Monumento Arqueologico Kuntur Wasi,4,Abril,2,0,0,0,2,0,20,4,3,29,0,0,0,0,0,0,0,0,0,29,Sitio Arqueológico
20240315,2021,6,Cajamarca,Monumento Arqueologico Kuntur Wasi,5,Mayo,0,0,0,0,0,0,31,14,7,52,0,0,0,0,0,0,0,0,0,52,Sitio Arqueológico
20240315,2021,6,Cajamarca,Monumento Arqueologico Kuntur Wasi,5,Mayo,1,0,0,0,0,0,0,0,0,0,0,0,0,0,0,0,0,0,0,0,Sitio Arqueológico
20240315,2021,6,Cajamarca,Monumento Arqueologico Kuntur Wasi,5,Mayo,2,0,0,0,0,0,31,14,7,52,0,0,0,0,0,0,0,0,0,52,Sitio Arqueológico
20240315,2021,6,Cajamarca,Monumento Arqueologico Kuntur Wasi,6,Junio,0,0,0,0,0,0,84,44,19,147,0,0,0,0,0,0,0,0,0,147,Sitio Arqueológico
20240315,2021,6,Cajamarca,Monumento Arqueologico Kuntur Wasi,6,Junio,1,0,0,0,0,0,0,0,0,0,0,0,0,0,0,0,0,0,0,0,Sitio Arqueológico
20240315,2021,6,Cajamarca,Monumento Arqueologico Kuntur Wasi,6,Junio,2,0,0,0,0,0,84,44,19,147,0,0,0,0,0,0,0,0,0,147,Sitio Arqueológico
20240315,2021,6,Cajamarca,Monumento Arqueologico Kuntur Wasi,7,Julio,0,0,0,0,13,39,210,87,115,464,0,0,0,0,0,0,0,0,0,464,Sitio Arqueológico
20240315,2021,6,Cajamarca,Monumento Arqueologico Kuntur Wasi,7,Julio,1,0,0,0,0,0,1,1,0,2,0,0,0,0,0,0,0,0,0,2,Sitio Arqueológico
20240315,2021,6,Cajamarca,Monumento Arqueologico Kuntur Wasi,7,Julio,2,0,0,0,13,39,211,88,115,466,0,0,0,0,0,0,0,0,0,466,Sitio Arqueológico
20240315,2021,6,Cajamarca,Monumento Arqueologico Kuntur Wasi,8,Agosto,0,0,0,0,0,20,153,90,50,313,0,0,0,1,4,62,17,51,135,448,Sitio Arqueológico
20240315,2021,6,Cajamarca,Monumento Arqueologico Kuntur Wasi,8,Agosto,1,0,0,0,0,0,0,0,0,0,0,0,0,0,0,0,0,0,0,0,Sitio Arqueológico
20240315,2021,6,Cajamarca,Monumento Arqueologico Kuntur Wasi,8,Agosto,2,0,0,0,0,20,153,90,50,313,0,0,0,1,4,62,17,51,135,448,Sitio Arqueológico
20240315,2021,6,Cajamarca,Monumento Arqueologico Kuntur Wasi,9,Setiembre,0,0,0,0,0,10,126,70,36,242,0,0,0,0,1,24,4,10,39,281,Sitio Arqueológico
20240315,2021,6,Cajamarca,Monumento Arqueologico Kuntur Wasi,9,Setiembre,1,0,0,0,0,0,3,0,0,3,0,0,0,0,0,0,0,0,0,3,Sitio Arqueológico
20240315,2021,6,Cajamarca,Monumento Arqueologico Kuntur Wasi,9,Setiembre,2,0,0,0,0,10,129,70,36,245,0,0,0,0,1,24,4,10,39,284,Sitio Arqueológico
20240315,2021,6,Cajamarca,Monumento Arqueologico Kuntur Wasi,10,Octubre,0,0,0,0,0,20,201,94,71,386,0,0,0,0,0,0,0,0,0,386,Sitio Arqueológico
20240315,2021,6,Cajamarca,Monumento Arqueologico Kuntur Wasi,10,Octubre,1,0,0,0,0,0,3,0,0,3,0,0,0,0,0,0,0,0,0,3,Sitio Arqueológico
20240315,2021,6,Cajamarca,Monumento Arqueologico Kuntur Wasi,10,Octubre,2,0,0,0,0,20,204,94,71,389,0,0,0,0,0,0,0,0,0,389,Sitio Arqueológico
20240315,2021,6,Cajamarca,Monumento Arqueologico Kuntur Wasi,11,Noviembre,0,0,0,0,0,6,110,86,34,236,0,0,0,0,1,23,16,10,50,286,Sitio Arqueológico
20240315,2021,6,Cajamarca,Monumento Arqueologico Kuntur Wasi,11,Noviembre,1,0,0,0,0,3,4,0,0,7,0,0,0,0,0,0,0,0,0,7,Sitio Arqueológico
20240315,2021,6,Cajamarca,Monumento Arqueologico Kuntur Wasi,11,Noviembre,2,0,0,0,0,9,114,86,34,243,0,0,0,0,1,23,16,10,50,293,Sitio Arqueológico
20240315,2021,6,Cajamarca,Monumento Arqueologico Kuntur Wasi,12,Diciembre,0,0,0,0,2,2,92,57,27,180,0,0,0,0,0,0,0,0,0,180,Sitio Arqueológico
20240315,2021,6,Cajamarca,Monumento Arqueologico Kuntur Wasi,12,Diciembre,1,0,0,0,0,0,3,0,0,3,0,0,0,0,0,0,0,0,0,3,Sitio Arqueológico
20240315,2021,6,Cajamarca,Monumento Arqueologico Kuntur Wasi,12,Diciembre,2,0,0,0,2,2,95,57,27,183,0,0,0,0,0,0,0,0,0,183,Sitio Arqueológico
20240315,2021,8,Cusco,Parque Arqueologico Macchu Picchu (Ruta 1: Camino Inka: Piscacucho Km. 82),1,Enero,0,0,0,0,0,0,0,0,0,0,0,0,0,0,0,0,0,0,0,0,Sitio Arqueológico
20240315,2021,8,Cusco,Parque Arqueologico Macchu Picchu (Ruta 1: Camino Inka: Piscacucho Km. 82),1,Enero,1,0,0,0,0,0,0,0,0,0,0,0,0,0,0,0,0,0,0,0,Sitio Arqueológico
20240315,2021,8,Cusco,Parque Arqueologico Macchu Picchu (Ruta 1: Camino Inka: Piscacucho Km. 82),1,Enero,2,0,0,0,0,0,0,0,0,0,0,0,0,0,0,0,0,0,0,0,Sitio Arqueológico
20240315,2021,8,Cusco,Parque Arqueologico Macchu Picchu (Ruta 1: Camino Inka: Piscacucho Km. 82),2,Febrero,0,0,0,0,0,0,0,0,0,0,0,0,0,0,0,0,0,0,0,0,Sitio Arqueológico
20240315,2021,8,Cusco,Parque Arqueologico Macchu Picchu (Ruta 1: Camino Inka: Piscacucho Km. 82),2,Febrero,1,0,0,0,0,0,0,0,0,0,0,0,0,0,0,0,0,0,0,0,Sitio Arqueológico
20240315,2021,8,Cusco,Parque Arqueologico Macchu Picchu (Ruta 1: Camino Inka: Piscacucho Km. 82),2,Febrero,2,0,0,0,0,0,0,0,0,0,0,0,0,0,0,0,0,0,0,0,Sitio Arqueológico
20240315,2021,8,Cusco,Parque Arqueologico Macchu Picchu (Ruta 1: Camino Inka: Piscacucho Km. 82),3,Marzo,0,0,0,0,0,0,0,0,0,0,0,0,0,0,0,0,0,0,0,0,Sitio Arqueológico
20240315,2021,8,Cusco,Parque Arqueologico Macchu Picchu (Ruta 1: Camino Inka: Piscacucho Km. 82),3,Marzo,1,0,0,0,0,0,0,0,0,0,0,0,0,0,0,0,0,0,0,0,Sitio Arqueológico
20240315,2021,8,Cusco,Parque Arqueologico Macchu Picchu (Ruta 1: Camino Inka: Piscacucho Km. 82),3,Marzo,2,0,0,0,0,0,0,0,0,0,0,0,0,0,0,0,0,0,0,0,Sitio Arqueológico
20240315,2021,8,Cusco,Parque Arqueologico Macchu Picchu (Ruta 1: Camino Inka: Piscacucho Km. 82),4,Abril,0,0,0,0,0,0,0,0,0,0,0,0,0,0,0,0,0,0,0,0,Sitio Arqueológico
20240315,2021,8,Cusco,Parque Arqueologico Macchu Picchu (Ruta 1: Camino Inka: Piscacucho Km. 82),4,Abril,1,0,0,0,0,0,0,0,0,0,0,0,0,0,0,0,0,0,0,0,Sitio Arqueológico
20240315,2021,8,Cusco,Parque Arqueologico Macchu Picchu (Ruta 1: Camino Inka: Piscacucho Km. 82),4,Abril,2,0,0,0,0,0,0,0,0,0,0,0,0,0,0,0,0,0,0,0,Sitio Arqueológico
20240315,2021,8,Cusco,Parque Arqueologico Macchu Picchu (Ruta 1: Camino Inka: Piscacucho Km. 82),5,Mayo,0,0,0,0,0,0,0,0,0,0,0,0,0,0,0,0,0,0,0,0,Sitio Arqueológico
20240315,2021,8,Cusco,Parque Arqueologico Macchu Picchu (Ruta 1: Camino Inka: Piscacucho Km. 82),5,Mayo,1,0,0,0,0,0,0,0,0,0,0,0,0,0,0,0,0,0,0,0,Sitio Arqueológico
20240315,2021,8,Cusco,Parque Arqueologico Macchu Picchu (Ruta 1: Camino Inka: Piscacucho Km. 82),5,Mayo,2,0,0,0,0,0,0,0,0,0,0,0,0,0,0,0,0,0,0,0,Sitio Arqueológico
20240315,2021,8,Cusco,Parque Arqueologico Macchu Picchu (Ruta 1: Camino Inka: Piscacucho Km. 82),6,Junio,0,0,0,0,0,0,0,0,0,0,0,0,0,0,0,0,0,0,0,0,Sitio Arqueológico
20240315,2021,8,Cusco,Parque Arqueologico Macchu Picchu (Ruta 1: Camino Inka: Piscacucho Km. 82),6,Junio,1,0,0,0,0,0,0,0,0,0,0,0,0,0,0,0,0,0,0,0,Sitio Arqueológico
20240315,2021,8,Cusco,Parque Arqueologico Macchu Picchu (Ruta 1: Camino Inka: Piscacucho Km. 82),6,Junio,2,0,0,0,0,0,0,0,0,0,0,0,0,0,0,0,0,0,0,0,Sitio Arqueológico
20240315,2021,8,Cusco,Parque Arqueologico Macchu Picchu (Ruta 1: Camino Inka: Piscacucho Km. 82),7,Julio,0,0,0,0,0,0,48,8,0,56,0,0,0,0,0,0,0,0,0,56,Sitio Arqueológico
20240315,2021,8,Cusco,Parque Arqueologico Macchu Picchu (Ruta 1: Camino Inka: Piscacucho Km. 82),7,Julio,1,0,0,0,0,0,266,13,1,280,0,0,0,0,0,0,0,0,0,280,Sitio Arqueológico
20240315,2021,8,Cusco,Parque Arqueologico Macchu Picchu (Ruta 1: Camino Inka: Piscacucho Km. 82),7,Julio,2,0,0,0,0,0,314,21,1,336,0,0,0,0,0,0,0,0,0,336,Sitio Arqueológico
20240315,2021,8,Cusco,Parque Arqueologico Macchu Picchu (Ruta 1: Camino Inka: Piscacucho Km. 82),8,Agosto,0,0,0,0,0,0,79,26,2,107,0,0,0,0,0,0,0,0,0,107,Sitio Arqueológico
20240315,2021,8,Cusco,Parque Arqueologico Macchu Picchu (Ruta 1: Camino Inka: Piscacucho Km. 82),8,Agosto,1,0,0,0,0,0,811,15,9,835,0,0,0,0,0,0,0,0,0,835,Sitio Arqueológico
20240315,2021,8,Cusco,Parque Arqueologico Macchu Picchu (Ruta 1: Camino Inka: Piscacucho Km. 82),8,Agosto,2,0,0,0,0,0,890,41,11,942,0,0,0,0,0,0,0,0,0,942,Sitio Arqueológico
20240315,2021,8,Cusco,Parque Arqueologico Macchu Picchu (Ruta 1: Camino Inka: Piscacucho Km. 82),9,Setiembre,0,0,0,0,0,0,82,92,0,174,0,0,0,0,0,0,0,0,0,174,Sitio Arqueológico
20240315,2021,8,Cusco,Parque Arqueologico Macchu Picchu (Ruta 1: Camino Inka: Piscacucho Km. 82),9,Setiembre,1,0,0,0,0,0,0,9,1070,1079,0,0,0,0,0,0,0,0,0,1079,Sitio Arqueológico
20240315,2021,8,Cusco,Parque Arqueologico Macchu Picchu (Ruta 1: Camino Inka: Piscacucho Km. 82),9,Setiembre,2,0,0,0,0,0,82,101,1070,1253,0,0,0,0,0,0,0,0,0,1253,Sitio Arqueológico
20240315,2021,8,Cusco,Parque Arqueologico Macchu Picchu (Ruta 1: Camino Inka: Piscacucho Km. 82),10,Octubre,0,0,0,0,0,0,60,3,1,64,0,0,0,0,0,0,0,0,0,64,Sitio Arqueológico
20240315,2021,8,Cusco,Parque Arqueologico Macchu Picchu (Ruta 1: Camino Inka: Piscacucho Km. 82),10,Octubre,1,0,0,0,0,0,1200,12,8,1220,0,0,0,0,0,0,0,0,0,1220,Sitio Arqueológico
20240315,2021,8,Cusco,Parque Arqueologico Macchu Picchu (Ruta 1: Camino Inka: Piscacucho Km. 82),10,Octubre,2,0,0,0,0,0,1260,15,9,1284,0,0,0,0,0,0,0,0,0,1284,Sitio Arqueológico
20240315,2021,8,Cusco,Parque Arqueologico Macchu Picchu (Ruta 1: Camino Inka: Piscacucho Km. 82),11,Noviembre,0,0,0,0,0,0,60,3,1,64,0,0,0,0,0,0,0,0,0,64,Sitio Arqueológico
20240315,2021,8,Cusco,Parque Arqueologico Macchu Picchu (Ruta 1: Camino Inka: Piscacucho Km. 82),11,Noviembre,1,0,0,0,0,0,1200,12,8,1220,0,0,0,0,0,0,0,0,0,1220,Sitio Arqueológico
20240315,2021,8,Cusco,Parque Arqueologico Macchu Picchu (Ruta 1: Camino Inka: Piscacucho Km. 82),11,Noviembre,2,0,0,0,0,0,1260,15,9,1284,0,0,0,0,0,0,0,0,0,1284,Sitio Arqueológico
20240315,2021,8,Cusco,Parque Arqueologico Macchu Picchu (Ruta 1: Camino Inka: Piscacucho Km. 82),12,Diciembre,0,0,0,0,0,0,27,0,0,27,0,0,0,0,0,0,0,0,0,27,Sitio Arqueológico
20240315,2021,8,Cusco,Parque Arqueologico Macchu Picchu (Ruta 1: Camino Inka: Piscacucho Km. 82),12,Diciembre,1,0,0,0,0,0,918,30,0,948,0,0,0,0,0,0,0,0,0,948,Sitio Arqueológico
20240315,2021,8,Cusco,Parque Arqueologico Macchu Picchu (Ruta 1: Camino Inka: Piscacucho Km. 82),12,Diciembre,2,0,0,0,0,0,945,30,0,975,0,0,0,0,0,0,0,0,0,975,Sitio Arqueológico
20240315,2021,8,Cusco,Parque Arqueologico Macchu Picchu (Ruta 2: Camino Inka: Km. 88),1,Enero,0,0,0,0,0,0,0,0,0,0,0,0,0,0,0,0,0,0,0,0,Sitio Arqueológico
20240315,2021,8,Cusco,Parque Arqueologico Macchu Picchu (Ruta 2: Camino Inka: Km. 88),1,Enero,1,0,0,0,0,0,0,0,0,0,0,0,0,0,0,0,0,0,0,0,Sitio Arqueológico
20240315,2021,8,Cusco,Parque Arqueologico Macchu Picchu (Ruta 2: Camino Inka: Km. 88),1,Enero,2,0,0,0,0,0,0,0,0,0,0,0,0,0,0,0,0,0,0,0,Sitio Arqueológico
20240315,2021,8,Cusco,Parque Arqueologico Macchu Picchu (Ruta 2: Camino Inka: Km. 88),2,Febrero,0,0,0,0,0,0,0,0,0,0,0,0,0,0,0,0,0,0,0,0,Sitio Arqueológico
20240315,2021,8,Cusco,Parque Arqueologico Macchu Picchu (Ruta 2: Camino Inka: Km. 88),2,Febrero,1,0,0,0,0,0,0,0,0,0,0,0,0,0,0,0,0,0,0,0,Sitio Arqueológico
20240315,2021,8,Cusco,Parque Arqueologico Macchu Picchu (Ruta 2: Camino Inka: Km. 88),2,Febrero,2,0,0,0,0,0,0,0,0,0,0,0,0,0,0,0,0,0,0,0,Sitio Arqueológico
20240315,2021,8,Cusco,Parque Arqueologico Macchu Picchu (Ruta 2: Camino Inka: Km. 88),3,Marzo,0,0,0,0,0,0,0,0,0,0,0,0,0,0,0,0,0,0,0,0,Sitio Arqueológico
20240315,2021,8,Cusco,Parque Arqueologico Macchu Picchu (Ruta 2: Camino Inka: Km. 88),3,Marzo,1,0,0,0,0,0,0,0,0,0,0,0,0,0,0,0,0,0,0,0,Sitio Arqueológico
20240315,2021,8,Cusco,Parque Arqueologico Macchu Picchu (Ruta 2: Camino Inka: Km. 88),3,Marzo,2,0,0,0,0,0,0,0,0,0,0,0,0,0,0,0,0,0,0,0,Sitio Arqueológico
20240315,2021,8,Cusco,Parque Arqueologico Macchu Picchu (Ruta 2: Camino Inka: Km. 88),4,Abril,0,0,0,0,0,0,0,0,0,0,0,0,0,0,0,0,0,0,0,0,Sitio Arqueológico
20240315,2021,8,Cusco,Parque Arqueologico Macchu Picchu (Ruta 2: Camino Inka: Km. 88),4,Abril,1,0,0,0,0,0,0,0,0,0,0,0,0,0,0,0,0,0,0,0,Sitio Arqueológico
20240315,2021,8,Cusco,Parque Arqueologico Macchu Picchu (Ruta 2: Camino Inka: Km. 88),4,Abril,2,0,0,0,0,0,0,0,0,0,0,0,0,0,0,0,0,0,0,0,Sitio Arqueológico
20240315,2021,8,Cusco,Parque Arqueologico Macchu Picchu (Ruta 2: Camino Inka: Km. 88),5,Mayo,0,0,0,0,0,0,0,0,0,0,0,0,0,0,0,0,0,0,0,0,Sitio Arqueológico
20240315,2021,8,Cusco,Parque Arqueologico Macchu Picchu (Ruta 2: Camino Inka: Km. 88),5,Mayo,1,0,0,0,0,0,0,0,0,0,0,0,0,0,0,0,0,0,0,0,Sitio Arqueológico
20240315,2021,8,Cusco,Parque Arqueologico Macchu Picchu (Ruta 2: Camino Inka: Km. 88),5,Mayo,2,0,0,0,0,0,0,0,0,0,0,0,0,0,0,0,0,0,0,0,Sitio Arqueológico
20240315,2021,8,Cusco,Parque Arqueologico Macchu Picchu (Ruta 2: Camino Inka: Km. 88),6,Junio,0,0,0,0,0,0,0,0,0,0,0,0,0,0,0,0,0,0,0,0,Sitio Arqueológico
20240315,2021,8,Cusco,Parque Arqueologico Macchu Picchu (Ruta 2: Camino Inka: Km. 88),6,Junio,1,0,0,0,0,0,0,0,0,0,0,0,0,0,0,0,0,0,0,0,Sitio Arqueológico
20240315,2021,8,Cusco,Parque Arqueologico Macchu Picchu (Ruta 2: Camino Inka: Km. 88),6,Junio,2,0,0,0,0,0,0,0,0,0,0,0,0,0,0,0,0,0,0,0,Sitio Arqueológico
20240315,2021,8,Cusco,Parque Arqueologico Macchu Picchu (Ruta 2: Camino Inka: Km. 88),7,Julio,0,0,0,0,0,0,14,2,0,16,0,0,0,0,0,0,0,0,0,16,Sitio Arqueológico
20240315,2021,8,Cusco,Parque Arqueologico Macchu Picchu (Ruta 2: Camino Inka: Km. 88),7,Julio,1,0,0,0,0,0,16,2,0,18,0,0,0,0,0,0,0,0,0,18,Sitio Arqueológico
20240315,2021,8,Cusco,Parque Arqueologico Macchu Picchu (Ruta 2: Camino Inka: Km. 88),7,Julio,2,0,0,0,0,0,30,4,0,34,0,0,0,0,0,0,0,0,0,34,Sitio Arqueológico
20240315,2021,8,Cusco,Parque Arqueologico Macchu Picchu (Ruta 2: Camino Inka: Km. 88),8,Agosto,0,0,0,0,0,0,0,0,0,0,0,0,0,0,0,0,0,0,0,0,Sitio Arqueológico
20240315,2021,8,Cusco,Parque Arqueologico Macchu Picchu (Ruta 2: Camino Inka: Km. 88),8,Agosto,1,0,0,0,0,0,45,2,0,47,0,0,0,0,0,0,0,0,0,47,Sitio Arqueológico
20240315,2021,8,Cusco,Parque Arqueologico Macchu Picchu (Ruta 2: Camino Inka: Km. 88),8,Agosto,2,0,0,0,0,0,45,2,0,47,0,0,0,0,0,0,0,0,0,47,Sitio Arqueológico
20240315,2021,8,Cusco,Parque Arqueologico Macchu Picchu (Ruta 2: Camino Inka: Km. 88),9,Setiembre,0,0,0,0,0,0,0,0,0,0,0,0,0,0,0,0,0,0,0,0,Sitio Arqueológico
20240315,2021,8,Cusco,Parque Arqueologico Macchu Picchu (Ruta 2: Camino Inka: Km. 88),9,Setiembre,1,0,0,0,0,0,85,1,0,86,0,0,0,0,0,0,0,0,0,86,Sitio Arqueológico
20240315,2021,8,Cusco,Parque Arqueologico Macchu Picchu (Ruta 2: Camino Inka: Km. 88),9,Setiembre,2,0,0,0,0,0,85,1,0,86,0,0,0,0,0,0,0,0,0,86,Sitio Arqueológico
20240315,2021,8,Cusco,Parque Arqueologico Macchu Picchu (Ruta 2: Camino Inka: Km. 88),10,Octubre,0,0,0,0,0,0,0,0,0,0,0,0,0,0,0,0,0,0,0,0,Sitio Arqueológico
20240315,2021,8,Cusco,Parque Arqueologico Macchu Picchu (Ruta 2: Camino Inka: Km. 88),10,Octubre,1,0,0,0,0,0,49,0,0,49,0,0,0,0,0,0,0,0,0,49,Sitio Arqueológico
20240315,2021,8,Cusco,Parque Arqueologico Macchu Picchu (Ruta 2: Camino Inka: Km. 88),10,Octubre,2,0,0,0,0,0,49,0,0,49,0,0,0,0,0,0,0,0,0,49,Sitio Arqueológico
20240315,2021,8,Cusco,Parque Arqueologico Macchu Picchu (Ruta 2: Camino Inka: Km. 88),11,Noviembre,0,0,0,0,0,0,0,0,0,0,0,0,0,0,0,0,0,0,0,0,Sitio Arqueológico
20240315,2021,8,Cusco,Parque Arqueologico Macchu Picchu (Ruta 2: Camino Inka: Km. 88),11,Noviembre,1,0,0,0,0,0,10,0,0,10,0,0,0,0,0,0,0,0,0,10,Sitio Arqueológico
20240315,2021,8,Cusco,Parque Arqueologico Macchu Picchu (Ruta 2: Camino Inka: Km. 88),11,Noviembre,2,0,0,0,0,0,10,0,0,10,0,0,0,0,0,0,0,0,0,10,Sitio Arqueológico
20240315,2021,8,Cusco,Parque Arqueologico Macchu Picchu (Ruta 2: Camino Inka: Km. 88),12,Diciembre,0,0,0,0,0,0,0,0,0,0,0,0,0,0,0,0,0,0,0,0,Sitio Arqueológico
20240315,2021,8,Cusco,Parque Arqueologico Macchu Picchu (Ruta 2: Camino Inka: Km. 88),12,Diciembre,1,0,0,0,0,0,43,7,1,51,0,0,0,0,0,0,0,0,0,51,Sitio Arqueológico
20240315,2021,8,Cusco,Parque Arqueologico Macchu Picchu (Ruta 2: Camino Inka: Km. 88),12,Diciembre,2,0,0,0,0,0,43,7,1,51,0,0,0,0,0,0,0,0,0,51,Sitio Arqueológico
20240315,2021,8,Cusco,Parque Arqueologico Macchu Picchu (Ruta 5: Camino Iinka: Chanchabamba Km. 104),1,Enero,0,0,0,0,0,0,7,2,0,9,0,0,0,0,0,0,0,0,0,9,Sitio Arqueológico
20240315,2021,8,Cusco,Parque Arqueologico Macchu Picchu (Ruta 5: Camino Iinka: Chanchabamba Km. 104),1,Enero,1,0,0,0,0,0,53,3,0,56,0,0,0,0,0,0,0,0,0,56,Sitio Arqueológico
20240315,2021,8,Cusco,Parque Arqueologico Macchu Picchu (Ruta 5: Camino Iinka: Chanchabamba Km. 104),1,Enero,2,0,0,0,0,0,60,5,0,65,0,0,0,0,0,0,0,0,0,65,Sitio Arqueológico
20240315,2021,8,Cusco,Parque Arqueologico Macchu Picchu (Ruta 5: Camino Iinka: Chanchabamba Km. 104),2,Febrero,0,0,0,0,0,0,0,0,0,0,0,0,0,0,0,0,0,0,0,0,Sitio Arqueológico
20240315,2021,8,Cusco,Parque Arqueologico Macchu Picchu (Ruta 5: Camino Iinka: Chanchabamba Km. 104),2,Febrero,1,0,0,0,0,0,0,0,0,0,0,0,0,0,0,0,0,0,0,0,Sitio Arqueológico
20240315,2021,8,Cusco,Parque Arqueologico Macchu Picchu (Ruta 5: Camino Iinka: Chanchabamba Km. 104),2,Febrero,2,0,0,0,0,0,0,0,0,0,0,0,0,0,0,0,0,0,0,0,Sitio Arqueológico
20240315,2021,8,Cusco,Parque Arqueologico Macchu Picchu (Ruta 5: Camino Iinka: Chanchabamba Km. 104),3,Marzo,0,0,0,0,0,0,13,4,0,17,0,0,0,0,0,0,0,0,0,17,Sitio Arqueológico
20240315,2021,8,Cusco,Parque Arqueologico Macchu Picchu (Ruta 5: Camino Iinka: Chanchabamba Km. 104),3,Marzo,1,0,0,0,0,0,29,0,0,29,0,0,0,0,0,0,0,0,0,29,Sitio Arqueológico
20240315,2021,8,Cusco,Parque Arqueologico Macchu Picchu (Ruta 5: Camino Iinka: Chanchabamba Km. 104),3,Marzo,2,0,0,0,0,0,42,4,0,46,0,0,0,0,0,0,0,0,0,46,Sitio Arqueológico
20240315,2021,8,Cusco,Parque Arqueologico Macchu Picchu (Ruta 5: Camino Iinka: Chanchabamba Km. 104),4,Abril,0,0,0,0,0,0,15,0,2,17,0,0,0,0,0,0,0,0,0,17,Sitio Arqueológico
20240315,2021,8,Cusco,Parque Arqueologico Macchu Picchu (Ruta 5: Camino Iinka: Chanchabamba Km. 104),4,Abril,1,0,0,0,0,0,118,6,0,124,0,0,0,0,0,0,0,0,0,124,Sitio Arqueológico
20240315,2021,8,Cusco,Parque Arqueologico Macchu Picchu (Ruta 5: Camino Iinka: Chanchabamba Km. 104),4,Abril,2,0,0,0,0,0,133,6,2,141,0,0,0,0,0,0,0,0,0,141,Sitio Arqueológico
20240315,2021,8,Cusco,Parque Arqueologico Macchu Picchu (Ruta 5: Camino Iinka: Chanchabamba Km. 104),5,Mayo,0,0,0,0,0,0,22,4,14,40,0,0,0,0,0,0,0,0,0,40,Sitio Arqueológico
20240315,2021,8,Cusco,Parque Arqueologico Macchu Picchu (Ruta 5: Camino Iinka: Chanchabamba Km. 104),5,Mayo,1,0,0,0,0,0,290,5,6,301,0,0,0,0,0,0,0,0,0,301,Sitio Arqueológico
20240315,2021,8,Cusco,Parque Arqueologico Macchu Picchu (Ruta 5: Camino Iinka: Chanchabamba Km. 104),5,Mayo,2,0,0,0,0,0,312,9,20,341,0,0,0,0,0,0,0,0,0,341,Sitio Arqueológico
20240315,2021,8,Cusco,Parque Arqueologico Macchu Picchu (Ruta 5: Camino Iinka: Chanchabamba Km. 104),6,Junio,0,0,0,0,0,27,12,4,3,46,0,0,0,0,0,174,0,0,174,220,Sitio Arqueológico
20240315,2021,8,Cusco,Parque Arqueologico Macchu Picchu (Ruta 5: Camino Iinka: Chanchabamba Km. 104),6,Junio,1,0,0,0,0,0,462,31,21,514,0,0,0,0,0,0,0,0,0,514,Sitio Arqueológico
20240315,2021,8,Cusco,Parque Arqueologico Macchu Picchu (Ruta 5: Camino Iinka: Chanchabamba Km. 104),6,Junio,2,0,0,0,0,27,474,35,24,560,0,0,0,0,0,174,0,0,174,734,Sitio Arqueológico
20240315,2021,8,Cusco,Parque Arqueologico Macchu Picchu (Ruta 5: Camino Iinka: Chanchabamba Km. 104),7,Julio,0,0,0,0,0,0,34,8,0,42,0,0,0,0,0,0,0,0,0,42,Sitio Arqueológico
20240315,2021,8,Cusco,Parque Arqueologico Macchu Picchu (Ruta 5: Camino Iinka: Chanchabamba Km. 104),7,Julio,1,0,0,0,0,0,459,47,5,511,0,0,0,0,0,0,0,0,0,511,Sitio Arqueológico
20240315,2021,8,Cusco,Parque Arqueologico Macchu Picchu (Ruta 5: Camino Iinka: Chanchabamba Km. 104),7,Julio,2,0,0,0,0,0,493,55,5,553,0,0,0,0,0,0,0,0,0,553,Sitio Arqueológico
20240315,2021,8,Cusco,Parque Arqueologico Macchu Picchu (Ruta 5: Camino Iinka: Chanchabamba Km. 104),8,Agosto,0,0,0,0,0,0,37,7,0,44,0,0,0,0,0,0,0,0,0,44,Sitio Arqueológico
20240315,2021,8,Cusco,Parque Arqueologico Macchu Picchu (Ruta 5: Camino Iinka: Chanchabamba Km. 104),8,Agosto,1,0,0,0,0,0,554,63,2,619,0,0,0,0,0,0,0,0,0,619,Sitio Arqueológico
20240315,2021,8,Cusco,Parque Arqueologico Macchu Picchu (Ruta 5: Camino Iinka: Chanchabamba Km. 104),8,Agosto,2,0,0,0,0,0,591,70,2,663,0,0,0,0,0,0,0,0,0,663,Sitio Arqueológico
20240315,2021,8,Cusco,Parque Arqueologico Macchu Picchu (Ruta 5: Camino Iinka: Chanchabamba Km. 104),9,Setiembre,0,0,0,0,0,0,26,0,0,26,0,0,0,0,0,0,0,0,0,26,Sitio Arqueológico
20240315,2021,8,Cusco,Parque Arqueologico Macchu Picchu (Ruta 5: Camino Iinka: Chanchabamba Km. 104),9,Setiembre,1,0,0,0,0,0,707,2,0,709,0,0,0,0,0,0,0,0,0,709,Sitio Arqueológico
20240315,2021,8,Cusco,Parque Arqueologico Macchu Picchu (Ruta 5: Camino Iinka: Chanchabamba Km. 104),9,Setiembre,2,0,0,0,0,0,733,2,0,735,0,0,0,0,0,0,0,0,0,735,Sitio Arqueológico
20240315,2021,8,Cusco,Parque Arqueologico Macchu Picchu (Ruta 5: Camino Iinka: Chanchabamba Km. 104),10,Octubre,0,0,0,0,0,0,36,10,0,46,0,0,0,0,0,0,0,0,0,46,Sitio Arqueológico
20240315,2021,8,Cusco,Parque Arqueologico Macchu Picchu (Ruta 5: Camino Iinka: Chanchabamba Km. 104),10,Octubre,1,0,0,0,0,0,667,19,0,686,0,0,0,0,0,0,0,0,0,686,Sitio Arqueológico
20240315,2021,8,Cusco,Parque Arqueologico Macchu Picchu (Ruta 5: Camino Iinka: Chanchabamba Km. 104),10,Octubre,2,0,0,0,0,0,703,29,0,732,0,0,0,0,0,0,0,0,0,732,Sitio Arqueológico
20240315,2021,8,Cusco,Parque Arqueologico Macchu Picchu (Ruta 5: Camino Iinka: Chanchabamba Km. 104),11,Noviembre,0,0,0,0,0,0,13,0,0,13,0,0,0,0,0,0,0,0,0,13,Sitio Arqueológico
20240315,2021,8,Cusco,Parque Arqueologico Macchu Picchu (Ruta 5: Camino Iinka: Chanchabamba Km. 104),11,Noviembre,1,0,0,0,0,0,583,37,0,620,0,0,0,0,0,0,0,0,0,620,Sitio Arqueológico
20240315,2021,8,Cusco,Parque Arqueologico Macchu Picchu (Ruta 5: Camino Iinka: Chanchabamba Km. 104),11,Noviembre,2,0,0,0,0,0,596,37,0,633,0,0,0,0,0,0,0,0,0,633,Sitio Arqueológico
20240315,2021,8,Cusco,Parque Arqueologico Macchu Picchu (Ruta 5: Camino Iinka: Chanchabamba Km. 104),12,Diciembre,0,0,0,0,0,0,20,0,0,20,0,0,0,0,0,0,0,0,0,20,Sitio Arqueológico
20240315,2021,8,Cusco,Parque Arqueologico Macchu Picchu (Ruta 5: Camino Iinka: Chanchabamba Km. 104),12,Diciembre,1,0,0,0,0,0,670,51,39,760,0,0,0,0,0,0,0,0,0,760,Sitio Arqueológico
20240315,2021,8,Cusco,Parque Arqueologico Macchu Picchu (Ruta 5: Camino Iinka: Chanchabamba Km. 104),12,Diciembre,2,0,0,0,0,0,690,51,39,780,0,0,0,0,0,0,0,0,0,780,Sitio Arqueológico
20240315,2021,8,Cusco,Monumento Arqueologico de Raqchi,1,Enero,0,0,0,0,0,0,166,202,0,368,0,0,0,0,0,840,172,45,1057,1425,Sitio Arqueológico
20240315,2021,8,Cusco,Monumento Arqueologico de Raqchi,1,Enero,1,0,0,0,0,0,0,0,0,0,0,0,0,0,0,0,0,0,0,0,Sitio Arqueológico
20240315,2021,8,Cusco,Monumento Arqueologico de Raqchi,1,Enero,2,0,0,0,0,0,166,202,0,368,0,0,0,0,0,840,172,45,1057,1425,Sitio Arqueológico
20240315,2021,8,Cusco,Monumento Arqueologico de Raqchi,2,Febrero,0,0,0,0,0,0,0,0,0,0,0,0,0,0,0,0,0,0,0,0,Sitio Arqueológico
20240315,2021,8,Cusco,Monumento Arqueologico de Raqchi,2,Febrero,1,0,0,0,0,0,0,0,0,0,0,0,0,0,0,0,0,0,0,0,Sitio Arqueológico
20240315,2021,8,Cusco,Monumento Arqueologico de Raqchi,2,Febrero,2,0,0,0,0,0,0,0,0,0,0,0,0,0,0,0,0,0,0,0,Sitio Arqueológico
20240315,2021,8,Cusco,Monumento Arqueologico de Raqchi,3,Marzo,0,0,0,0,0,0,84,162,0,246,0,0,0,0,0,359,50,16,425,671,Sitio Arqueológico
20240315,2021,8,Cusco,Monumento Arqueologico de Raqchi,3,Marzo,1,0,0,0,0,0,0,0,0,0,0,0,0,0,0,0,0,0,0,0,Sitio Arqueológico
20240315,2021,8,Cusco,Monumento Arqueologico de Raqchi,3,Marzo,2,0,0,0,0,0,84,162,0,246,0,0,0,0,0,359,50,16,425,671,Sitio Arqueológico
20240315,2021,8,Cusco,Monumento Arqueologico de Raqchi,4,Abril,0,0,0,0,0,0,98,141,0,239,0,0,0,0,0,395,74,14,483,722,Sitio Arqueológico
20240315,2021,8,Cusco,Monumento Arqueologico de Raqchi,4,Abril,1,0,0,0,0,0,0,0,0,0,0,0,0,0,0,0,0,0,0,0,Sitio Arqueológico
20240315,2021,8,Cusco,Monumento Arqueologico de Raqchi,4,Abril,2,0,0,0,0,0,98,141,0,239,0,0,0,0,0,395,74,14,483,722,Sitio Arqueológico
20240315,2021,8,Cusco,Monumento Arqueologico de Raqchi,5,Mayo,0,0,0,0,0,0,149,184,0,333,0,0,0,0,0,311,58,20,389,722,Sitio Arqueológico
20240315,2021,8,Cusco,Monumento Arqueologico de Raqchi,5,Mayo,1,0,0,0,0,0,10,0,0,10,0,0,0,0,0,0,0,0,0,10,Sitio Arqueológico
20240315,2021,8,Cusco,Monumento Arqueologico de Raqchi,5,Mayo,2,0,0,0,0,0,159,184,0,343,0,0,0,0,0,311,58,20,389,732,Sitio Arqueológico
20240315,2021,8,Cusco,Monumento Arqueologico de Raqchi,6,Junio,0,0,0,0,0,0,229,231,0,460,0,0,0,0,0,250,49,11,310,770,Sitio Arqueológico
20240315,2021,8,Cusco,Monumento Arqueologico de Raqchi,6,Junio,1,0,0,0,0,0,32,0,0,32,0,0,0,0,0,0,0,0,0,32,Sitio Arqueológico
20240315,2021,8,Cusco,Monumento Arqueologico de Raqchi,6,Junio,2,0,0,0,0,0,261,231,0,492,0,0,0,0,0,250,49,11,310,802,Sitio Arqueológico
20240315,2021,8,Cusco,Monumento Arqueologico de Raqchi,7,Julio,0,0,0,0,0,0,308,317,0,625,0,0,0,0,0,363,133,61,557,1182,Sitio Arqueológico
20240315,2021,8,Cusco,Monumento Arqueologico de Raqchi,7,Julio,1,0,0,0,0,0,142,23,0,165,0,0,0,0,0,0,0,0,0,165,Sitio Arqueológico
20240315,2021,8,Cusco,Monumento Arqueologico de Raqchi,7,Julio,2,0,0,0,0,0,450,340,0,790,0,0,0,0,0,363,133,61,557,1347,Sitio Arqueológico
20240315,2021,8,Cusco,Monumento Arqueologico de Raqchi,8,Agosto,0,0,0,0,0,0,422,473,0,895,0,0,0,0,0,336,86,21,443,1338,Sitio Arqueológico
20240315,2021,8,Cusco,Monumento Arqueologico de Raqchi,8,Agosto,1,0,0,0,0,0,0,106,588,694,0,0,0,0,0,0,0,0,0,694,Sitio Arqueológico
20240315,2021,8,Cusco,Monumento Arqueologico de Raqchi,8,Agosto,2,0,0,0,0,0,422,579,588,1589,0,0,0,0,0,336,86,21,443,2032,Sitio Arqueológico
20240315,2021,8,Cusco,Monumento Arqueologico de Raqchi,9,Setiembre,0,0,0,0,0,0,449,377,0,826,0,0,0,0,0,352,110,34,496,1322,Sitio Arqueológico
20240315,2021,8,Cusco,Monumento Arqueologico de Raqchi,9,Setiembre,1,0,0,0,0,0,911,49,0,960,0,0,0,0,0,0,0,0,0,960,Sitio Arqueológico
20240315,2021,8,Cusco,Monumento Arqueologico de Raqchi,9,Setiembre,2,0,0,0,0,0,1360,426,0,1786,0,0,0,0,0,352,110,34,496,2282,Sitio Arqueológico
20240315,2021,8,Cusco,Monumento Arqueologico de Raqchi,10,Octubre,0,0,0,0,0,0,278,402,0,680,0,0,0,0,0,368,94,25,487,1167,Sitio Arqueológico
20240315,2021,8,Cusco,Monumento Arqueologico de Raqchi,10,Octubre,1,0,0,0,0,0,1505,17,0,1522,0,0,0,0,0,0,0,0,0,1522,Sitio Arqueológico
20240315,2021,8,Cusco,Monumento Arqueologico de Raqchi,10,Octubre,2,0,0,0,0,0,1783,419,0,2202,0,0,0,0,0,368,94,25,487,2689,Sitio Arqueológico
20240315,2021,8,Cusco,Monumento Arqueologico de Raqchi,11,Noviembre,0,0,0,0,0,0,302,246,0,548,0,0,0,0,0,383,74,12,469,1017,Sitio Arqueológico
20240315,2021,8,Cusco,Monumento Arqueologico de Raqchi,11,Noviembre,1,0,0,0,0,0,1480,78,0,1558,0,0,0,0,0,0,0,0,0,1558,Sitio Arqueológico
20240315,2021,8,Cusco,Monumento Arqueologico de Raqchi,11,Noviembre,2,0,0,0,0,0,1782,324,0,2106,0,0,0,0,0,383,74,12,469,2575,Sitio Arqueológico
20240315,2021,8,Cusco,Monumento Arqueologico de Raqchi,12,Diciembre,0,0,0,0,0,0,222,197,0,419,0,0,0,0,0,615,149,40,804,1223,Sitio Arqueológico
20240315,2021,8,Cusco,Monumento Arqueologico de Raqchi,12,Diciembre,1,0,0,0,0,0,138,51,0,189,0,0,0,0,0,0,0,0,0,189,Sitio Arqueológico
20240315,2021,8,Cusco,Monumento Arqueologico de Raqchi,12,Diciembre,2,0,0,0,0,0,360,248,0,608,0,0,0,0,0,615,149,40,804,1412,Sitio Arqueológico
20240315,2021,8,Cusco,Monumento Arqueologico de Moray,1,Enero,0,0,0,0,0,216,3399,1586,214,5415,0,0,0,0,85,2487,754,268,3594,9009,Sitio Arqueológico
20240315,2021,8,Cusco,Monumento Arqueologico de Moray,1,Enero,1,0,0,0,0,14,314,137,6,471,0,0,0,0,0,375,150,70,595,1066,Sitio Arqueológico
20240315,2021,8,Cusco,Monumento Arqueologico de Moray,1,Enero,2,0,0,0,0,230,3713,1723,220,5886,0,0,0,0,85,2862,904,338,4189,10075,Sitio Arqueológico
20240315,2021,8,Cusco,Monumento Arqueologico de Moray,2,Febrero,0,0,0,0,0,0,0,0,0,0,0,0,0,0,0,0,0,0,0,0,Sitio Arqueológico
20240315,2021,8,Cusco,Monumento Arqueologico de Moray,2,Febrero,1,0,0,0,0,0,0,0,0,0,0,0,0,0,0,0,0,0,0,0,Sitio Arqueológico
20240315,2021,8,Cusco,Monumento Arqueologico de Moray,2,Febrero,2,0,0,0,0,0,0,0,0,0,0,0,0,0,0,0,0,0,0,0,Sitio Arqueológico
20240315,2021,8,Cusco,Monumento Arqueologico de Moray,3,Marzo,0,0,0,0,53,183,1794,457,98,2585,0,0,0,0,56,757,344,57,1214,3799,Sitio Arqueológico
20240315,2021,8,Cusco,Monumento Arqueologico de Moray,3,Marzo,1,0,0,0,0,4,511,73,6,594,0,0,0,0,0,0,0,32,32,626,Sitio Arqueológico
20240315,2021,8,Cusco,Monumento Arqueologico de Moray,3,Marzo,2,0,0,0,53,187,2305,530,104,3179,0,0,0,0,56,757,344,89,1246,4425,Sitio Arqueológico
20240315,2021,8,Cusco,Monumento Arqueologico de Moray,4,Abril,0,0,0,0,0,326,2184,502,153,3165,0,0,0,0,0,466,168,31,665,3830,Sitio Arqueológico
20240315,2021,8,Cusco,Monumento Arqueologico de Moray,4,Abril,1,0,0,0,0,22,908,61,4,995,0,0,0,0,0,0,0,0,0,995,Sitio Arqueológico
20240315,2021,8,Cusco,Monumento Arqueologico de Moray,4,Abril,2,0,0,0,0,348,3092,563,157,4160,0,0,0,0,0,466,168,31,665,4825,Sitio Arqueológico
20240315,2021,8,Cusco,Monumento Arqueologico de Moray,5,Mayo,0,0,0,0,0,751,5815,1386,362,8314,0,0,0,0,39,606,225,40,910,9224,Sitio Arqueológico
20240315,2021,8,Cusco,Monumento Arqueologico de Moray,5,Mayo,1,0,0,0,0,0,3483,437,91,4011,0,0,0,0,0,0,0,420,420,4431,Sitio Arqueológico
20240315,2021,8,Cusco,Monumento Arqueologico de Moray,5,Mayo,2,0,0,0,0,751,9298,1823,453,12325,0,0,0,0,39,606,225,460,1330,13655,Sitio Arqueológico
20240315,2021,8,Cusco,Monumento Arqueologico de Moray,6,Junio,0,0,0,0,0,0,1396,230,0,1626,0,0,0,0,75,883,103,53,1114,2740,Sitio Arqueológico
20240315,2021,8,Cusco,Monumento Arqueologico de Moray,6,Junio,1,0,0,0,0,0,220,18,0,238,0,0,0,0,0,0,0,0,0,238,Sitio Arqueológico
20240315,2021,8,Cusco,Monumento Arqueologico de Moray,6,Junio,2,0,0,0,0,0,1616,248,0,1864,0,0,0,0,75,883,103,53,1114,2978,Sitio Arqueológico
20240315,2021,8,Cusco,Monumento Arqueologico de Moray,7,Julio,0,0,0,0,0,1639,14195,3715,956,20505,0,0,0,0,145,1416,367,95,2023,22528,Sitio Arqueológico
20240315,2021,8,Cusco,Monumento Arqueologico de Moray,7,Julio,1,0,0,0,0,1174,7730,1508,426,10838,0,0,0,0,0,0,0,0,0,10838,Sitio Arqueológico
20240315,2021,8,Cusco,Monumento Arqueologico de Moray,7,Julio,2,0,0,0,0,2813,21925,5223,1382,31343,0,0,0,0,145,1416,367,95,2023,33366,Sitio Arqueológico
20240315,2021,8,Cusco,Monumento Arqueologico de Moray,8,Agosto,0,0,0,0,0,1924,17529,4515,1150,25118,0,0,0,0,366,2304,684,333,3687,28805,Sitio Arqueológico
20240315,2021,8,Cusco,Monumento Arqueologico de Moray,8,Agosto,1,0,0,0,0,1354,7651,1568,450,11023,0,0,0,0,0,0,0,0,0,11023,Sitio Arqueológico
20240315,2021,8,Cusco,Monumento Arqueologico de Moray,8,Agosto,2,0,0,0,0,3278,25180,6083,1600,36141,0,0,0,0,366,2304,684,333,3687,39828,Sitio Arqueológico
20240315,2021,8,Cusco,Monumento Arqueologico de Moray,9,Setiembre,0,0,0,0,0,1395,16169,3639,732,21935,0,0,0,0,135,1373,233,80,1821,23756,Sitio Arqueológico
20240315,2021,8,Cusco,Monumento Arqueologico de Moray,9,Setiembre,1,0,0,0,0,816,7459,843,175,9293,0,0,0,0,0,0,0,0,0,9293,Sitio Arqueológico
20240315,2021,8,Cusco,Monumento Arqueologico de Moray,9,Setiembre,2,0,0,0,0,2211,23628,4482,907,31228,0,0,0,0,135,1373,233,80,1821,33049,Sitio Arqueológico
20240315,2021,8,Cusco,Monumento Arqueologico de Moray,10,Octubre,0,0,0,0,0,1382,20116,5455,902,27855,0,0,0,0,106,1571,272,60,2009,29864,Sitio Arqueológico
20240315,2021,8,Cusco,Monumento Arqueologico de Moray,10,Octubre,1,0,0,0,0,837,10814,1394,213,13258,0,0,0,0,0,0,0,0,0,13258,Sitio Arqueológico
20240315,2021,8,Cusco,Monumento Arqueologico de Moray,10,Octubre,2,0,0,0,0,2219,30930,6849,1115,41113,0,0,0,0,106,1571,272,60,2009,43122,Sitio Arqueológico
20240315,2021,8,Cusco,Monumento Arqueologico de Moray,11,Noviembre,0,0,0,0,0,1208,14227,3825,665,19925,0,0,0,0,129,1183,313,117,1742,21667,Sitio Arqueológico
20240315,2021,8,Cusco,Monumento Arqueologico de Moray,11,Noviembre,1,0,0,0,0,867,10158,948,162,12135,0,0,0,0,0,0,0,0,0,12135,Sitio Arqueológico
20240315,2021,8,Cusco,Monumento Arqueologico de Moray,11,Noviembre,2,0,0,0,0,2075,24385,4773,827,32060,0,0,0,0,129,1183,313,117,1742,33802,Sitio Arqueológico
20240315,2021,8,Cusco,Monumento Arqueologico de Moray,12,Diciembre,0,0,0,0,0,1001,10309,2834,504,14648,0,0,0,0,121,1136,374,101,1732,16380,Sitio Arqueológico
20240315,2021,8,Cusco,Monumento Arqueologico de Moray,12,Diciembre,1,0,0,0,0,909,9000,1382,220,11511,0,0,0,0,0,0,0,0,0,11511,Sitio Arqueológico
20240315,2021,8,Cusco,Monumento Arqueologico de Moray,12,Diciembre,2,0,0,0,0,1910,19309,4216,724,26159,0,0,0,0,121,1136,374,101,1732,27891,Sitio Arqueológico
20240315,2021,8,Cusco,Parque Arqueologico Tipon,1,Enero,0,0,0,0,0,0,806,228,0,1034,0,0,0,0,134,2441,281,46,2902,3936,Sitio Arqueológico
20240315,2021,8,Cusco,Parque Arqueologico Tipon,1,Enero,1,0,0,0,0,0,16,7,0,23,0,0,0,0,0,68,1,0,69,92,Sitio Arqueológico
20240315,2021,8,Cusco,Parque Arqueologico Tipon,1,Enero,2,0,0,0,0,0,822,235,0,1057,0,0,0,0,134,2509,282,46,2971,4028,Sitio Arqueológico
20240315,2021,8,Cusco,Parque Arqueologico Tipon,2,Febrero,0,0,0,0,0,0,0,0,0,0,0,0,0,0,0,0,0,0,0,0,Sitio Arqueológico
20240315,2021,8,Cusco,Parque Arqueologico Tipon,2,Febrero,1,0,0,0,0,0,0,0,0,0,0,0,0,0,0,0,0,0,0,0,Sitio Arqueológico
20240315,2021,8,Cusco,Parque Arqueologico Tipon,2,Febrero,2,0,0,0,0,0,0,0,0,0,0,0,0,0,0,0,0,0,0,0,Sitio Arqueológico
20240315,2021,8,Cusco,Parque Arqueologico Tipon,3,Marzo,0,0,0,0,0,0,324,101,0,425,0,0,0,0,62,756,131,37,986,1411,Sitio Arqueológico
20240315,2021,8,Cusco,Parque Arqueologico Tipon,3,Marzo,1,0,0,0,0,0,20,0,0,20,0,0,0,0,0,0,0,0,0,20,Sitio Arqueológico
20240315,2021,8,Cusco,Parque Arqueologico Tipon,3,Marzo,2,0,0,0,0,0,344,101,0,445,0,0,0,0,62,756,131,37,986,1431,Sitio Arqueológico
20240315,2021,8,Cusco,Parque Arqueologico Tipon,4,Abril,0,0,0,0,0,0,405,69,0,474,0,0,0,0,43,547,58,24,672,1146,Sitio Arqueológico
20240315,2021,8,Cusco,Parque Arqueologico Tipon,4,Abril,1,0,0,0,0,0,50,1,0,51,0,0,0,0,0,0,0,0,0,51,Sitio Arqueológico
20240315,2021,8,Cusco,Parque Arqueologico Tipon,4,Abril,2,0,0,0,0,0,455,70,0,525,0,0,0,0,43,547,58,24,672,1197,Sitio Arqueológico
20240315,2021,8,Cusco,Parque Arqueologico Tipon,5,Mayo,0,0,0,0,0,0,1264,254,0,1518,0,0,0,0,87,800,93,34,1014,2532,Sitio Arqueológico
20240315,2021,8,Cusco,Parque Arqueologico Tipon,5,Mayo,1,0,0,0,0,0,109,15,0,124,0,0,0,0,0,0,0,0,0,124,Sitio Arqueológico
20240315,2021,8,Cusco,Parque Arqueologico Tipon,5,Mayo,2,0,0,0,0,0,1373,269,0,1642,0,0,0,0,87,800,93,34,1014,2656,Sitio Arqueológico
20240315,2021,8,Cusco,Parque Arqueologico Tipon,6,Junio,0,0,0,0,0,0,1396,230,0,1626,0,0,0,0,75,883,103,53,1114,2740,Sitio Arqueológico
20240315,2021,8,Cusco,Parque Arqueologico Tipon,6,Junio,1,0,0,0,0,0,220,18,0,238,0,0,0,0,0,0,0,0,0,238,Sitio Arqueológico
20240315,2021,8,Cusco,Parque Arqueologico Tipon,6,Junio,2,0,0,0,0,0,1616,248,0,1864,0,0,0,0,75,883,103,53,1114,2978,Sitio Arqueológico
20240315,2021,8,Cusco,Parque Arqueologico Tipon,7,Julio,0,0,0,0,0,0,3485,904,0,4389,0,0,0,0,160,1401,187,98,1846,6235,Sitio Arqueológico
20240315,2021,8,Cusco,Parque Arqueologico Tipon,7,Julio,1,0,0,0,0,0,298,77,0,375,0,0,0,0,0,0,0,0,0,375,Sitio Arqueológico
20240315,2021,8,Cusco,Parque Arqueologico Tipon,7,Julio,2,0,0,0,0,0,3783,981,0,4764,0,0,0,0,160,1401,187,98,1846,6610,Sitio Arqueológico
20240315,2021,8,Cusco,Parque Arqueologico Tipon,8,Agosto,0,0,0,0,0,0,5574,1499,0,7073,0,0,0,0,189,1721,220,57,2187,9260,Sitio Arqueológico
20240315,2021,8,Cusco,Parque Arqueologico Tipon,8,Agosto,1,0,0,0,0,0,317,43,0,360,0,0,0,0,0,0,0,0,0,360,Sitio Arqueológico
20240315,2021,8,Cusco,Parque Arqueologico Tipon,8,Agosto,2,0,0,0,0,0,5891,1542,0,7433,0,0,0,0,189,1721,220,57,2187,9620,Sitio Arqueológico
20240315,2021,8,Cusco,Parque Arqueologico Tipon,9,Setiembre,0,0,0,0,0,0,4414,760,0,5174,0,0,0,0,189,1337,208,25,1759,6933,Sitio Arqueológico
20240315,2021,8,Cusco,Parque Arqueologico Tipon,9,Setiembre,1,0,0,0,0,0,332,14,0,346,0,0,0,0,0,0,0,0,0,346,Sitio Arqueológico
20240315,2021,8,Cusco,Parque Arqueologico Tipon,9,Setiembre,2,0,0,0,0,0,4746,774,0,5520,0,0,0,0,189,1337,208,25,1759,7279,Sitio Arqueológico
20240315,2021,8,Cusco,Parque Arqueologico Tipon,10,Octubre,0,0,0,0,0,0,5836,1278,0,7114,0,0,0,0,0,1701,203,109,2013,9127,Sitio Arqueológico
20240315,2021,8,Cusco,Parque Arqueologico Tipon,10,Octubre,1,0,0,0,0,0,603,64,0,667,0,0,0,0,0,0,0,0,0,667,Sitio Arqueológico
20240315,2021,8,Cusco,Parque Arqueologico Tipon,10,Octubre,2,0,0,0,0,0,6439,1342,0,7781,0,0,0,0,0,1701,203,109,2013,9794,Sitio Arqueológico
20240315,2021,8,Cusco,Parque Arqueologico Tipon,11,Noviembre,0,0,0,0,0,0,3437,634,0,4071,0,0,0,0,148,1423,213,61,1845,5916,Sitio Arqueológico
20240315,2021,8,Cusco,Parque Arqueologico Tipon,11,Noviembre,1,0,0,0,0,0,636,44,0,680,0,0,0,0,0,0,0,0,0,680,Sitio Arqueológico
20240315,2021,8,Cusco,Parque Arqueologico Tipon,11,Noviembre,2,0,0,0,0,0,4073,678,0,4751,0,0,0,0,148,1423,213,61,1845,6596,Sitio Arqueológico
20240315,2021,8,Cusco,Parque Arqueologico Tipon,12,Diciembre,0,0,0,0,0,0,2590,521,0,3111,0,0,0,0,174,1383,246,81,1884,4995,Sitio Arqueológico
20240315,2021,8,Cusco,Parque Arqueologico Tipon,12,Diciembre,1,0,0,0,0,0,675,56,0,731,0,0,0,0,0,0,0,0,0,731,Sitio Arqueológico
20240315,2021,8,Cusco,Parque Arqueologico Tipon,12,Diciembre,2,0,0,0,0,0,3265,577,0,3842,0,0,0,0,174,1383,246,81,1884,5726,Sitio Arqueológico
20240315,2021,8,Cusco,Monumento Arqueologico de Tarawasi,1,Enero,0,0,0,0,0,0,22,8,0,30,0,0,0,0,0,0,0,0,0,30,Sitio Arqueológico
20240315,2021,8,Cusco,Monumento Arqueologico de Tarawasi,1,Enero,1,0,0,0,0,0,0,0,0,0,0,0,0,0,0,0,0,0,0,0,Sitio Arqueológico
20240315,2021,8,Cusco,Monumento Arqueologico de Tarawasi,1,Enero,2,0,0,0,0,0,22,8,0,30,0,0,0,0,0,0,0,0,0,30,Sitio Arqueológico
20240315,2021,8,Cusco,Monumento Arqueologico de Tarawasi,2,Febrero,0,0,0,0,0,0,0,0,0,0,0,0,0,0,0,0,0,0,0,0,Sitio Arqueológico
20240315,2021,8,Cusco,Monumento Arqueologico de Tarawasi,2,Febrero,1,0,0,0,0,0,0,0,0,0,0,0,0,0,0,0,0,0,0,0,Sitio Arqueológico
20240315,2021,8,Cusco,Monumento Arqueologico de Tarawasi,2,Febrero,2,0,0,0,0,0,0,0,0,0,0,0,0,0,0,0,0,0,0,0,Sitio Arqueológico
20240315,2021,8,Cusco,Monumento Arqueologico de Tarawasi,3,Marzo,0,0,0,0,0,0,21,7,0,28,0,0,0,0,0,0,0,0,0,28,Sitio Arqueológico
20240315,2021,8,Cusco,Monumento Arqueologico de Tarawasi,3,Marzo,1,0,0,0,0,0,0,0,0,0,0,0,0,0,0,0,0,0,0,0,Sitio Arqueológico
20240315,2021,8,Cusco,Monumento Arqueologico de Tarawasi,3,Marzo,2,0,0,0,0,0,21,7,0,28,0,0,0,0,0,0,0,0,0,28,Sitio Arqueológico
20240315,2021,8,Cusco,Monumento Arqueologico de Tarawasi,4,Abril,0,0,0,0,0,0,26,4,0,30,0,0,0,0,0,0,0,0,0,30,Sitio Arqueológico
20240315,2021,8,Cusco,Monumento Arqueologico de Tarawasi,4,Abril,1,0,0,0,0,0,0,0,0,0,0,0,0,0,0,0,0,0,0,0,Sitio Arqueológico
20240315,2021,8,Cusco,Monumento Arqueologico de Tarawasi,4,Abril,2,0,0,0,0,0,26,4,0,30,0,0,0,0,0,0,0,0,0,30,Sitio Arqueológico
20240315,2021,8,Cusco,Monumento Arqueologico de Tarawasi,5,Mayo,0,0,0,0,0,0,26,4,0,30,0,0,0,0,0,0,0,0,0,30,Sitio Arqueológico
20240315,2021,8,Cusco,Monumento Arqueologico de Tarawasi,5,Mayo,1,0,0,0,0,0,0,0,0,0,0,0,0,0,0,0,0,0,0,0,Sitio Arqueológico
20240315,2021,8,Cusco,Monumento Arqueologico de Tarawasi,5,Mayo,2,0,0,0,0,0,26,4,0,30,0,0,0,0,0,0,0,0,0,30,Sitio Arqueológico
20240315,2021,8,Cusco,Monumento Arqueologico de Tarawasi,6,Junio,0,0,0,0,0,0,29,0,0,29,0,0,0,0,0,0,0,0,0,29,Sitio Arqueológico
20240315,2021,8,Cusco,Monumento Arqueologico de Tarawasi,6,Junio,1,0,0,0,0,0,0,0,0,0,0,0,0,0,0,0,0,0,0,0,Sitio Arqueológico
20240315,2021,8,Cusco,Monumento Arqueologico de Tarawasi,6,Junio,2,0,0,0,0,0,29,0,0,29,0,0,0,0,0,0,0,0,0,29,Sitio Arqueológico
20240315,2021,8,Cusco,Monumento Arqueologico de Tarawasi,7,Julio,0,0,0,0,0,0,39,1,0,40,0,0,0,0,0,0,0,0,0,40,Sitio Arqueológico
20240315,2021,8,Cusco,Monumento Arqueologico de Tarawasi,7,Julio,1,0,0,0,0,0,0,0,0,0,0,0,0,0,0,0,0,0,0,0,Sitio Arqueológico
20240315,2021,8,Cusco,Monumento Arqueologico de Tarawasi,7,Julio,2,0,0,0,0,0,39,1,0,40,0,0,0,0,0,0,0,0,0,40,Sitio Arqueológico
20240315,2021,8,Cusco,Monumento Arqueologico de Tarawasi,8,Agosto,0,0,0,0,0,0,31,15,0,46,0,0,0,0,0,0,0,0,0,46,Sitio Arqueológico
20240315,2021,8,Cusco,Monumento Arqueologico de Tarawasi,8,Agosto,1,0,0,0,0,0,0,0,0,0,0,0,0,0,0,0,0,0,0,0,Sitio Arqueológico
20240315,2021,8,Cusco,Monumento Arqueologico de Tarawasi,8,Agosto,2,0,0,0,0,0,31,15,0,46,0,0,0,0,0,0,0,0,0,46,Sitio Arqueológico
20240315,2021,8,Cusco,Monumento Arqueologico de Tarawasi,9,Setiembre,0,0,0,0,0,0,40,7,0,47,0,0,0,0,0,0,0,0,0,47,Sitio Arqueológico
20240315,2021,8,Cusco,Monumento Arqueologico de Tarawasi,9,Setiembre,1,0,0,0,0,0,0,0,0,0,0,0,0,0,0,0,0,0,0,0,Sitio Arqueológico
20240315,2021,8,Cusco,Monumento Arqueologico de Tarawasi,9,Setiembre,2,0,0,0,0,0,40,7,0,47,0,0,0,0,0,0,0,0,0,47,Sitio Arqueológico
20240315,2021,8,Cusco,Monumento Arqueologico de Tarawasi,10,Octubre,0,0,0,0,0,0,31,7,0,38,0,0,0,0,0,91,180,35,306,344,Sitio Arqueológico
20240315,2021,8,Cusco,Monumento Arqueologico de Tarawasi,10,Octubre,1,0,0,0,0,0,30,0,0,30,0,0,0,0,0,0,0,0,0,30,Sitio Arqueológico
20240315,2021,8,Cusco,Monumento Arqueologico de Tarawasi,10,Octubre,2,0,0,0,0,0,61,7,0,68,0,0,0,0,0,91,180,35,306,374,Sitio Arqueológico
20240315,2021,8,Cusco,Monumento Arqueologico de Tarawasi,11,Noviembre,0,0,0,0,0,0,0,0,0,0,0,0,0,0,0,45,118,18,181,181,Sitio Arqueológico
20240315,2021,8,Cusco,Monumento Arqueologico de Tarawasi,11,Noviembre,1,0,0,0,0,0,17,1,0,18,0,0,0,0,0,0,0,0,0,18,Sitio Arqueológico
20240315,2021,8,Cusco,Monumento Arqueologico de Tarawasi,11,Noviembre,2,0,0,0,0,0,17,1,0,18,0,0,0,0,0,45,118,18,181,199,Sitio Arqueológico
20240315,2021,8,Cusco,Monumento Arqueologico de Tarawasi,12,Diciembre,0,0,0,0,0,0,31,7,0,38,0,0,0,0,0,67,130,32,229,267,Sitio Arqueológico
20240315,2021,8,Cusco,Monumento Arqueologico de Tarawasi,12,Diciembre,1,0,0,0,0,0,31,3,0,34,0,0,0,0,0,0,0,0,0,34,Sitio Arqueológico
20240315,2021,8,Cusco,Monumento Arqueologico de Tarawasi,12,Diciembre,2,0,0,0,0,0,62,10,0,72,0,0,0,0,0,67,130,32,229,301,Sitio Arqueológico
20240315,2021,8,Cusco,Parque Arqueologico Nacional de Vilcabamba (Choquequirao),1,Enero,0,0,0,0,0,0,36,39,0,75,0,0,0,0,0,0,0,0,0,75,Sitio Arqueológico
20240315,2021,8,Cusco,Parque Arqueologico Nacional de Vilcabamba (Choquequirao),1,Enero,1,0,0,0,0,0,4,1,0,5,0,0,0,0,0,0,0,0,0,5,Sitio Arqueológico
20240315,2021,8,Cusco,Parque Arqueologico Nacional de Vilcabamba (Choquequirao),1,Enero,2,0,0,0,0,0,40,40,0,80,0,0,0,0,0,0,0,0,0,80,Sitio Arqueológico
20240315,2021,8,Cusco,Parque Arqueologico Nacional de Vilcabamba (Choquequirao),2,Febrero,0,0,0,0,0,0,0,0,0,0,0,0,0,0,0,0,0,0,0,0,Sitio Arqueológico
20240315,2021,8,Cusco,Parque Arqueologico Nacional de Vilcabamba (Choquequirao),2,Febrero,1,0,0,0,0,0,0,0,0,0,0,0,0,0,0,0,0,0,0,0,Sitio Arqueológico
20240315,2021,8,Cusco,Parque Arqueologico Nacional de Vilcabamba (Choquequirao),2,Febrero,2,0,0,0,0,0,0,0,0,0,0,0,0,0,0,0,0,0,0,0,Sitio Arqueológico
20240315,2021,8,Cusco,Parque Arqueologico Nacional de Vilcabamba (Choquequirao),3,Marzo,0,0,0,0,0,0,28,25,0,53,0,0,0,0,0,0,0,0,0,53,Sitio Arqueológico
20240315,2021,8,Cusco,Parque Arqueologico Nacional de Vilcabamba (Choquequirao),3,Marzo,1,0,0,0,0,0,2,0,0,2,0,0,0,0,0,0,0,0,0,2,Sitio Arqueológico
20240315,2021,8,Cusco,Parque Arqueologico Nacional de Vilcabamba (Choquequirao),3,Marzo,2,0,0,0,0,0,30,25,0,55,0,0,0,0,0,0,0,0,0,55,Sitio Arqueológico
20240315,2021,8,Cusco,Parque Arqueologico Nacional de Vilcabamba (Choquequirao),4,Abril,0,0,0,0,0,0,95,29,0,124,0,0,0,0,0,7,4,1,12,136,Sitio Arqueológico
20240315,2021,8,Cusco,Parque Arqueologico Nacional de Vilcabamba (Choquequirao),4,Abril,1,0,0,0,0,0,17,5,0,22,0,0,0,0,0,0,0,0,0,22,Sitio Arqueológico
20240315,2021,8,Cusco,Parque Arqueologico Nacional de Vilcabamba (Choquequirao),4,Abril,2,0,0,0,0,0,112,34,0,146,0,0,0,0,0,7,4,1,12,158,Sitio Arqueológico
20240315,2021,8,Cusco,Parque Arqueologico Nacional de Vilcabamba (Choquequirao),5,Mayo,0,0,0,0,0,0,95,29,0,124,0,0,0,0,0,7,4,1,12,136,Sitio Arqueológico
20240315,2021,8,Cusco,Parque Arqueologico Nacional de Vilcabamba (Choquequirao),5,Mayo,1,0,0,0,0,0,17,5,0,22,0,0,0,0,0,0,0,0,0,22,Sitio Arqueológico
20240315,2021,8,Cusco,Parque Arqueologico Nacional de Vilcabamba (Choquequirao),5,Mayo,2,0,0,0,0,0,112,34,0,146,0,0,0,0,0,7,4,1,12,158,Sitio Arqueológico
20240315,2021,8,Cusco,Parque Arqueologico Nacional de Vilcabamba (Choquequirao),6,Junio,0,0,0,0,0,0,118,76,0,194,0,0,0,0,0,20,11,2,33,227,Sitio Arqueológico
20240315,2021,8,Cusco,Parque Arqueologico Nacional de Vilcabamba (Choquequirao),6,Junio,1,0,0,0,0,0,43,0,0,43,0,0,0,0,0,0,0,0,0,43,Sitio Arqueológico
20240315,2021,8,Cusco,Parque Arqueologico Nacional de Vilcabamba (Choquequirao),6,Junio,2,0,0,0,0,0,161,76,0,237,0,0,0,0,0,20,11,2,33,270,Sitio Arqueológico
20240315,2021,8,Cusco,Parque Arqueologico Nacional de Vilcabamba (Choquequirao),7,Julio,0,0,0,0,0,0,343,268,0,611,0,0,0,0,0,131,49,2,182,793,Sitio Arqueológico
20240315,2021,8,Cusco,Parque Arqueologico Nacional de Vilcabamba (Choquequirao),7,Julio,1,0,0,0,0,0,81,24,0,105,0,0,0,0,0,0,0,0,0,105,Sitio Arqueológico
20240315,2021,8,Cusco,Parque Arqueologico Nacional de Vilcabamba (Choquequirao),7,Julio,2,0,0,0,0,0,424,292,0,716,0,0,0,0,0,131,49,2,182,898,Sitio Arqueológico
20240315,2021,8,Cusco,Parque Arqueologico Nacional de Vilcabamba (Choquequirao),8,Agosto,0,0,0,0,0,0,342,208,0,550,0,0,0,0,0,54,21,0,75,625,Sitio Arqueológico
20240315,2021,8,Cusco,Parque Arqueologico Nacional de Vilcabamba (Choquequirao),8,Agosto,1,0,0,0,0,0,91,16,0,107,0,0,0,0,0,0,0,0,0,107,Sitio Arqueológico
20240315,2021,8,Cusco,Parque Arqueologico Nacional de Vilcabamba (Choquequirao),8,Agosto,2,0,0,0,0,0,433,224,0,657,0,0,0,0,0,54,21,0,75,732,Sitio Arqueológico
20240315,2021,8,Cusco,Parque Arqueologico Nacional de Vilcabamba (Choquequirao),9,Setiembre,0,0,0,0,0,0,296,187,0,483,0,0,0,0,0,57,53,2,112,595,Sitio Arqueológico
20240315,2021,8,Cusco,Parque Arqueologico Nacional de Vilcabamba (Choquequirao),9,Setiembre,1,0,0,0,0,0,72,21,0,93,0,0,0,0,0,0,0,0,0,93,Sitio Arqueológico
20240315,2021,8,Cusco,Parque Arqueologico Nacional de Vilcabamba (Choquequirao),9,Setiembre,2,0,0,0,0,0,368,208,0,576,0,0,0,0,0,57,53,2,112,688,Sitio Arqueológico
20240315,2021,8,Cusco,Parque Arqueologico Nacional de Vilcabamba (Choquequirao),10,Octubre,0,0,0,0,0,0,229,232,0,461,0,0,0,0,0,57,33,0,90,551,Sitio Arqueológico
20240315,2021,8,Cusco,Parque Arqueologico Nacional de Vilcabamba (Choquequirao),10,Octubre,1,0,0,0,0,0,49,28,0,77,0,0,0,0,0,0,0,0,0,77,Sitio Arqueológico
20240315,2021,8,Cusco,Parque Arqueologico Nacional de Vilcabamba (Choquequirao),10,Octubre,2,0,0,0,0,0,278,260,0,538,0,0,0,0,0,57,33,0,90,628,Sitio Arqueológico
20240315,2021,8,Cusco,Parque Arqueologico Nacional de Vilcabamba (Choquequirao),11,Noviembre,0,0,0,0,0,0,141,92,0,233,0,0,0,0,0,10,2,0,12,245,Sitio Arqueológico
20240315,2021,8,Cusco,Parque Arqueologico Nacional de Vilcabamba (Choquequirao),11,Noviembre,1,0,0,0,0,0,138,51,0,189,0,0,0,0,0,0,0,0,0,189,Sitio Arqueológico
20240315,2021,8,Cusco,Parque Arqueologico Nacional de Vilcabamba (Choquequirao),11,Noviembre,2,0,0,0,0,0,279,143,0,422,0,0,0,0,0,10,2,0,12,434,Sitio Arqueológico
20240315,2021,8,Cusco,Parque Arqueologico Nacional de Vilcabamba (Choquequirao),12,Diciembre,0,0,0,0,0,0,66,79,0,145,0,0,0,0,0,8,16,0,24,169,Sitio Arqueológico
20240315,2021,8,Cusco,Parque Arqueologico Nacional de Vilcabamba (Choquequirao),12,Diciembre,1,0,0,0,0,0,138,51,0,189,0,0,0,0,0,0,0,0,0,189,Sitio Arqueológico
20240315,2021,8,Cusco,Parque Arqueologico Nacional de Vilcabamba (Choquequirao),12,Diciembre,2,0,0,0,0,0,204,130,0,334,0,0,0,0,0,8,16,0,24,358,Sitio Arqueológico
20240315,2021,8,Cusco,Conjunto Arqueologico de Huchuy Qosco,1,Enero,0,0,0,0,0,0,50,0,0,50,0,0,0,0,0,110,133,31,274,324,Sitio Arqueológico
20240315,2021,8,Cusco,Conjunto Arqueologico de Huchuy Qosco,1,Enero,1,0,0,0,0,0,0,0,0,0,0,0,0,0,0,0,0,0,0,0,Sitio Arqueológico
20240315,2021,8,Cusco,Conjunto Arqueologico de Huchuy Qosco,1,Enero,2,0,0,0,0,0,50,0,0,50,0,0,0,0,0,110,133,31,274,324,Sitio Arqueológico
20240315,2021,8,Cusco,Conjunto Arqueologico de Huchuy Qosco,2,Febrero,0,0,0,0,0,0,0,0,0,0,0,0,0,0,0,0,0,0,0,0,Sitio Arqueológico
20240315,2021,8,Cusco,Conjunto Arqueologico de Huchuy Qosco,2,Febrero,1,0,0,0,0,0,0,0,0,0,0,0,0,0,0,0,0,0,0,0,Sitio Arqueológico
20240315,2021,8,Cusco,Conjunto Arqueologico de Huchuy Qosco,2,Febrero,2,0,0,0,0,0,0,0,0,0,0,0,0,0,0,0,0,0,0,0,Sitio Arqueológico
20240315,2021,8,Cusco,Conjunto Arqueologico de Huchuy Qosco,3,Marzo,0,0,0,0,0,0,39,0,0,39,0,0,0,0,0,0,0,0,0,39,Sitio Arqueológico
20240315,2021,8,Cusco,Conjunto Arqueologico de Huchuy Qosco,3,Marzo,1,0,0,0,0,0,0,0,0,0,0,0,0,0,0,0,0,0,0,0,Sitio Arqueológico
20240315,2021,8,Cusco,Conjunto Arqueologico de Huchuy Qosco,3,Marzo,2,0,0,0,0,0,39,0,0,39,0,0,0,0,0,0,0,0,0,39,Sitio Arqueológico
20240315,2021,8,Cusco,Conjunto Arqueologico de Huchuy Qosco,4,Abril,0,0,0,0,0,0,62,0,0,62,0,0,0,0,0,0,0,0,0,62,Sitio Arqueológico
20240315,2021,8,Cusco,Conjunto Arqueologico de Huchuy Qosco,4,Abril,1,0,0,0,0,0,0,0,0,0,0,0,0,0,0,0,0,0,0,0,Sitio Arqueológico
20240315,2021,8,Cusco,Conjunto Arqueologico de Huchuy Qosco,4,Abril,2,0,0,0,0,0,62,0,0,62,0,0,0,0,0,0,0,0,0,62,Sitio Arqueológico
20240315,2021,8,Cusco,Conjunto Arqueologico de Huchuy Qosco,5,Mayo,0,0,0,0,0,0,79,0,0,79,0,0,0,0,0,0,0,0,0,79,Sitio Arqueológico
20240315,2021,8,Cusco,Conjunto Arqueologico de Huchuy Qosco,5,Mayo,1,0,0,0,0,0,0,0,0,0,0,0,0,0,0,0,0,0,0,0,Sitio Arqueológico
20240315,2021,8,Cusco,Conjunto Arqueologico de Huchuy Qosco,5,Mayo,2,0,0,0,0,0,79,0,0,79,0,0,0,0,0,0,0,0,0,79,Sitio Arqueológico
20240315,2021,8,Cusco,Conjunto Arqueologico de Huchuy Qosco,6,Junio,0,0,0,0,0,0,49,0,0,49,0,0,0,0,0,102,130,38,270,319,Sitio Arqueológico
20240315,2021,8,Cusco,Conjunto Arqueologico de Huchuy Qosco,6,Junio,1,0,0,0,0,0,32,0,0,32,0,0,0,0,0,0,0,0,0,32,Sitio Arqueológico
20240315,2021,8,Cusco,Conjunto Arqueologico de Huchuy Qosco,6,Junio,2,0,0,0,0,0,81,0,0,81,0,0,0,0,0,102,130,38,270,351,Sitio Arqueológico
20240315,2021,8,Cusco,Conjunto Arqueologico de Huchuy Qosco,7,Julio,0,0,0,0,0,0,68,0,0,68,0,0,0,0,0,92,167,36,295,363,Sitio Arqueológico
20240315,2021,8,Cusco,Conjunto Arqueologico de Huchuy Qosco,7,Julio,1,0,0,0,0,0,30,0,0,30,0,0,0,0,0,0,0,0,0,30,Sitio Arqueológico
20240315,2021,8,Cusco,Conjunto Arqueologico de Huchuy Qosco,7,Julio,2,0,0,0,0,0,98,0,0,98,0,0,0,0,0,92,167,36,295,393,Sitio Arqueológico
20240315,2021,8,Cusco,Conjunto Arqueologico de Huchuy Qosco,8,Agosto,0,0,0,0,0,0,107,0,0,107,0,0,0,0,0,92,167,36,295,402,Sitio Arqueológico
20240315,2021,8,Cusco,Conjunto Arqueologico de Huchuy Qosco,8,Agosto,1,0,0,0,0,0,0,0,0,0,0,0,0,0,0,0,0,0,0,0,Sitio Arqueológico
20240315,2021,8,Cusco,Conjunto Arqueologico de Huchuy Qosco,8,Agosto,2,0,0,0,0,0,107,0,0,107,0,0,0,0,0,92,167,36,295,402,Sitio Arqueológico
20240315,2021,8,Cusco,Conjunto Arqueologico de Huchuy Qosco,9,Setiembre,0,0,0,0,0,0,46,0,0,46,0,0,0,0,0,91,180,35,306,352,Sitio Arqueológico
20240315,2021,8,Cusco,Conjunto Arqueologico de Huchuy Qosco,9,Setiembre,1,0,0,0,0,0,56,0,0,56,0,0,0,0,0,0,0,0,0,56,Sitio Arqueológico
20240315,2021,8,Cusco,Conjunto Arqueologico de Huchuy Qosco,9,Setiembre,2,0,0,0,0,0,102,0,0,102,0,0,0,0,0,91,180,35,306,408,Sitio Arqueológico
20240315,2021,8,Cusco,Conjunto Arqueologico de Huchuy Qosco,10,Octubre,0,0,0,0,0,0,46,0,0,46,0,0,0,0,0,91,180,35,306,352,Sitio Arqueológico
20240315,2021,8,Cusco,Conjunto Arqueologico de Huchuy Qosco,10,Octubre,1,0,0,0,0,0,56,0,0,56,0,0,0,0,0,0,0,0,0,56,Sitio Arqueológico
20240315,2021,8,Cusco,Conjunto Arqueologico de Huchuy Qosco,10,Octubre,2,0,0,0,0,0,102,0,0,102,0,0,0,0,0,91,180,35,306,408,Sitio Arqueológico
20240315,2021,8,Cusco,Conjunto Arqueologico de Huchuy Qosco,11,Noviembre,0,0,0,0,0,0,37,0,0,37,0,0,0,0,0,69,109,14,192,229,Sitio Arqueológico
20240315,2021,8,Cusco,Conjunto Arqueologico de Huchuy Qosco,11,Noviembre,1,0,0,0,0,0,52,0,0,52,0,0,0,0,0,0,0,0,0,52,Sitio Arqueológico
20240315,2021,8,Cusco,Conjunto Arqueologico de Huchuy Qosco,11,Noviembre,2,0,0,0,0,0,89,0,0,89,0,0,0,0,0,69,109,14,192,281,Sitio Arqueológico
20240315,2021,8,Cusco,Conjunto Arqueologico de Huchuy Qosco,12,Diciembre,0,0,0,0,0,0,36,0,0,36,0,0,0,0,0,150,129,29,308,344,Sitio Arqueológico
20240315,2021,8,Cusco,Conjunto Arqueologico de Huchuy Qosco,12,Diciembre,1,0,0,0,0,0,138,51,0,189,0,0,0,0,0,0,0,0,0,189,Sitio Arqueológico
20240315,2021,8,Cusco,Conjunto Arqueologico de Huchuy Qosco,12,Diciembre,2,0,0,0,0,0,174,51,0,225,0,0,0,0,0,150,129,29,308,533,Sitio Arqueológico
20240315,2021,8,Cusco,Parque Arqueologico Machu Picchu,1,Enero,0,0,0,0,0,0,15448,953,3460,19861,0,0,0,0,0,1899,7,218,2124,21985,Sitio Arqueológico
20240315,2021,8,Cusco,Parque Arqueologico Machu Picchu,1,Enero,1,0,0,0,0,0,2256,53,156,2465,0,0,0,0,0,0,0,0,0,2465,Sitio Arqueológico
20240315,2021,8,Cusco,Parque Arqueologico Machu Picchu,1,Enero,2,0,0,0,0,0,17704,1006,3616,22326,0,0,0,0,0,1899,7,218,2124,24450,Sitio Arqueológico
20240315,2021,8,Cusco,Parque Arqueologico Machu Picchu,2,Febrero,0,0,0,0,0,0,0,0,0,0,0,0,0,0,0,0,0,0,0,0,Sitio Arqueológico
20240315,2021,8,Cusco,Parque Arqueologico Machu Picchu,2,Febrero,1,0,0,0,0,0,0,0,0,0,0,0,0,0,0,0,0,0,0,0,Sitio Arqueológico
20240315,2021,8,Cusco,Parque Arqueologico Machu Picchu,2,Febrero,2,0,0,0,0,0,0,0,0,0,0,0,0,0,0,0,0,0,0,0,Sitio Arqueológico
20240315,2021,8,Cusco,Parque Arqueologico Machu Picchu,3,Marzo,0,0,0,0,0,0,6240,391,1097,7728,0,0,0,0,0,1231,55,51,1337,9065,Sitio Arqueológico
20240315,2021,8,Cusco,Parque Arqueologico Machu Picchu,3,Marzo,1,0,0,0,0,0,929,28,43,1000,0,0,0,0,0,438,12,17,467,1467,Sitio Arqueológico
20240315,2021,8,Cusco,Parque Arqueologico Machu Picchu,3,Marzo,2,0,0,0,0,0,7169,419,1140,8728,0,0,0,0,0,1669,67,68,1804,10532,Sitio Arqueológico
20240315,2021,8,Cusco,Parque Arqueologico Machu Picchu,4,Abril,0,0,0,0,0,0,6839,298,922,8059,0,0,0,0,0,446,0,0,446,8505,Sitio Arqueológico
20240315,2021,8,Cusco,Parque Arqueologico Machu Picchu,4,Abril,1,602,9,28,0,0,2016,45,99,2799,0,0,0,0,0,0,0,0,0,2799,Sitio Arqueológico
20240315,2021,8,Cusco,Parque Arqueologico Machu Picchu,4,Abril,2,602,9,28,0,0,8855,343,1021,10858,0,0,0,0,0,446,0,0,446,11304,Sitio Arqueológico
20240315,2021,8,Cusco,Parque Arqueologico Machu Picchu,5,Mayo,0,0,0,0,0,0,13574,491,2782,16847,0,0,0,0,0,1416,0,0,1416,18263,Sitio Arqueológico
20240315,2021,8,Cusco,Parque Arqueologico Machu Picchu,5,Mayo,1,0,0,0,0,0,4247,79,138,4464,0,0,0,0,0,1125,9,61,1195,5659,Sitio Arqueológico
20240315,2021,8,Cusco,Parque Arqueologico Machu Picchu,5,Mayo,2,0,0,0,0,0,17821,570,2920,21311,0,0,0,0,0,2541,9,61,2611,23922,Sitio Arqueológico
20240315,2021,8,Cusco,Parque Arqueologico Machu Picchu,6,Junio,0,0,0,0,0,0,15344,547,2405,18296,0,0,0,0,0,1413,0,0,1413,19709,Sitio Arqueológico
20240315,2021,8,Cusco,Parque Arqueologico Machu Picchu,6,Junio,1,1507,30,82,0,0,6749,193,557,9118,0,0,0,0,0,0,0,0,0,9118,Sitio Arqueológico
20240315,2021,8,Cusco,Parque Arqueologico Machu Picchu,6,Junio,2,1507,30,82,0,0,22093,740,2962,27414,0,0,0,0,0,1413,0,0,1413,28827,Sitio Arqueológico
20240315,2021,8,Cusco,Parque Arqueologico Machu Picchu,7,Julio,0,0,0,0,0,0,28779,1313,6515,36607,0,0,0,0,0,2178,0,0,2178,38785,Sitio Arqueológico
20240315,2021,8,Cusco,Parque Arqueologico Machu Picchu,7,Julio,1,2037,51,130,0,0,8899,344,908,12369,0,0,0,0,0,0,0,0,0,12369,Sitio Arqueológico
20240315,2021,8,Cusco,Parque Arqueologico Machu Picchu,7,Julio,2,2037,51,130,0,0,37678,1657,7423,48976,0,0,0,0,0,2178,0,0,2178,51154,Sitio Arqueológico
20240315,2021,8,Cusco,Parque Arqueologico Machu Picchu,8,Agosto,0,0,0,0,0,0,34961,1361,8562,44884,0,0,0,0,0,1916,0,0,1916,46800,Sitio Arqueológico
20240315,2021,8,Cusco,Parque Arqueologico Machu Picchu,8,Agosto,1,0,0,0,0,10600,335,709,0,11644,0,0,0,0,0,0,0,0,0,11644,Sitio Arqueológico
20240315,2021,8,Cusco,Parque Arqueologico Machu Picchu,8,Agosto,2,0,0,0,0,10600,35296,2070,8562,56528,0,0,0,0,0,1916,0,0,1916,58444,Sitio Arqueológico
20240315,2021,8,Cusco,Parque Arqueologico Machu Picchu,9,Setiembre,0,0,0,0,0,0,30556,634,5109,36299,0,0,0,0,0,1530,0,0,1530,37829,Sitio Arqueológico
20240315,2021,8,Cusco,Parque Arqueologico Machu Picchu,9,Setiembre,1,0,0,0,0,0,16054,226,322,16602,0,0,0,0,0,0,0,0,0,16602,Sitio Arqueológico
20240315,2021,8,Cusco,Parque Arqueologico Machu Picchu,9,Setiembre,2,0,0,0,0,0,46610,860,5431,52901,0,0,0,0,0,1530,0,0,1530,54431,Sitio Arqueológico
20240315,2021,8,Cusco,Parque Arqueologico Machu Picchu,10,Octubre,0,0,0,0,0,0,33883,1046,8321,43250,0,0,0,0,0,2369,0,0,2369,45619,Sitio Arqueológico
20240315,2021,8,Cusco,Parque Arqueologico Machu Picchu,10,Octubre,1,0,0,0,0,0,18733,208,359,19300,0,0,0,0,0,3454,28,182,3664,22964,Sitio Arqueológico
20240315,2021,8,Cusco,Parque Arqueologico Machu Picchu,10,Octubre,2,0,0,0,0,0,52616,1254,8680,62550,0,0,0,0,0,5823,28,182,6033,68583,Sitio Arqueológico
20240315,2021,8,Cusco,Parque Arqueologico Machu Picchu,11,Noviembre,0,0,0,0,0,0,25788,587,4823,31198,0,0,0,0,0,2146,0,0,2146,33344,Sitio Arqueológico
20240315,2021,8,Cusco,Parque Arqueologico Machu Picchu,11,Noviembre,1,4061,40,146,0,0,23547,335,872,29001,0,0,0,0,0,0,0,0,0,29001,Sitio Arqueológico
20240315,2021,8,Cusco,Parque Arqueologico Machu Picchu,11,Noviembre,2,4061,40,146,0,0,49335,922,5695,60199,0,0,0,0,0,2146,0,0,2146,62345,Sitio Arqueológico
20240315,2021,8,Cusco,Parque Arqueologico Machu Picchu,12,Diciembre,0,0,0,0,0,0,18690,658,3550,22898,0,0,0,0,0,2040,0,0,2040,24938,Sitio Arqueológico
20240315,2021,8,Cusco,Parque Arqueologico Machu Picchu,12,Diciembre,1,0,0,0,0,0,24013,616,1600,26229,0,0,0,0,0,0,0,0,0,26229,Sitio Arqueológico
20240315,2021,8,Cusco,Parque Arqueologico Machu Picchu,12,Diciembre,2,0,0,0,0,0,42703,1274,5150,49127,0,0,0,0,0,2040,0,0,2040,51167,Sitio Arqueológico
20240315,2021,8,Cusco,Santuario Historico de Machu Picchu,1,Enero,0,0,0,0,0,0,5,0,0,5,0,0,0,0,0,441,68,45,554,559,Sitio Arqueológico
20240315,2021,8,Cusco,Santuario Historico de Machu Picchu,1,Enero,1,0,0,0,0,0,5,0,0,5,0,0,0,0,0,23,3,0,26,31,Sitio Arqueológico
20240315,2021,8,Cusco,Santuario Historico de Machu Picchu,1,Enero,2,0,0,0,0,0,10,0,0,10,0,0,0,0,0,464,71,45,580,590,Sitio Arqueológico
20240315,2021,8,Cusco,Santuario Historico de Machu Picchu,2,Febrero,0,0,0,0,0,0,0,0,0,0,0,0,0,0,0,0,0,0,0,0,Sitio Arqueológico
20240315,2021,8,Cusco,Santuario Historico de Machu Picchu,2,Febrero,1,0,0,0,0,0,0,0,0,0,0,0,0,0,0,0,0,0,0,0,Sitio Arqueológico
20240315,2021,8,Cusco,Santuario Historico de Machu Picchu,2,Febrero,2,0,0,0,0,0,0,0,0,0,0,0,0,0,0,0,0,0,0,0,Sitio Arqueológico
20240315,2021,8,Cusco,Santuario Historico de Machu Picchu,3,Marzo,0,0,0,0,0,0,2,0,0,2,0,0,0,0,0,169,8,4,181,183,Sitio Arqueológico
20240315,2021,8,Cusco,Santuario Historico de Machu Picchu,3,Marzo,1,0,0,0,0,0,0,0,0,0,0,0,0,0,0,38,0,0,38,38,Sitio Arqueológico
20240315,2021,8,Cusco,Santuario Historico de Machu Picchu,3,Marzo,2,0,0,0,0,0,2,0,0,2,0,0,0,0,0,207,8,4,219,221,Sitio Arqueológico
20240315,2021,8,Cusco,Santuario Historico de Machu Picchu,4,Abril,0,0,0,0,0,0,0,0,0,0,0,0,0,0,0,185,14,10,209,209,Sitio Arqueológico
20240315,2021,8,Cusco,Santuario Historico de Machu Picchu,4,Abril,1,0,0,0,0,0,0,0,0,0,0,0,0,0,0,75,0,0,75,75,Sitio Arqueológico
20240315,2021,8,Cusco,Santuario Historico de Machu Picchu,4,Abril,2,0,0,0,0,0,0,0,0,0,0,0,0,0,0,260,14,10,284,284,Sitio Arqueológico
20240315,2021,8,Cusco,Santuario Historico de Machu Picchu,5,Mayo,0,0,0,0,0,0,0,0,0,0,0,0,0,0,0,354,58,10,422,422,Sitio Arqueológico
20240315,2021,8,Cusco,Santuario Historico de Machu Picchu,5,Mayo,1,0,0,0,0,0,4,1,0,5,0,0,0,0,0,106,3,0,109,114,Sitio Arqueológico
20240315,2021,8,Cusco,Santuario Historico de Machu Picchu,5,Mayo,2,0,0,0,0,0,4,1,0,5,0,0,0,0,0,460,61,10,531,536,Sitio Arqueológico
20240315,2021,8,Cusco,Santuario Historico de Machu Picchu,6,Junio,0,0,0,0,0,0,0,0,0,0,0,0,0,0,0,454,66,16,536,536,Sitio Arqueológico
20240315,2021,8,Cusco,Santuario Historico de Machu Picchu,6,Junio,1,0,0,0,0,0,5,0,0,5,0,0,0,0,0,179,4,0,183,188,Sitio Arqueológico
20240315,2021,8,Cusco,Santuario Historico de Machu Picchu,6,Junio,2,0,0,0,0,0,5,0,0,5,0,0,0,0,0,633,70,16,719,724,Sitio Arqueológico
20240315,2021,8,Cusco,Santuario Historico de Machu Picchu,7,Julio,0,0,0,0,0,0,9,0,0,9,0,0,0,0,0,829,68,22,919,928,Sitio Arqueológico
20240315,2021,8,Cusco,Santuario Historico de Machu Picchu,7,Julio,1,0,0,0,0,0,16,2,0,18,0,0,0,0,0,243,24,0,267,285,Sitio Arqueológico
20240315,2021,8,Cusco,Santuario Historico de Machu Picchu,7,Julio,2,0,0,0,0,0,25,2,0,27,0,0,0,0,0,1072,92,22,1186,1213,Sitio Arqueológico
20240315,2021,8,Cusco,Santuario Historico de Machu Picchu,8,Agosto,0,0,0,0,0,0,11,0,0,11,0,0,0,0,0,1240,153,22,1415,1426,Sitio Arqueológico
20240315,2021,8,Cusco,Santuario Historico de Machu Picchu,8,Agosto,1,0,0,0,0,0,20,0,0,20,0,0,0,0,0,402,13,0,415,435,Sitio Arqueológico
20240315,2021,8,Cusco,Santuario Historico de Machu Picchu,8,Agosto,2,0,0,0,0,0,31,0,0,31,0,0,0,0,0,1642,166,22,1830,1861,Sitio Arqueológico
20240315,2021,8,Cusco,Santuario Historico de Machu Picchu,9,Setiembre,0,0,0,0,0,0,12,1,0,13,0,0,0,0,0,740,45,13,798,811,Sitio Arqueológico
20240315,2021,8,Cusco,Santuario Historico de Machu Picchu,9,Setiembre,1,0,0,0,0,0,37,0,0,37,0,0,0,0,0,312,3,0,315,352,Sitio Arqueológico
20240315,2021,8,Cusco,Santuario Historico de Machu Picchu,9,Setiembre,2,0,0,0,0,0,49,1,0,50,0,0,0,0,0,1052,48,13,1113,1163,Sitio Arqueológico
20240315,2021,8,Cusco,Santuario Historico de Machu Picchu,10,Octubre,0,0,0,0,0,0,7,3,0,10,0,0,0,0,0,889,67,4,960,970,Sitio Arqueológico
20240315,2021,8,Cusco,Santuario Historico de Machu Picchu,10,Octubre,1,0,0,0,0,0,22,0,0,22,0,0,0,0,0,446,1,0,447,469,Sitio Arqueológico
20240315,2021,8,Cusco,Santuario Historico de Machu Picchu,10,Octubre,2,0,0,0,0,0,29,3,0,32,0,0,0,0,0,1335,68,4,1407,1439,Sitio Arqueológico
20240315,2021,8,Cusco,Santuario Historico de Machu Picchu,11,Noviembre,0,0,0,0,0,0,2,0,0,2,0,0,0,0,0,833,82,21,936,938,Sitio Arqueológico
20240315,2021,8,Cusco,Santuario Historico de Machu Picchu,11,Noviembre,1,0,0,0,0,0,36,1,0,37,0,0,0,0,0,590,0,0,590,627,Sitio Arqueológico
20240315,2021,8,Cusco,Santuario Historico de Machu Picchu,11,Noviembre,2,0,0,0,0,0,38,1,0,39,0,0,0,0,0,1423,82,21,1526,1565,Sitio Arqueológico
20240315,2021,8,Cusco,Santuario Historico de Machu Picchu,12,Diciembre,0,0,0,0,0,0,3,0,0,3,0,0,0,0,0,709,42,7,758,761,Sitio Arqueológico
20240315,2021,8,Cusco,Santuario Historico de Machu Picchu,12,Diciembre,1,0,0,0,0,0,24,0,0,24,0,0,0,0,0,440,8,0,448,472,Sitio Arqueológico
20240315,2021,8,Cusco,Santuario Historico de Machu Picchu,12,Diciembre,2,0,0,0,0,0,27,0,0,27,0,0,0,0,0,1149,50,7,1206,1233,Sitio Arqueológico
20240315,2021,8,Cusco,Parque Arqueologico Macchu Picchu (Ingreso Salkantay-Paucarcancha),1,Enero,0,0,0,0,0,0,0,0,0,0,0,0,0,0,0,0,0,0,0,0,Sitio Arqueológico
20240315,2021,8,Cusco,Parque Arqueologico Macchu Picchu (Ingreso Salkantay-Paucarcancha),1,Enero,1,0,0,0,0,0,0,0,0,0,0,0,0,0,0,0,0,0,0,0,Sitio Arqueológico
20240315,2021,8,Cusco,Parque Arqueologico Macchu Picchu (Ingreso Salkantay-Paucarcancha),1,Enero,2,0,0,0,0,0,0,0,0,0,0,0,0,0,0,0,0,0,0,0,Sitio Arqueológico
20240315,2021,8,Cusco,Parque Arqueologico Macchu Picchu (Ingreso Salkantay-Paucarcancha),2,Febrero,0,0,0,0,0,0,0,0,0,0,0,0,0,0,0,0,0,0,0,0,Sitio Arqueológico
20240315,2021,8,Cusco,Parque Arqueologico Macchu Picchu (Ingreso Salkantay-Paucarcancha),2,Febrero,1,0,0,0,0,0,0,0,0,0,0,0,0,0,0,0,0,0,0,0,Sitio Arqueológico
20240315,2021,8,Cusco,Parque Arqueologico Macchu Picchu (Ingreso Salkantay-Paucarcancha),2,Febrero,2,0,0,0,0,0,0,0,0,0,0,0,0,0,0,0,0,0,0,0,Sitio Arqueológico
20240315,2021,8,Cusco,Parque Arqueologico Macchu Picchu (Ingreso Salkantay-Paucarcancha),3,Marzo,0,0,0,0,0,0,0,0,0,0,0,0,0,0,0,0,0,0,0,0,Sitio Arqueológico
20240315,2021,8,Cusco,Parque Arqueologico Macchu Picchu (Ingreso Salkantay-Paucarcancha),3,Marzo,1,0,0,0,0,0,0,0,0,0,0,0,0,0,0,0,0,0,0,0,Sitio Arqueológico
20240315,2021,8,Cusco,Parque Arqueologico Macchu Picchu (Ingreso Salkantay-Paucarcancha),3,Marzo,2,0,0,0,0,0,0,0,0,0,0,0,0,0,0,0,0,0,0,0,Sitio Arqueológico
20240315,2021,8,Cusco,Parque Arqueologico Macchu Picchu (Ingreso Salkantay-Paucarcancha),4,Abril,0,0,0,0,0,0,0,0,0,0,0,0,0,0,0,0,0,0,0,0,Sitio Arqueológico
20240315,2021,8,Cusco,Parque Arqueologico Macchu Picchu (Ingreso Salkantay-Paucarcancha),4,Abril,1,0,0,0,0,0,0,0,0,0,0,0,0,0,0,0,0,0,0,0,Sitio Arqueológico
20240315,2021,8,Cusco,Parque Arqueologico Macchu Picchu (Ingreso Salkantay-Paucarcancha),4,Abril,2,0,0,0,0,0,0,0,0,0,0,0,0,0,0,0,0,0,0,0,Sitio Arqueológico
20240315,2021,8,Cusco,Parque Arqueologico Macchu Picchu (Ingreso Salkantay-Paucarcancha),5,Mayo,0,0,0,0,0,0,0,0,0,0,0,0,0,0,0,0,0,0,0,0,Sitio Arqueológico
20240315,2021,8,Cusco,Parque Arqueologico Macchu Picchu (Ingreso Salkantay-Paucarcancha),5,Mayo,1,0,0,0,0,0,0,0,0,0,0,0,0,0,0,0,0,0,0,0,Sitio Arqueológico
20240315,2021,8,Cusco,Parque Arqueologico Macchu Picchu (Ingreso Salkantay-Paucarcancha),5,Mayo,2,0,0,0,0,0,0,0,0,0,0,0,0,0,0,0,0,0,0,0,Sitio Arqueológico
20240315,2021,8,Cusco,Parque Arqueologico Macchu Picchu (Ingreso Salkantay-Paucarcancha),6,Junio,0,0,0,0,0,0,0,0,0,0,0,0,0,0,0,0,0,0,0,0,Sitio Arqueológico
20240315,2021,8,Cusco,Parque Arqueologico Macchu Picchu (Ingreso Salkantay-Paucarcancha),6,Junio,1,0,0,0,0,0,0,0,0,0,0,0,0,0,0,0,0,0,0,0,Sitio Arqueológico
20240315,2021,8,Cusco,Parque Arqueologico Macchu Picchu (Ingreso Salkantay-Paucarcancha),6,Junio,2,0,0,0,0,0,0,0,0,0,0,0,0,0,0,0,0,0,0,0,Sitio Arqueológico
20240315,2021,8,Cusco,Parque Arqueologico Macchu Picchu (Ingreso Salkantay-Paucarcancha),7,Julio,0,0,0,0,0,0,0,0,0,0,0,0,0,0,0,0,0,0,0,0,Sitio Arqueológico
20240315,2021,8,Cusco,Parque Arqueologico Macchu Picchu (Ingreso Salkantay-Paucarcancha),7,Julio,1,0,0,0,0,0,19,14,0,33,0,0,0,0,0,0,0,0,0,33,Sitio Arqueológico
20240315,2021,8,Cusco,Parque Arqueologico Macchu Picchu (Ingreso Salkantay-Paucarcancha),7,Julio,2,0,0,0,0,0,19,14,0,33,0,0,0,0,0,0,0,0,0,33,Sitio Arqueológico
20240315,2021,8,Cusco,Parque Arqueologico Macchu Picchu (Ingreso Salkantay-Paucarcancha),8,Agosto,0,0,0,0,0,0,0,0,0,0,0,0,0,0,0,0,0,0,0,0,Sitio Arqueológico
20240315,2021,8,Cusco,Parque Arqueologico Macchu Picchu (Ingreso Salkantay-Paucarcancha),8,Agosto,1,0,0,0,0,0,0,0,0,0,0,0,0,0,0,12,0,0,12,12,Sitio Arqueológico
20240315,2021,8,Cusco,Parque Arqueologico Macchu Picchu (Ingreso Salkantay-Paucarcancha),8,Agosto,2,0,0,0,0,0,0,0,0,0,0,0,0,0,0,12,0,0,12,12,Sitio Arqueológico
20240315,2021,8,Cusco,Parque Arqueologico Macchu Picchu (Ingreso Salkantay-Paucarcancha),9,Setiembre,0,0,0,0,0,0,0,0,0,0,0,0,0,0,0,0,0,0,0,0,Sitio Arqueológico
20240315,2021,8,Cusco,Parque Arqueologico Macchu Picchu (Ingreso Salkantay-Paucarcancha),9,Setiembre,1,0,0,0,0,0,28,0,0,28,0,0,0,0,0,0,0,0,0,28,Sitio Arqueológico
20240315,2021,8,Cusco,Parque Arqueologico Macchu Picchu (Ingreso Salkantay-Paucarcancha),9,Setiembre,2,0,0,0,0,0,28,0,0,28,0,0,0,0,0,0,0,0,0,28,Sitio Arqueológico
20240315,2021,8,Cusco,Parque Arqueologico Macchu Picchu (Ingreso Salkantay-Paucarcancha),10,Octubre,0,0,0,0,0,0,0,0,0,0,0,0,0,0,0,0,0,0,0,0,Sitio Arqueológico
20240315,2021,8,Cusco,Parque Arqueologico Macchu Picchu (Ingreso Salkantay-Paucarcancha),10,Octubre,1,0,0,0,0,0,35,0,0,35,0,0,0,0,0,0,0,0,0,35,Sitio Arqueológico
20240315,2021,8,Cusco,Parque Arqueologico Macchu Picchu (Ingreso Salkantay-Paucarcancha),10,Octubre,2,0,0,0,0,0,35,0,0,35,0,0,0,0,0,0,0,0,0,35,Sitio Arqueológico
20240315,2021,8,Cusco,Parque Arqueologico Macchu Picchu (Ingreso Salkantay-Paucarcancha),11,Noviembre,0,0,0,0,0,0,0,0,0,0,0,0,0,0,0,0,0,0,0,0,Sitio Arqueológico
20240315,2021,8,Cusco,Parque Arqueologico Macchu Picchu (Ingreso Salkantay-Paucarcancha),11,Noviembre,1,0,0,0,0,0,12,0,0,12,0,0,0,0,0,0,0,0,0,12,Sitio Arqueológico
20240315,2021,8,Cusco,Parque Arqueologico Macchu Picchu (Ingreso Salkantay-Paucarcancha),11,Noviembre,2,0,0,0,0,0,12,0,0,12,0,0,0,0,0,0,0,0,0,12,Sitio Arqueológico
20240315,2021,8,Cusco,Parque Arqueologico Macchu Picchu (Ingreso Salkantay-Paucarcancha),12,Diciembre,0,0,0,0,0,0,0,0,0,0,0,0,0,0,0,0,0,0,0,0,Sitio Arqueológico
20240315,2021,8,Cusco,Parque Arqueologico Macchu Picchu (Ingreso Salkantay-Paucarcancha),12,Diciembre,1,0,0,0,0,0,4,0,0,4,0,0,0,0,0,0,0,0,0,4,Sitio Arqueológico
20240315,2021,8,Cusco,Parque Arqueologico Macchu Picchu (Ingreso Salkantay-Paucarcancha),12,Diciembre,2,0,0,0,0,0,4,0,0,4,0,0,0,0,0,0,0,0,0,4,Sitio Arqueológico
20240315,2021,10,Huanuco,Zona Arqueologica Monumental de Garu,1,Enero,0,0,0,0,0,0,0,0,0,0,0,0,0,0,0,0,0,0,0,0,Sitio Arqueológico
20240315,2021,10,Huanuco,Zona Arqueologica Monumental de Garu,1,Enero,1,0,0,0,0,0,0,0,0,0,0,0,0,0,0,0,0,0,0,0,Sitio Arqueológico
20240315,2021,10,Huanuco,Zona Arqueologica Monumental de Garu,1,Enero,2,0,0,0,0,0,0,0,0,0,0,0,0,0,0,0,0,0,0,0,Sitio Arqueológico
20240315,2021,10,Huanuco,Zona Arqueologica Monumental de Garu,2,Febrero,0,0,0,0,0,0,0,0,0,0,0,0,0,0,0,0,0,0,0,0,Sitio Arqueológico
20240315,2021,10,Huanuco,Zona Arqueologica Monumental de Garu,2,Febrero,1,0,0,0,0,0,0,0,0,0,0,0,0,0,0,0,0,0,0,0,Sitio Arqueológico
20240315,2021,10,Huanuco,Zona Arqueologica Monumental de Garu,2,Febrero,2,0,0,0,0,0,0,0,0,0,0,0,0,0,0,0,0,0,0,0,Sitio Arqueológico
20240315,2021,10,Huanuco,Zona Arqueologica Monumental de Garu,3,Marzo,0,0,0,0,0,0,0,0,0,0,0,0,0,0,0,0,0,0,0,0,Sitio Arqueológico
20240315,2021,10,Huanuco,Zona Arqueologica Monumental de Garu,3,Marzo,1,0,0,0,0,0,0,0,0,0,0,0,0,0,0,0,0,0,0,0,Sitio Arqueológico
20240315,2021,10,Huanuco,Zona Arqueologica Monumental de Garu,3,Marzo,2,0,0,0,0,0,0,0,0,0,0,0,0,0,0,0,0,0,0,0,Sitio Arqueológico
20240315,2021,10,Huanuco,Zona Arqueologica Monumental de Garu,4,Abril,0,0,0,0,0,0,0,0,0,0,0,0,0,0,0,0,0,0,0,0,Sitio Arqueológico
20240315,2021,10,Huanuco,Zona Arqueologica Monumental de Garu,4,Abril,1,0,0,0,0,0,0,0,0,0,0,0,0,0,0,0,0,0,0,0,Sitio Arqueológico
20240315,2021,10,Huanuco,Zona Arqueologica Monumental de Garu,4,Abril,2,0,0,0,0,0,0,0,0,0,0,0,0,0,0,0,0,0,0,0,Sitio Arqueológico
20240315,2021,10,Huanuco,Zona Arqueologica Monumental de Garu,5,Mayo,0,0,0,0,0,0,0,0,0,0,0,0,0,0,0,0,0,0,0,0,Sitio Arqueológico
20240315,2021,10,Huanuco,Zona Arqueologica Monumental de Garu,5,Mayo,1,0,0,0,0,0,0,0,0,0,0,0,0,0,0,0,0,0,0,0,Sitio Arqueológico
20240315,2021,10,Huanuco,Zona Arqueologica Monumental de Garu,5,Mayo,2,0,0,0,0,0,0,0,0,0,0,0,0,0,0,0,0,0,0,0,Sitio Arqueológico
20240315,2021,10,Huanuco,Zona Arqueologica Monumental de Garu,6,Junio,0,0,0,0,0,0,0,0,0,0,0,0,0,0,0,0,0,0,0,0,Sitio Arqueológico
20240315,2021,10,Huanuco,Zona Arqueologica Monumental de Garu,6,Junio,1,0,0,0,0,0,0,0,0,0,0,0,0,0,0,0,0,0,0,0,Sitio Arqueológico
20240315,2021,10,Huanuco,Zona Arqueologica Monumental de Garu,6,Junio,2,0,0,0,0,0,0,0,0,0,0,0,0,0,0,0,0,0,0,0,Sitio Arqueológico
20240315,2021,10,Huanuco,Zona Arqueologica Monumental de Garu,7,Julio,0,0,0,0,0,0,0,0,0,0,0,0,0,0,0,0,0,0,0,0,Sitio Arqueológico
20240315,2021,10,Huanuco,Zona Arqueologica Monumental de Garu,7,Julio,1,0,0,0,0,0,0,0,0,0,0,0,0,0,0,0,0,0,0,0,Sitio Arqueológico
20240315,2021,10,Huanuco,Zona Arqueologica Monumental de Garu,7,Julio,2,0,0,0,0,0,0,0,0,0,0,0,0,0,0,0,0,0,0,0,Sitio Arqueológico
20240315,2021,10,Huanuco,Zona Arqueologica Monumental de Garu,8,Agosto,0,0,0,0,0,0,0,0,0,0,0,0,0,0,0,0,0,0,0,0,Sitio Arqueológico
20240315,2021,10,Huanuco,Zona Arqueologica Monumental de Garu,8,Agosto,1,0,0,0,0,0,0,0,0,0,0,0,0,0,0,0,0,0,0,0,Sitio Arqueológico
20240315,2021,10,Huanuco,Zona Arqueologica Monumental de Garu,8,Agosto,2,0,0,0,0,0,0,0,0,0,0,0,0,0,0,0,0,0,0,0,Sitio Arqueológico
20240315,2021,10,Huanuco,Zona Arqueologica Monumental de Garu,9,Setiembre,0,0,0,0,0,0,0,0,0,0,0,0,0,0,0,0,0,0,0,0,Sitio Arqueológico
20240315,2021,10,Huanuco,Zona Arqueologica Monumental de Garu,9,Setiembre,1,0,0,0,0,0,0,0,0,0,0,0,0,0,0,0,0,0,0,0,Sitio Arqueológico
20240315,2021,10,Huanuco,Zona Arqueologica Monumental de Garu,9,Setiembre,2,0,0,0,0,0,0,0,0,0,0,0,0,0,0,0,0,0,0,0,Sitio Arqueológico
20240315,2021,10,Huanuco,Zona Arqueologica Monumental de Garu,10,Octubre,0,0,0,0,0,0,0,0,0,0,0,0,0,0,0,0,0,0,0,0,Sitio Arqueológico
20240315,2021,10,Huanuco,Zona Arqueologica Monumental de Garu,10,Octubre,1,0,0,0,0,0,0,0,0,0,0,0,0,0,0,0,0,0,0,0,Sitio Arqueológico
20240315,2021,10,Huanuco,Zona Arqueologica Monumental de Garu,10,Octubre,2,0,0,0,0,0,0,0,0,0,0,0,0,0,0,0,0,0,0,0,Sitio Arqueológico
20240315,2021,10,Huanuco,Zona Arqueologica Monumental de Garu,11,Noviembre,0,0,0,0,0,0,0,0,0,0,0,0,0,0,0,0,0,0,0,0,Sitio Arqueológico
20240315,2021,10,Huanuco,Zona Arqueologica Monumental de Garu,11,Noviembre,1,0,0,0,0,0,0,0,0,0,0,0,0,0,0,0,0,0,0,0,Sitio Arqueológico
20240315,2021,10,Huanuco,Zona Arqueologica Monumental de Garu,11,Noviembre,2,0,0,0,0,0,0,0,0,0,0,0,0,0,0,0,0,0,0,0,Sitio Arqueológico
20240315,2021,10,Huanuco,Zona Arqueologica Monumental de Garu,12,Diciembre,0,0,0,0,0,0,0,0,0,0,0,0,0,0,0,0,0,0,0,0,Sitio Arqueológico
20240315,2021,10,Huanuco,Zona Arqueologica Monumental de Garu,12,Diciembre,1,0,0,0,0,0,0,0,0,0,0,0,0,0,0,0,0,0,0,0,Sitio Arqueológico
20240315,2021,10,Huanuco,Zona Arqueologica Monumental de Garu,12,Diciembre,2,0,0,0,0,0,0,0,0,0,0,0,0,0,0,0,0,0,0,0,Sitio Arqueológico
20240315,2021,10,Huanuco,Huanucopampa,1,Enero,0,0,0,0,0,0,486,96,56,638,0,0,0,0,0,0,0,0,0,638,Sitio Arqueológico
20240315,2021,10,Huanuco,Huanucopampa,1,Enero,1,0,0,0,0,0,0,0,0,0,0,0,0,0,0,0,0,0,0,0,Sitio Arqueológico
20240315,2021,10,Huanuco,Huanucopampa,1,Enero,2,0,0,0,0,0,486,96,56,638,0,0,0,0,0,0,0,0,0,638,Sitio Arqueológico
20240315,2021,10,Huanuco,Huanucopampa,2,Febrero,0,0,0,0,0,0,0,0,0,0,0,0,0,0,0,0,0,0,0,0,Sitio Arqueológico
20240315,2021,10,Huanuco,Huanucopampa,2,Febrero,1,0,0,0,0,0,0,0,0,0,0,0,0,0,0,0,0,0,0,0,Sitio Arqueológico
20240315,2021,10,Huanuco,Huanucopampa,2,Febrero,2,0,0,0,0,0,0,0,0,0,0,0,0,0,0,0,0,0,0,0,Sitio Arqueológico
20240315,2021,10,Huanuco,Huanucopampa,3,Marzo,0,0,0,0,0,0,424,87,68,579,0,0,0,0,0,48,19,12,79,658,Sitio Arqueológico
20240315,2021,10,Huanuco,Huanucopampa,3,Marzo,1,0,0,0,0,0,0,0,0,0,0,0,0,0,0,0,0,0,0,0,Sitio Arqueológico
20240315,2021,10,Huanuco,Huanucopampa,3,Marzo,2,0,0,0,0,0,424,87,68,579,0,0,0,0,0,48,19,12,79,658,Sitio Arqueológico
20240315,2021,10,Huanuco,Huanucopampa,4,Abril,0,0,0,0,0,0,251,188,43,482,0,0,0,0,0,0,0,0,0,482,Sitio Arqueológico
20240315,2021,10,Huanuco,Huanucopampa,4,Abril,1,0,0,0,0,0,0,0,0,0,0,0,0,0,0,0,0,0,0,0,Sitio Arqueológico
20240315,2021,10,Huanuco,Huanucopampa,4,Abril,2,0,0,0,0,0,251,188,43,482,0,0,0,0,0,0,0,0,0,482,Sitio Arqueológico
20240315,2021,10,Huanuco,Huanucopampa,5,Mayo,0,0,0,0,0,0,0,598,106,704,0,0,0,0,0,38,23,12,73,777,Sitio Arqueológico
20240315,2021,10,Huanuco,Huanucopampa,5,Mayo,1,0,0,0,0,0,0,0,0,0,0,0,0,0,0,0,0,0,0,0,Sitio Arqueológico
20240315,2021,10,Huanuco,Huanucopampa,5,Mayo,2,0,0,0,0,0,0,598,106,704,0,0,0,0,0,38,23,12,73,777,Sitio Arqueológico
20240315,2021,10,Huanuco,Huanucopampa,6,Junio,0,0,0,0,0,0,0,997,130,1127,0,0,0,0,0,0,35,10,45,1172,Sitio Arqueológico
20240315,2021,10,Huanuco,Huanucopampa,6,Junio,1,0,0,0,0,0,0,0,0,0,0,0,0,0,0,0,0,0,0,0,Sitio Arqueológico
20240315,2021,10,Huanuco,Huanucopampa,6,Junio,2,0,0,0,0,0,0,997,130,1127,0,0,0,0,0,0,35,10,45,1172,Sitio Arqueológico
20240315,2021,10,Huanuco,Huanucopampa,7,Julio,0,0,0,0,0,0,753,932,289,1974,0,0,0,0,0,69,47,26,142,2116,Sitio Arqueológico
20240315,2021,10,Huanuco,Huanucopampa,7,Julio,1,0,0,0,0,0,0,0,0,0,0,0,0,0,0,0,0,0,0,0,Sitio Arqueológico
20240315,2021,10,Huanuco,Huanucopampa,7,Julio,2,0,0,0,0,0,753,932,289,1974,0,0,0,0,0,69,47,26,142,2116,Sitio Arqueológico
20240315,2021,10,Huanuco,Huanucopampa,8,Agosto,0,0,0,0,0,0,1031,473,200,1704,0,0,0,0,0,173,51,38,262,1966,Sitio Arqueológico
20240315,2021,10,Huanuco,Huanucopampa,8,Agosto,1,0,0,0,0,0,1,0,0,1,0,0,0,0,0,0,0,0,0,1,Sitio Arqueológico
20240315,2021,10,Huanuco,Huanucopampa,8,Agosto,2,0,0,0,0,0,1032,473,200,1705,0,0,0,0,0,173,51,38,262,1967,Sitio Arqueológico
20240315,2021,10,Huanuco,Huanucopampa,9,Setiembre,0,0,0,0,0,0,548,358,111,1017,0,0,0,0,0,79,28,14,121,1138,Sitio Arqueológico
20240315,2021,10,Huanuco,Huanucopampa,9,Setiembre,1,0,0,0,0,0,9,0,0,9,0,0,0,0,0,0,0,0,0,9,Sitio Arqueológico
20240315,2021,10,Huanuco,Huanucopampa,9,Setiembre,2,0,0,0,0,0,557,358,111,1026,0,0,0,0,0,79,28,14,121,1147,Sitio Arqueológico
20240315,2021,10,Huanuco,Huanucopampa,10,Octubre,0,0,0,0,0,0,536,301,209,1046,0,0,0,0,0,108,32,19,159,1205,Sitio Arqueológico
20240315,2021,10,Huanuco,Huanucopampa,10,Octubre,1,0,0,0,0,0,6,0,0,6,0,0,0,0,0,0,0,0,0,6,Sitio Arqueológico
20240315,2021,10,Huanuco,Huanucopampa,10,Octubre,2,0,0,0,0,0,542,301,209,1052,0,0,0,0,0,108,32,19,159,1211,Sitio Arqueológico
20240315,2021,10,Huanuco,Huanucopampa,11,Noviembre,0,0,0,0,0,0,376,181,85,642,0,0,0,0,0,105,45,28,178,820,Sitio Arqueológico
20240315,2021,10,Huanuco,Huanucopampa,11,Noviembre,1,0,0,0,0,0,4,0,0,4,0,0,0,0,0,0,0,0,0,4,Sitio Arqueológico
20240315,2021,10,Huanuco,Huanucopampa,11,Noviembre,2,0,0,0,0,0,380,181,85,646,0,0,0,0,0,105,45,28,178,824,Sitio Arqueológico
20240315,2021,10,Huanuco,Huanucopampa,12,Diciembre,0,0,0,0,0,0,236,143,75,454,0,0,0,0,0,37,28,13,78,532,Sitio Arqueológico
20240315,2021,10,Huanuco,Huanucopampa,12,Diciembre,1,0,0,0,0,0,0,0,0,0,0,0,0,0,0,0,0,0,0,0,Sitio Arqueológico
20240315,2021,10,Huanuco,Huanucopampa,12,Diciembre,2,0,0,0,0,0,236,143,75,454,0,0,0,0,0,37,28,13,78,532,Sitio Arqueológico
20240315,2021,11,Ica,Sitio Arqueologico Pampas de Huayuri,1,Enero,0,0,0,0,0,0,0,0,0,0,0,0,0,0,0,0,0,0,0,0,Sitio Arqueológico
20240315,2021,11,Ica,Sitio Arqueologico Pampas de Huayuri,1,Enero,1,0,0,0,0,0,0,0,0,0,0,0,0,0,0,0,0,0,0,0,Sitio Arqueológico
20240315,2021,11,Ica,Sitio Arqueologico Pampas de Huayuri,1,Enero,2,0,0,0,0,0,0,0,0,0,0,0,0,0,0,0,0,0,0,0,Sitio Arqueológico
20240315,2021,11,Ica,Sitio Arqueologico Pampas de Huayuri,2,Febrero,0,0,0,0,0,0,0,0,0,0,0,0,0,0,0,0,0,0,0,0,Sitio Arqueológico
20240315,2021,11,Ica,Sitio Arqueologico Pampas de Huayuri,2,Febrero,1,0,0,0,0,0,0,0,0,0,0,0,0,0,0,0,0,0,0,0,Sitio Arqueológico
20240315,2021,11,Ica,Sitio Arqueologico Pampas de Huayuri,2,Febrero,2,0,0,0,0,0,0,0,0,0,0,0,0,0,0,0,0,0,0,0,Sitio Arqueológico
20240315,2021,11,Ica,Sitio Arqueologico Pampas de Huayuri,3,Marzo,0,0,0,0,0,0,0,0,0,0,0,0,0,0,0,0,0,0,0,0,Sitio Arqueológico
20240315,2021,11,Ica,Sitio Arqueologico Pampas de Huayuri,3,Marzo,1,0,0,0,0,0,0,0,0,0,0,0,0,0,0,0,0,0,0,0,Sitio Arqueológico
20240315,2021,11,Ica,Sitio Arqueologico Pampas de Huayuri,3,Marzo,2,0,0,0,0,0,0,0,0,0,0,0,0,0,0,0,0,0,0,0,Sitio Arqueológico
20240315,2021,11,Ica,Sitio Arqueologico Pampas de Huayuri,4,Abril,0,0,0,0,0,0,0,0,0,0,0,0,0,0,0,0,0,0,0,0,Sitio Arqueológico
20240315,2021,11,Ica,Sitio Arqueologico Pampas de Huayuri,4,Abril,1,0,0,0,0,0,0,0,0,0,0,0,0,0,0,0,0,0,0,0,Sitio Arqueológico
20240315,2021,11,Ica,Sitio Arqueologico Pampas de Huayuri,4,Abril,2,0,0,0,0,0,0,0,0,0,0,0,0,0,0,0,0,0,0,0,Sitio Arqueológico
20240315,2021,11,Ica,Sitio Arqueologico Pampas de Huayuri,5,Mayo,0,0,0,0,0,0,0,0,0,0,0,0,0,0,0,0,0,0,0,0,Sitio Arqueológico
20240315,2021,11,Ica,Sitio Arqueologico Pampas de Huayuri,5,Mayo,1,0,0,0,0,0,0,0,0,0,0,0,0,0,0,0,0,0,0,0,Sitio Arqueológico
20240315,2021,11,Ica,Sitio Arqueologico Pampas de Huayuri,5,Mayo,2,0,0,0,0,0,0,0,0,0,0,0,0,0,0,0,0,0,0,0,Sitio Arqueológico
20240315,2021,11,Ica,Sitio Arqueologico Pampas de Huayuri,6,Junio,0,0,0,0,0,0,0,0,0,0,0,0,0,0,0,0,0,0,0,0,Sitio Arqueológico
20240315,2021,11,Ica,Sitio Arqueologico Pampas de Huayuri,6,Junio,1,0,0,0,0,0,0,0,0,0,0,0,0,0,0,0,0,0,0,0,Sitio Arqueológico
20240315,2021,11,Ica,Sitio Arqueologico Pampas de Huayuri,6,Junio,2,0,0,0,0,0,0,0,0,0,0,0,0,0,0,0,0,0,0,0,Sitio Arqueológico
20240315,2021,11,Ica,Sitio Arqueologico Pampas de Huayuri,7,Julio,0,0,0,0,0,0,0,0,0,0,0,0,0,0,0,0,0,0,0,0,Sitio Arqueológico
20240315,2021,11,Ica,Sitio Arqueologico Pampas de Huayuri,7,Julio,1,0,0,0,0,0,0,0,0,0,0,0,0,0,0,0,0,0,0,0,Sitio Arqueológico
20240315,2021,11,Ica,Sitio Arqueologico Pampas de Huayuri,7,Julio,2,0,0,0,0,0,0,0,0,0,0,0,0,0,0,0,0,0,0,0,Sitio Arqueológico
20240315,2021,11,Ica,Sitio Arqueologico Pampas de Huayuri,8,Agosto,0,0,0,0,0,0,0,0,0,0,0,0,0,0,0,0,0,0,0,0,Sitio Arqueológico
20240315,2021,11,Ica,Sitio Arqueologico Pampas de Huayuri,8,Agosto,1,0,0,0,0,0,0,0,0,0,0,0,0,0,0,0,0,0,0,0,Sitio Arqueológico
20240315,2021,11,Ica,Sitio Arqueologico Pampas de Huayuri,8,Agosto,2,0,0,0,0,0,0,0,0,0,0,0,0,0,0,0,0,0,0,0,Sitio Arqueológico
20240315,2021,11,Ica,Sitio Arqueologico Pampas de Huayuri,9,Setiembre,0,0,0,0,0,0,0,0,0,0,0,0,0,0,0,0,0,0,0,0,Sitio Arqueológico
20240315,2021,11,Ica,Sitio Arqueologico Pampas de Huayuri,9,Setiembre,1,0,0,0,0,0,0,0,0,0,0,0,0,0,0,0,0,0,0,0,Sitio Arqueológico
20240315,2021,11,Ica,Sitio Arqueologico Pampas de Huayuri,9,Setiembre,2,0,0,0,0,0,0,0,0,0,0,0,0,0,0,0,0,0,0,0,Sitio Arqueológico
20240315,2021,11,Ica,Sitio Arqueologico Pampas de Huayuri,10,Octubre,0,0,0,0,0,0,0,0,0,0,0,0,0,0,0,0,0,0,0,0,Sitio Arqueológico
20240315,2021,11,Ica,Sitio Arqueologico Pampas de Huayuri,10,Octubre,1,0,0,0,0,0,0,0,0,0,0,0,0,0,0,0,0,0,0,0,Sitio Arqueológico
20240315,2021,11,Ica,Sitio Arqueologico Pampas de Huayuri,10,Octubre,2,0,0,0,0,0,0,0,0,0,0,0,0,0,0,0,0,0,0,0,Sitio Arqueológico
20240315,2021,11,Ica,Sitio Arqueologico Pampas de Huayuri,11,Noviembre,0,0,0,0,0,0,0,0,0,0,0,0,0,0,0,0,0,0,0,0,Sitio Arqueológico
20240315,2021,11,Ica,Sitio Arqueologico Pampas de Huayuri,11,Noviembre,1,0,0,0,0,0,0,0,0,0,0,0,0,0,0,0,0,0,0,0,Sitio Arqueológico
20240315,2021,11,Ica,Sitio Arqueologico Pampas de Huayuri,11,Noviembre,2,0,0,0,0,0,0,0,0,0,0,0,0,0,0,0,0,0,0,0,Sitio Arqueológico
20240315,2021,11,Ica,Sitio Arqueologico Pampas de Huayuri,12,Diciembre,0,0,0,0,0,0,0,0,0,0,0,0,0,0,0,0,0,0,0,0,Sitio Arqueológico
20240315,2021,11,Ica,Sitio Arqueologico Pampas de Huayuri,12,Diciembre,1,0,0,0,0,0,0,0,0,0,0,0,0,0,0,0,0,0,0,0,Sitio Arqueológico
20240315,2021,11,Ica,Sitio Arqueologico Pampas de Huayuri,12,Diciembre,2,0,0,0,0,0,0,0,0,0,0,0,0,0,0,0,0,0,0,0,Sitio Arqueológico
20240315,2021,11,Ica,Monumento Arqueologico de Palpa (Lineas y Geoglifos de Sacramento),1,Enero,0,0,0,0,0,0,0,0,0,0,0,0,0,0,0,0,0,0,0,0,Sitio Arqueológico
20240315,2021,11,Ica,Monumento Arqueologico de Palpa (Lineas y Geoglifos de Sacramento),1,Enero,1,0,0,0,0,0,0,0,0,0,0,0,0,0,0,0,0,0,0,0,Sitio Arqueológico
20240315,2021,11,Ica,Monumento Arqueologico de Palpa (Lineas y Geoglifos de Sacramento),1,Enero,2,0,0,0,0,0,0,0,0,0,0,0,0,0,0,0,0,0,0,0,Sitio Arqueológico
20240315,2021,11,Ica,Monumento Arqueologico de Palpa (Lineas y Geoglifos de Sacramento),2,Febrero,0,0,0,0,0,0,0,0,0,0,0,0,0,0,0,0,0,0,0,0,Sitio Arqueológico
20240315,2021,11,Ica,Monumento Arqueologico de Palpa (Lineas y Geoglifos de Sacramento),2,Febrero,1,0,0,0,0,0,0,0,0,0,0,0,0,0,0,0,0,0,0,0,Sitio Arqueológico
20240315,2021,11,Ica,Monumento Arqueologico de Palpa (Lineas y Geoglifos de Sacramento),2,Febrero,2,0,0,0,0,0,0,0,0,0,0,0,0,0,0,0,0,0,0,0,Sitio Arqueológico
20240315,2021,11,Ica,Monumento Arqueologico de Palpa (Lineas y Geoglifos de Sacramento),3,Marzo,0,0,0,0,0,0,0,0,0,0,0,0,0,0,0,0,0,0,0,0,Sitio Arqueológico
20240315,2021,11,Ica,Monumento Arqueologico de Palpa (Lineas y Geoglifos de Sacramento),3,Marzo,1,0,0,0,0,0,0,0,0,0,0,0,0,0,0,0,0,0,0,0,Sitio Arqueológico
20240315,2021,11,Ica,Monumento Arqueologico de Palpa (Lineas y Geoglifos de Sacramento),3,Marzo,2,0,0,0,0,0,0,0,0,0,0,0,0,0,0,0,0,0,0,0,Sitio Arqueológico
20240315,2021,11,Ica,Monumento Arqueologico de Palpa (Lineas y Geoglifos de Sacramento),4,Abril,0,0,0,0,0,0,0,0,0,0,0,0,0,0,0,0,0,0,0,0,Sitio Arqueológico
20240315,2021,11,Ica,Monumento Arqueologico de Palpa (Lineas y Geoglifos de Sacramento),4,Abril,1,0,0,0,0,0,0,0,0,0,0,0,0,0,0,0,0,0,0,0,Sitio Arqueológico
20240315,2021,11,Ica,Monumento Arqueologico de Palpa (Lineas y Geoglifos de Sacramento),4,Abril,2,0,0,0,0,0,0,0,0,0,0,0,0,0,0,0,0,0,0,0,Sitio Arqueológico
20240315,2021,11,Ica,Monumento Arqueologico de Palpa (Lineas y Geoglifos de Sacramento),5,Mayo,0,0,0,0,0,0,0,0,0,0,0,0,0,0,0,0,0,0,0,0,Sitio Arqueológico
20240315,2021,11,Ica,Monumento Arqueologico de Palpa (Lineas y Geoglifos de Sacramento),5,Mayo,1,0,0,0,0,0,0,0,0,0,0,0,0,0,0,0,0,0,0,0,Sitio Arqueológico
20240315,2021,11,Ica,Monumento Arqueologico de Palpa (Lineas y Geoglifos de Sacramento),5,Mayo,2,0,0,0,0,0,0,0,0,0,0,0,0,0,0,0,0,0,0,0,Sitio Arqueológico
20240315,2021,11,Ica,Monumento Arqueologico de Palpa (Lineas y Geoglifos de Sacramento),6,Junio,0,0,0,0,0,0,0,0,0,0,0,0,0,0,0,0,0,0,0,0,Sitio Arqueológico
20240315,2021,11,Ica,Monumento Arqueologico de Palpa (Lineas y Geoglifos de Sacramento),6,Junio,1,0,0,0,0,0,0,0,0,0,0,0,0,0,0,0,0,0,0,0,Sitio Arqueológico
20240315,2021,11,Ica,Monumento Arqueologico de Palpa (Lineas y Geoglifos de Sacramento),6,Junio,2,0,0,0,0,0,0,0,0,0,0,0,0,0,0,0,0,0,0,0,Sitio Arqueológico
20240315,2021,11,Ica,Monumento Arqueologico de Palpa (Lineas y Geoglifos de Sacramento),7,Julio,0,0,0,0,0,0,0,0,0,0,0,0,0,0,0,0,0,0,0,0,Sitio Arqueológico
20240315,2021,11,Ica,Monumento Arqueologico de Palpa (Lineas y Geoglifos de Sacramento),7,Julio,1,0,0,0,0,0,0,0,0,0,0,0,0,0,0,0,0,0,0,0,Sitio Arqueológico
20240315,2021,11,Ica,Monumento Arqueologico de Palpa (Lineas y Geoglifos de Sacramento),7,Julio,2,0,0,0,0,0,0,0,0,0,0,0,0,0,0,0,0,0,0,0,Sitio Arqueológico
20240315,2021,11,Ica,Monumento Arqueologico de Palpa (Lineas y Geoglifos de Sacramento),8,Agosto,0,0,0,0,0,0,0,0,0,0,0,0,0,0,0,0,0,0,0,0,Sitio Arqueológico
20240315,2021,11,Ica,Monumento Arqueologico de Palpa (Lineas y Geoglifos de Sacramento),8,Agosto,1,0,0,0,0,0,0,0,0,0,0,0,0,0,0,0,0,0,0,0,Sitio Arqueológico
20240315,2021,11,Ica,Monumento Arqueologico de Palpa (Lineas y Geoglifos de Sacramento),8,Agosto,2,0,0,0,0,0,0,0,0,0,0,0,0,0,0,0,0,0,0,0,Sitio Arqueológico
20240315,2021,11,Ica,Monumento Arqueologico de Palpa (Lineas y Geoglifos de Sacramento),9,Setiembre,0,0,0,0,0,0,0,0,0,0,0,0,0,0,0,0,0,0,0,0,Sitio Arqueológico
20240315,2021,11,Ica,Monumento Arqueologico de Palpa (Lineas y Geoglifos de Sacramento),9,Setiembre,1,0,0,0,0,0,0,0,0,0,0,0,0,0,0,0,0,0,0,0,Sitio Arqueológico
20240315,2021,11,Ica,Monumento Arqueologico de Palpa (Lineas y Geoglifos de Sacramento),9,Setiembre,2,0,0,0,0,0,0,0,0,0,0,0,0,0,0,0,0,0,0,0,Sitio Arqueológico
20240315,2021,11,Ica,Monumento Arqueologico de Palpa (Lineas y Geoglifos de Sacramento),10,Octubre,0,0,0,0,0,0,0,0,0,0,0,0,0,0,0,0,0,0,0,0,Sitio Arqueológico
20240315,2021,11,Ica,Monumento Arqueologico de Palpa (Lineas y Geoglifos de Sacramento),10,Octubre,1,0,0,0,0,0,0,0,0,0,0,0,0,0,0,0,0,0,0,0,Sitio Arqueológico
20240315,2021,11,Ica,Monumento Arqueologico de Palpa (Lineas y Geoglifos de Sacramento),10,Octubre,2,0,0,0,0,0,0,0,0,0,0,0,0,0,0,0,0,0,0,0,Sitio Arqueológico
20240315,2021,11,Ica,Monumento Arqueologico de Palpa (Lineas y Geoglifos de Sacramento),11,Noviembre,0,0,0,0,0,0,0,0,0,0,0,0,0,0,0,0,0,0,0,0,Sitio Arqueológico
20240315,2021,11,Ica,Monumento Arqueologico de Palpa (Lineas y Geoglifos de Sacramento),11,Noviembre,1,0,0,0,0,0,0,0,0,0,0,0,0,0,0,0,0,0,0,0,Sitio Arqueológico
20240315,2021,11,Ica,Monumento Arqueologico de Palpa (Lineas y Geoglifos de Sacramento),11,Noviembre,2,0,0,0,0,0,0,0,0,0,0,0,0,0,0,0,0,0,0,0,Sitio Arqueológico
20240315,2021,11,Ica,Monumento Arqueologico de Palpa (Lineas y Geoglifos de Sacramento),12,Diciembre,0,0,0,0,0,0,0,0,0,0,0,0,0,0,0,0,0,0,0,0,Sitio Arqueológico
20240315,2021,11,Ica,Monumento Arqueologico de Palpa (Lineas y Geoglifos de Sacramento),12,Diciembre,1,0,0,0,0,0,0,0,0,0,0,0,0,0,0,0,0,0,0,0,Sitio Arqueológico
20240315,2021,11,Ica,Monumento Arqueologico de Palpa (Lineas y Geoglifos de Sacramento),12,Diciembre,2,0,0,0,0,0,0,0,0,0,0,0,0,0,0,0,0,0,0,0,Sitio Arqueológico
20240315,2021,11,Ica,Sitio Arqueologico Centinela,1,Enero,0,0,0,0,0,0,0,0,0,0,0,0,0,0,0,0,0,0,0,0,Sitio Arqueológico
20240315,2021,11,Ica,Sitio Arqueologico Centinela,1,Enero,1,0,0,0,0,0,0,0,0,0,0,0,0,0,0,0,0,0,0,0,Sitio Arqueológico
20240315,2021,11,Ica,Sitio Arqueologico Centinela,1,Enero,2,0,0,0,0,0,0,0,0,0,0,0,0,0,0,0,0,0,0,0,Sitio Arqueológico
20240315,2021,11,Ica,Sitio Arqueologico Centinela,2,Febrero,0,0,0,0,0,0,0,0,0,0,0,0,0,0,0,0,0,0,0,0,Sitio Arqueológico
20240315,2021,11,Ica,Sitio Arqueologico Centinela,2,Febrero,1,0,0,0,0,0,0,0,0,0,0,0,0,0,0,0,0,0,0,0,Sitio Arqueológico
20240315,2021,11,Ica,Sitio Arqueologico Centinela,2,Febrero,2,0,0,0,0,0,0,0,0,0,0,0,0,0,0,0,0,0,0,0,Sitio Arqueológico
20240315,2021,11,Ica,Sitio Arqueologico Centinela,3,Marzo,0,0,0,0,0,0,0,0,0,0,0,0,0,0,0,0,0,0,0,0,Sitio Arqueológico
20240315,2021,11,Ica,Sitio Arqueologico Centinela,3,Marzo,1,0,0,0,0,0,0,0,0,0,0,0,0,0,0,0,0,0,0,0,Sitio Arqueológico
20240315,2021,11,Ica,Sitio Arqueologico Centinela,3,Marzo,2,0,0,0,0,0,0,0,0,0,0,0,0,0,0,0,0,0,0,0,Sitio Arqueológico
20240315,2021,11,Ica,Sitio Arqueologico Centinela,4,Abril,0,0,0,0,0,0,0,0,0,0,0,0,0,0,0,0,0,0,0,0,Sitio Arqueológico
20240315,2021,11,Ica,Sitio Arqueologico Centinela,4,Abril,1,0,0,0,0,0,0,0,0,0,0,0,0,0,0,0,0,0,0,0,Sitio Arqueológico
20240315,2021,11,Ica,Sitio Arqueologico Centinela,4,Abril,2,0,0,0,0,0,0,0,0,0,0,0,0,0,0,0,0,0,0,0,Sitio Arqueológico
20240315,2021,11,Ica,Sitio Arqueologico Centinela,5,Mayo,0,0,0,0,0,0,0,0,0,0,0,0,0,0,0,0,0,0,0,0,Sitio Arqueológico
20240315,2021,11,Ica,Sitio Arqueologico Centinela,5,Mayo,1,0,0,0,0,0,0,0,0,0,0,0,0,0,0,0,0,0,0,0,Sitio Arqueológico
20240315,2021,11,Ica,Sitio Arqueologico Centinela,5,Mayo,2,0,0,0,0,0,0,0,0,0,0,0,0,0,0,0,0,0,0,0,Sitio Arqueológico
20240315,2021,11,Ica,Sitio Arqueologico Centinela,6,Junio,0,0,0,0,0,0,0,0,0,0,0,0,0,0,0,0,0,0,0,0,Sitio Arqueológico
20240315,2021,11,Ica,Sitio Arqueologico Centinela,6,Junio,1,0,0,0,0,0,0,0,0,0,0,0,0,0,0,0,0,0,0,0,Sitio Arqueológico
20240315,2021,11,Ica,Sitio Arqueologico Centinela,6,Junio,2,0,0,0,0,0,0,0,0,0,0,0,0,0,0,0,0,0,0,0,Sitio Arqueológico
20240315,2021,11,Ica,Sitio Arqueologico Centinela,7,Julio,0,0,0,0,0,0,0,0,0,0,0,0,0,0,0,0,0,0,0,0,Sitio Arqueológico
20240315,2021,11,Ica,Sitio Arqueologico Centinela,7,Julio,1,0,0,0,0,0,0,0,0,0,0,0,0,0,0,0,0,0,0,0,Sitio Arqueológico
20240315,2021,11,Ica,Sitio Arqueologico Centinela,7,Julio,2,0,0,0,0,0,0,0,0,0,0,0,0,0,0,0,0,0,0,0,Sitio Arqueológico
20240315,2021,11,Ica,Sitio Arqueologico Centinela,8,Agosto,0,0,0,0,0,0,0,0,0,0,0,0,0,0,0,0,0,0,0,0,Sitio Arqueológico
20240315,2021,11,Ica,Sitio Arqueologico Centinela,8,Agosto,1,0,0,0,0,0,0,0,0,0,0,0,0,0,0,0,0,0,0,0,Sitio Arqueológico
20240315,2021,11,Ica,Sitio Arqueologico Centinela,8,Agosto,2,0,0,0,0,0,0,0,0,0,0,0,0,0,0,0,0,0,0,0,Sitio Arqueológico
20240315,2021,11,Ica,Sitio Arqueologico Centinela,9,Setiembre,0,0,0,0,0,0,0,0,0,0,0,0,0,0,0,0,0,0,0,0,Sitio Arqueológico
20240315,2021,11,Ica,Sitio Arqueologico Centinela,9,Setiembre,1,0,0,0,0,0,0,0,0,0,0,0,0,0,0,0,0,0,0,0,Sitio Arqueológico
20240315,2021,11,Ica,Sitio Arqueologico Centinela,9,Setiembre,2,0,0,0,0,0,0,0,0,0,0,0,0,0,0,0,0,0,0,0,Sitio Arqueológico
20240315,2021,11,Ica,Sitio Arqueologico Centinela,10,Octubre,0,0,0,0,0,0,0,0,0,0,0,0,0,0,0,0,0,0,0,0,Sitio Arqueológico
20240315,2021,11,Ica,Sitio Arqueologico Centinela,10,Octubre,1,0,0,0,0,0,0,0,0,0,0,0,0,0,0,0,0,0,0,0,Sitio Arqueológico
20240315,2021,11,Ica,Sitio Arqueologico Centinela,10,Octubre,2,0,0,0,0,0,0,0,0,0,0,0,0,0,0,0,0,0,0,0,Sitio Arqueológico
20240315,2021,11,Ica,Sitio Arqueologico Centinela,11,Noviembre,0,0,0,0,0,0,0,0,0,0,0,0,0,0,0,0,0,0,0,0,Sitio Arqueológico
20240315,2021,11,Ica,Sitio Arqueologico Centinela,11,Noviembre,1,0,0,0,0,0,0,0,0,0,0,0,0,0,0,0,0,0,0,0,Sitio Arqueológico
20240315,2021,11,Ica,Sitio Arqueologico Centinela,11,Noviembre,2,0,0,0,0,0,0,0,0,0,0,0,0,0,0,0,0,0,0,0,Sitio Arqueológico
20240315,2021,11,Ica,Sitio Arqueologico Centinela,12,Diciembre,0,0,0,0,0,0,0,0,0,0,0,0,0,0,0,0,0,0,0,0,Sitio Arqueológico
20240315,2021,11,Ica,Sitio Arqueologico Centinela,12,Diciembre,1,0,0,0,0,0,0,0,0,0,0,0,0,0,0,0,0,0,0,0,Sitio Arqueológico
20240315,2021,11,Ica,Sitio Arqueologico Centinela,12,Diciembre,2,0,0,0,0,0,0,0,0,0,0,0,0,0,0,0,0,0,0,0,Sitio Arqueológico
20240315,2021,11,Ica,Reserva Arqueologica Lineas y Geoglifos de Nazca,1,Enero,0,0,0,0,0,0,0,0,0,0,0,0,0,0,0,0,0,0,0,0,Sitio Arqueológico
20240315,2021,11,Ica,Reserva Arqueologica Lineas y Geoglifos de Nazca,1,Enero,1,0,0,0,0,0,0,0,0,0,0,0,0,0,0,0,0,0,0,0,Sitio Arqueológico
20240315,2021,11,Ica,Reserva Arqueologica Lineas y Geoglifos de Nazca,1,Enero,2,0,0,0,0,0,0,0,0,0,0,0,0,0,0,0,0,0,0,0,Sitio Arqueológico
20240315,2021,11,Ica,Reserva Arqueologica Lineas y Geoglifos de Nazca,2,Febrero,0,0,0,0,0,0,0,0,0,0,0,0,0,0,0,0,0,0,0,0,Sitio Arqueológico
20240315,2021,11,Ica,Reserva Arqueologica Lineas y Geoglifos de Nazca,2,Febrero,1,0,0,0,0,0,0,0,0,0,0,0,0,0,0,0,0,0,0,0,Sitio Arqueológico
20240315,2021,11,Ica,Reserva Arqueologica Lineas y Geoglifos de Nazca,2,Febrero,2,0,0,0,0,0,0,0,0,0,0,0,0,0,0,0,0,0,0,0,Sitio Arqueológico
20240315,2021,11,Ica,Reserva Arqueologica Lineas y Geoglifos de Nazca,3,Marzo,0,0,0,0,0,0,0,0,0,0,0,0,0,0,0,0,0,0,0,0,Sitio Arqueológico
20240315,2021,11,Ica,Reserva Arqueologica Lineas y Geoglifos de Nazca,3,Marzo,1,0,0,0,0,0,0,0,0,0,0,0,0,0,0,0,0,0,0,0,Sitio Arqueológico
20240315,2021,11,Ica,Reserva Arqueologica Lineas y Geoglifos de Nazca,3,Marzo,2,0,0,0,0,0,0,0,0,0,0,0,0,0,0,0,0,0,0,0,Sitio Arqueológico
20240315,2021,11,Ica,Reserva Arqueologica Lineas y Geoglifos de Nazca,4,Abril,0,0,0,0,0,0,0,0,0,0,0,0,0,0,0,0,0,0,0,0,Sitio Arqueológico
20240315,2021,11,Ica,Reserva Arqueologica Lineas y Geoglifos de Nazca,4,Abril,1,0,0,0,0,0,0,0,0,0,0,0,0,0,0,0,0,0,0,0,Sitio Arqueológico
20240315,2021,11,Ica,Reserva Arqueologica Lineas y Geoglifos de Nazca,4,Abril,2,0,0,0,0,0,0,0,0,0,0,0,0,0,0,0,0,0,0,0,Sitio Arqueológico
20240315,2021,11,Ica,Reserva Arqueologica Lineas y Geoglifos de Nazca,5,Mayo,0,0,0,0,0,0,1585,286,662,2533,0,0,0,0,0,0,0,0,0,2533,Sitio Arqueológico
20240315,2021,11,Ica,Reserva Arqueologica Lineas y Geoglifos de Nazca,5,Mayo,1,0,0,0,0,0,0,0,0,0,0,0,0,0,0,0,0,0,0,0,Sitio Arqueológico
20240315,2021,11,Ica,Reserva Arqueologica Lineas y Geoglifos de Nazca,5,Mayo,2,0,0,0,0,0,1585,286,662,2533,0,0,0,0,0,0,0,0,0,2533,Sitio Arqueológico
20240315,2021,11,Ica,Reserva Arqueologica Lineas y Geoglifos de Nazca,6,Junio,0,0,0,0,0,0,1526,420,469,2415,0,0,0,0,0,0,0,0,0,2415,Sitio Arqueológico
20240315,2021,11,Ica,Reserva Arqueologica Lineas y Geoglifos de Nazca,6,Junio,1,0,0,0,0,0,0,0,0,0,0,0,0,0,0,0,0,0,0,0,Sitio Arqueológico
20240315,2021,11,Ica,Reserva Arqueologica Lineas y Geoglifos de Nazca,6,Junio,2,0,0,0,0,0,1526,420,469,2415,0,0,0,0,0,0,0,0,0,2415,Sitio Arqueológico
20240315,2021,11,Ica,Reserva Arqueologica Lineas y Geoglifos de Nazca,7,Julio,0,0,0,0,0,0,3291,907,1438,5636,0,0,0,0,0,0,0,0,0,5636,Sitio Arqueológico
20240315,2021,11,Ica,Reserva Arqueologica Lineas y Geoglifos de Nazca,7,Julio,1,0,0,0,0,0,480,0,0,480,0,0,0,0,0,0,0,0,0,480,Sitio Arqueológico
20240315,2021,11,Ica,Reserva Arqueologica Lineas y Geoglifos de Nazca,7,Julio,2,0,0,0,0,0,3771,907,1438,6116,0,0,0,0,0,0,0,0,0,6116,Sitio Arqueológico
20240315,2021,11,Ica,Reserva Arqueologica Lineas y Geoglifos de Nazca,8,Agosto,0,0,0,0,0,0,4715,906,1833,7454,0,0,0,0,0,983,0,0,983,8437,Sitio Arqueológico
20240315,2021,11,Ica,Reserva Arqueologica Lineas y Geoglifos de Nazca,8,Agosto,1,0,0,0,0,0,0,0,0,0,0,0,0,0,0,0,0,0,0,0,Sitio Arqueológico
20240315,2021,11,Ica,Reserva Arqueologica Lineas y Geoglifos de Nazca,8,Agosto,2,0,0,0,0,0,4715,906,1833,7454,0,0,0,0,0,983,0,0,983,8437,Sitio Arqueológico
20240315,2021,11,Ica,Reserva Arqueologica Lineas y Geoglifos de Nazca,9,Setiembre,0,0,0,0,0,0,3016,635,872,4523,0,0,0,0,0,0,0,0,0,4523,Sitio Arqueológico
20240315,2021,11,Ica,Reserva Arqueologica Lineas y Geoglifos de Nazca,9,Setiembre,1,0,0,0,0,0,0,0,0,0,0,0,0,0,0,0,0,0,0,0,Sitio Arqueológico
20240315,2021,11,Ica,Reserva Arqueologica Lineas y Geoglifos de Nazca,9,Setiembre,2,0,0,0,0,0,3016,635,872,4523,0,0,0,0,0,0,0,0,0,4523,Sitio Arqueológico
20240315,2021,11,Ica,Reserva Arqueologica Lineas y Geoglifos de Nazca,10,Octubre,0,0,0,0,0,0,3463,1860,1675,6998,0,0,0,0,0,24,0,0,24,7022,Sitio Arqueológico
20240315,2021,11,Ica,Reserva Arqueologica Lineas y Geoglifos de Nazca,10,Octubre,1,0,0,0,0,0,0,0,0,0,0,0,0,0,0,0,0,0,0,0,Sitio Arqueológico
20240315,2021,11,Ica,Reserva Arqueologica Lineas y Geoglifos de Nazca,10,Octubre,2,0,0,0,0,0,3463,1860,1675,6998,0,0,0,0,0,24,0,0,24,7022,Sitio Arqueológico
20240315,2021,11,Ica,Reserva Arqueologica Lineas y Geoglifos de Nazca,11,Noviembre,0,0,0,0,0,0,3080,895,855,4830,0,0,0,0,0,0,0,0,0,4830,Sitio Arqueológico
20240315,2021,11,Ica,Reserva Arqueologica Lineas y Geoglifos de Nazca,11,Noviembre,1,0,0,0,0,0,0,0,0,0,0,0,0,0,0,0,0,0,0,0,Sitio Arqueológico
20240315,2021,11,Ica,Reserva Arqueologica Lineas y Geoglifos de Nazca,11,Noviembre,2,0,0,0,0,0,3080,895,855,4830,0,0,0,0,0,0,0,0,0,4830,Sitio Arqueológico
20240315,2021,11,Ica,Reserva Arqueologica Lineas y Geoglifos de Nazca,12,Diciembre,0,0,0,0,0,0,2859,751,1141,4751,0,0,0,0,0,0,0,0,0,4751,Sitio Arqueológico
20240315,2021,11,Ica,Reserva Arqueologica Lineas y Geoglifos de Nazca,12,Diciembre,1,0,0,0,0,0,16,0,0,16,0,0,0,0,0,0,0,0,0,16,Sitio Arqueológico
20240315,2021,11,Ica,Reserva Arqueologica Lineas y Geoglifos de Nazca,12,Diciembre,2,0,0,0,0,0,2875,751,1141,4767,0,0,0,0,0,0,0,0,0,4767,Sitio Arqueológico
20240315,2021,13,La Libertad,Complejo Arqueologico Chan Chan (Palacio Nik-An),1,Enero,0,0,0,0,0,0,956,623,261,1840,0,0,0,0,0,352,49,98,499,2339,Sitio Arqueológico
20240315,2021,13,La Libertad,Complejo Arqueologico Chan Chan (Palacio Nik-An),1,Enero,1,0,0,0,0,0,97,24,0,121,0,0,0,0,0,0,0,0,0,121,Sitio Arqueológico
20240315,2021,13,La Libertad,Complejo Arqueologico Chan Chan (Palacio Nik-An),1,Enero,2,0,0,0,0,0,1053,647,261,1961,0,0,0,0,0,352,49,98,499,2460,Sitio Arqueológico
20240315,2021,13,La Libertad,Complejo Arqueologico Chan Chan (Palacio Nik-An),2,Febrero,0,0,0,0,0,0,138,44,30,212,0,0,0,0,0,164,55,37,256,468,Sitio Arqueológico
20240315,2021,13,La Libertad,Complejo Arqueologico Chan Chan (Palacio Nik-An),2,Febrero,1,0,0,0,0,0,7,0,0,7,0,0,0,0,0,0,0,0,0,7,Sitio Arqueológico
20240315,2021,13,La Libertad,Complejo Arqueologico Chan Chan (Palacio Nik-An),2,Febrero,2,0,0,0,0,0,145,44,30,219,0,0,0,0,0,164,55,37,256,475,Sitio Arqueológico
20240315,2021,13,La Libertad,Complejo Arqueologico Chan Chan (Palacio Nik-An),3,Marzo,0,0,0,0,0,0,326,70,65,461,0,0,0,0,0,251,64,79,394,855,Sitio Arqueológico
20240315,2021,13,La Libertad,Complejo Arqueologico Chan Chan (Palacio Nik-An),3,Marzo,1,0,0,0,0,0,6,2,0,8,0,0,0,0,0,0,0,0,0,8,Sitio Arqueológico
20240315,2021,13,La Libertad,Complejo Arqueologico Chan Chan (Palacio Nik-An),3,Marzo,2,0,0,0,0,0,332,72,65,469,0,0,0,0,0,251,64,79,394,863,Sitio Arqueológico
20240315,2021,13,La Libertad,Complejo Arqueologico Chan Chan (Palacio Nik-An),4,Abril,0,0,0,0,0,0,97,129,66,292,0,0,0,0,0,0,0,0,0,292,Sitio Arqueológico
20240315,2021,13,La Libertad,Complejo Arqueologico Chan Chan (Palacio Nik-An),4,Abril,1,0,0,0,0,0,10,54,3,67,0,0,0,0,0,0,0,0,0,67,Sitio Arqueológico
20240315,2021,13,La Libertad,Complejo Arqueologico Chan Chan (Palacio Nik-An),4,Abril,2,0,0,0,0,0,107,183,69,359,0,0,0,0,0,0,0,0,0,359,Sitio Arqueológico
20240315,2021,13,La Libertad,Complejo Arqueologico Chan Chan (Palacio Nik-An),5,Mayo,0,0,0,0,0,0,478,150,122,750,0,0,0,0,0,0,0,0,0,750,Sitio Arqueológico
20240315,2021,13,La Libertad,Complejo Arqueologico Chan Chan (Palacio Nik-An),5,Mayo,1,0,0,0,0,0,1,1,0,2,0,0,0,0,0,0,0,0,0,2,Sitio Arqueológico
20240315,2021,13,La Libertad,Complejo Arqueologico Chan Chan (Palacio Nik-An),5,Mayo,2,0,0,0,0,0,479,151,122,752,0,0,0,0,0,0,0,0,0,752,Sitio Arqueológico
20240315,2021,13,La Libertad,Complejo Arqueologico Chan Chan (Palacio Nik-An),6,Junio,0,0,0,0,0,0,967,229,208,1404,0,0,0,0,0,0,0,0,0,1404,Sitio Arqueológico
20240315,2021,13,La Libertad,Complejo Arqueologico Chan Chan (Palacio Nik-An),6,Junio,1,0,0,0,0,0,27,1,0,28,0,0,0,0,0,0,0,0,0,28,Sitio Arqueológico
20240315,2021,13,La Libertad,Complejo Arqueologico Chan Chan (Palacio Nik-An),6,Junio,2,0,0,0,0,0,994,230,208,1432,0,0,0,0,0,0,0,0,0,1432,Sitio Arqueológico
20240315,2021,13,La Libertad,Complejo Arqueologico Chan Chan (Palacio Nik-An),7,Julio,0,0,0,0,0,0,4608,1203,1555,7366,0,0,0,0,0,324,78,120,522,7888,Sitio Arqueológico
20240315,2021,13,La Libertad,Complejo Arqueologico Chan Chan (Palacio Nik-An),7,Julio,1,0,0,0,0,0,102,2,2,106,0,0,0,0,0,0,0,0,0,106,Sitio Arqueológico
20240315,2021,13,La Libertad,Complejo Arqueologico Chan Chan (Palacio Nik-An),7,Julio,2,0,0,0,0,0,4710,1205,1557,7472,0,0,0,0,0,324,78,120,522,7994,Sitio Arqueológico
20240315,2021,13,La Libertad,Complejo Arqueologico Chan Chan (Palacio Nik-An),8,Agosto,0,0,0,0,0,0,4609,1547,1604,7760,0,0,0,0,0,1606,88,428,2122,9882,Sitio Arqueológico
20240315,2021,13,La Libertad,Complejo Arqueologico Chan Chan (Palacio Nik-An),8,Agosto,1,0,0,0,0,0,59,14,0,73,0,0,0,0,0,0,0,0,0,73,Sitio Arqueológico
20240315,2021,13,La Libertad,Complejo Arqueologico Chan Chan (Palacio Nik-An),8,Agosto,2,0,0,0,0,0,4668,1561,1604,7833,0,0,0,0,0,1606,88,428,2122,9955,Sitio Arqueológico
20240315,2021,13,La Libertad,Complejo Arqueologico Chan Chan (Palacio Nik-An),9,Setiembre,0,0,0,0,0,0,2319,830,655,3804,0,0,0,0,0,908,127,161,1196,5000,Sitio Arqueológico
20240315,2021,13,La Libertad,Complejo Arqueologico Chan Chan (Palacio Nik-An),9,Setiembre,1,0,0,0,0,0,109,13,0,122,0,0,0,0,0,0,0,0,0,122,Sitio Arqueológico
20240315,2021,13,La Libertad,Complejo Arqueologico Chan Chan (Palacio Nik-An),9,Setiembre,2,0,0,0,0,0,2428,843,655,3926,0,0,0,0,0,908,127,161,1196,5122,Sitio Arqueológico
20240315,2021,13,La Libertad,Complejo Arqueologico Chan Chan (Palacio Nik-An),10,Octubre,0,0,0,0,0,0,4040,1697,1447,7184,0,0,0,0,0,940,106,213,1259,8443,Sitio Arqueológico
20240315,2021,13,La Libertad,Complejo Arqueologico Chan Chan (Palacio Nik-An),10,Octubre,1,0,0,0,0,0,142,1,0,143,0,0,0,0,0,0,0,0,0,143,Sitio Arqueológico
20240315,2021,13,La Libertad,Complejo Arqueologico Chan Chan (Palacio Nik-An),10,Octubre,2,0,0,0,0,0,4182,1698,1447,7327,0,0,0,0,0,940,106,213,1259,8586,Sitio Arqueológico
20240315,2021,13,La Libertad,Complejo Arqueologico Chan Chan (Palacio Nik-An),11,Noviembre,0,0,0,0,0,0,2048,743,570,3361,0,0,0,0,0,1637,88,316,2041,5402,Sitio Arqueológico
20240315,2021,13,La Libertad,Complejo Arqueologico Chan Chan (Palacio Nik-An),11,Noviembre,1,0,0,0,0,0,201,25,4,230,0,0,0,0,0,0,0,0,0,230,Sitio Arqueológico
20240315,2021,13,La Libertad,Complejo Arqueologico Chan Chan (Palacio Nik-An),11,Noviembre,2,0,0,0,0,0,2249,768,574,3591,0,0,0,0,0,1637,88,316,2041,5632,Sitio Arqueológico
20240315,2021,13,La Libertad,Complejo Arqueologico Chan Chan (Palacio Nik-An),12,Diciembre,0,0,0,0,0,0,1880,640,600,3120,0,0,0,0,0,793,108,132,1033,4153,Sitio Arqueológico
20240315,2021,13,La Libertad,Complejo Arqueologico Chan Chan (Palacio Nik-An),12,Diciembre,1,0,0,0,0,0,260,123,0,383,0,0,0,0,0,0,0,0,0,383,Sitio Arqueológico
20240315,2021,13,La Libertad,Complejo Arqueologico Chan Chan (Palacio Nik-An),12,Diciembre,2,0,0,0,0,0,2140,763,600,3503,0,0,0,0,0,793,108,132,1033,4536,Sitio Arqueológico
20240315,2021,13,La Libertad,Zona Arqueologica Monumental Huaca del Sol y de La Luna,1,Enero,0,0,0,0,0,0,1120,332,203,1655,0,0,0,0,0,86,27,21,134,1789,Sitio Arqueológico
20240315,2021,13,La Libertad,Zona Arqueologica Monumental Huaca del Sol y de La Luna,1,Enero,1,0,0,0,0,0,57,2,8,67,0,0,0,0,0,0,0,0,0,67,Sitio Arqueológico
20240315,2021,13,La Libertad,Zona Arqueologica Monumental Huaca del Sol y de La Luna,1,Enero,2,0,0,0,0,0,1177,334,211,1722,0,0,0,0,0,86,27,21,134,1856,Sitio Arqueológico
20240315,2021,13,La Libertad,Zona Arqueologica Monumental Huaca del Sol y de La Luna,2,Febrero,0,0,0,0,0,0,142,47,34,223,0,0,0,0,0,114,2,28,144,367,Sitio Arqueológico
20240315,2021,13,La Libertad,Zona Arqueologica Monumental Huaca del Sol y de La Luna,2,Febrero,1,0,0,0,0,0,17,1,1,19,0,0,0,0,0,0,0,0,0,19,Sitio Arqueológico
20240315,2021,13,La Libertad,Zona Arqueologica Monumental Huaca del Sol y de La Luna,2,Febrero,2,0,0,0,0,0,159,48,35,242,0,0,0,0,0,114,2,28,144,386,Sitio Arqueológico
20240315,2021,13,La Libertad,Zona Arqueologica Monumental Huaca del Sol y de La Luna,3,Marzo,0,0,0,0,0,0,308,85,41,434,0,0,0,0,0,0,0,0,0,434,Sitio Arqueológico
20240315,2021,13,La Libertad,Zona Arqueologica Monumental Huaca del Sol y de La Luna,3,Marzo,1,0,0,0,0,0,12,0,0,12,0,0,0,0,0,0,0,0,0,12,Sitio Arqueológico
20240315,2021,13,La Libertad,Zona Arqueologica Monumental Huaca del Sol y de La Luna,3,Marzo,2,0,0,0,0,0,320,85,41,446,0,0,0,0,0,0,0,0,0,446,Sitio Arqueológico
20240315,2021,13,La Libertad,Zona Arqueologica Monumental Huaca del Sol y de La Luna,4,Abril,0,0,0,0,0,0,211,44,16,271,0,0,0,0,0,0,0,0,0,271,Sitio Arqueológico
20240315,2021,13,La Libertad,Zona Arqueologica Monumental Huaca del Sol y de La Luna,4,Abril,1,0,0,0,0,0,43,0,1,44,0,0,0,0,0,0,0,0,0,44,Sitio Arqueológico
20240315,2021,13,La Libertad,Zona Arqueologica Monumental Huaca del Sol y de La Luna,4,Abril,2,0,0,0,0,0,254,44,17,315,0,0,0,0,0,0,0,0,0,315,Sitio Arqueológico
20240315,2021,13,La Libertad,Zona Arqueologica Monumental Huaca del Sol y de La Luna,5,Mayo,0,0,0,0,0,0,575,172,122,869,0,0,0,0,0,0,0,0,0,869,Sitio Arqueológico
20240315,2021,13,La Libertad,Zona Arqueologica Monumental Huaca del Sol y de La Luna,5,Mayo,1,0,0,0,0,0,49,6,2,57,0,0,0,0,0,0,0,0,0,57,Sitio Arqueológico
20240315,2021,13,La Libertad,Zona Arqueologica Monumental Huaca del Sol y de La Luna,5,Mayo,2,0,0,0,0,0,624,178,124,926,0,0,0,0,0,0,0,0,0,926,Sitio Arqueológico
20240315,2021,13,La Libertad,Zona Arqueologica Monumental Huaca del Sol y de La Luna,6,Junio,0,0,0,0,0,0,871,200,167,1238,0,0,0,0,0,0,0,0,0,1238,Sitio Arqueológico
20240315,2021,13,La Libertad,Zona Arqueologica Monumental Huaca del Sol y de La Luna,6,Junio,1,0,0,0,0,0,59,9,2,70,0,0,0,0,0,0,0,0,0,70,Sitio Arqueológico
20240315,2021,13,La Libertad,Zona Arqueologica Monumental Huaca del Sol y de La Luna,6,Junio,2,0,0,0,0,0,930,209,169,1308,0,0,0,0,0,0,0,0,0,1308,Sitio Arqueológico
20240315,2021,13,La Libertad,Zona Arqueologica Monumental Huaca del Sol y de La Luna,7,Julio,0,0,0,0,0,0,3649,1010,1084,5743,0,0,0,0,0,0,0,0,0,5743,Sitio Arqueológico
20240315,2021,13,La Libertad,Zona Arqueologica Monumental Huaca del Sol y de La Luna,7,Julio,1,0,0,0,0,0,147,21,6,174,0,0,0,0,0,0,0,0,0,174,Sitio Arqueológico
20240315,2021,13,La Libertad,Zona Arqueologica Monumental Huaca del Sol y de La Luna,7,Julio,2,0,0,0,0,0,3796,1031,1090,5917,0,0,0,0,0,0,0,0,0,5917,Sitio Arqueológico
20240315,2021,13,La Libertad,Zona Arqueologica Monumental Huaca del Sol y de La Luna,8,Agosto,0,0,0,0,0,0,4294,1550,1277,7121,0,0,0,0,0,495,20,176,691,7812,Sitio Arqueológico
20240315,2021,13,La Libertad,Zona Arqueologica Monumental Huaca del Sol y de La Luna,8,Agosto,1,0,0,0,0,0,227,53,9,289,0,0,0,0,0,0,0,0,0,289,Sitio Arqueológico
20240315,2021,13,La Libertad,Zona Arqueologica Monumental Huaca del Sol y de La Luna,8,Agosto,2,0,0,0,0,0,4521,1603,1286,7410,0,0,0,0,0,495,20,176,691,8101,Sitio Arqueológico
20240315,2021,13,La Libertad,Zona Arqueologica Monumental Huaca del Sol y de La Luna,9,Setiembre,0,0,0,0,0,0,2355,809,522,3686,0,0,0,0,0,390,2,120,512,4198,Sitio Arqueológico
20240315,2021,13,La Libertad,Zona Arqueologica Monumental Huaca del Sol y de La Luna,9,Setiembre,1,0,0,0,0,0,216,36,5,257,0,0,0,0,0,0,0,0,0,257,Sitio Arqueológico
20240315,2021,13,La Libertad,Zona Arqueologica Monumental Huaca del Sol y de La Luna,9,Setiembre,2,0,0,0,0,0,2571,845,527,3943,0,0,0,0,0,390,2,120,512,4455,Sitio Arqueológico
20240315,2021,13,La Libertad,Zona Arqueologica Monumental Huaca del Sol y de La Luna,10,Octubre,0,0,0,0,0,0,3986,1524,1205,6715,0,0,0,0,0,0,0,0,0,6715,Sitio Arqueológico
20240315,2021,13,La Libertad,Zona Arqueologica Monumental Huaca del Sol y de La Luna,10,Octubre,1,0,0,0,0,0,245,61,8,314,0,0,0,0,0,0,0,0,0,314,Sitio Arqueológico
20240315,2021,13,La Libertad,Zona Arqueologica Monumental Huaca del Sol y de La Luna,10,Octubre,2,0,0,0,0,0,4231,1585,1213,7029,0,0,0,0,0,0,0,0,0,7029,Sitio Arqueológico
20240315,2021,13,La Libertad,Zona Arqueologica Monumental Huaca del Sol y de La Luna,11,Noviembre,0,0,0,0,0,0,2504,961,471,3936,0,0,0,0,0,290,41,62,393,4329,Sitio Arqueológico
20240315,2021,13,La Libertad,Zona Arqueologica Monumental Huaca del Sol y de La Luna,11,Noviembre,1,0,0,0,0,0,299,63,10,372,0,0,0,0,0,0,0,0,0,372,Sitio Arqueológico
20240315,2021,13,La Libertad,Zona Arqueologica Monumental Huaca del Sol y de La Luna,11,Noviembre,2,0,0,0,0,0,2803,1024,481,4308,0,0,0,0,0,290,41,62,393,4701,Sitio Arqueológico
20240315,2021,13,La Libertad,Zona Arqueologica Monumental Huaca del Sol y de La Luna,12,Diciembre,0,0,0,0,0,0,1952,834,392,3178,0,0,0,0,0,262,29,36,327,3505,Sitio Arqueológico
20240315,2021,13,La Libertad,Zona Arqueologica Monumental Huaca del Sol y de La Luna,12,Diciembre,1,0,0,0,0,0,406,87,22,515,0,0,0,0,0,0,0,0,0,515,Sitio Arqueológico
20240315,2021,13,La Libertad,Zona Arqueologica Monumental Huaca del Sol y de La Luna,12,Diciembre,2,0,0,0,0,0,2358,921,414,3693,0,0,0,0,0,262,29,36,327,4020,Sitio Arqueológico
20240315,2021,13,La Libertad,Zona Arqueologica Monumental El Brujo,1,Enero,0,0,0,0,0,0,546,168,106,820,0,0,0,0,0,72,52,35,159,979,Sitio Arqueológico
20240315,2021,13,La Libertad,Zona Arqueologica Monumental El Brujo,1,Enero,1,0,0,0,0,0,32,3,2,37,0,0,0,0,0,0,0,0,0,37,Sitio Arqueológico
20240315,2021,13,La Libertad,Zona Arqueologica Monumental El Brujo,1,Enero,2,0,0,0,0,0,578,171,108,857,0,0,0,0,0,72,52,35,159,1016,Sitio Arqueológico
20240315,2021,13,La Libertad,Zona Arqueologica Monumental El Brujo,2,Febrero,0,0,0,0,0,0,82,23,27,132,0,0,0,0,0,6,4,1,11,143,Sitio Arqueológico
20240315,2021,13,La Libertad,Zona Arqueologica Monumental El Brujo,2,Febrero,1,0,0,0,0,0,1,1,0,2,0,0,0,0,0,0,0,0,0,2,Sitio Arqueológico
20240315,2021,13,La Libertad,Zona Arqueologica Monumental El Brujo,2,Febrero,2,0,0,0,0,0,83,24,27,134,0,0,0,0,0,6,4,1,11,145,Sitio Arqueológico
20240315,2021,13,La Libertad,Zona Arqueologica Monumental El Brujo,3,Marzo,0,0,0,0,0,0,194,57,37,288,0,0,0,0,0,17,10,3,30,318,Sitio Arqueológico
20240315,2021,13,La Libertad,Zona Arqueologica Monumental El Brujo,3,Marzo,1,0,0,0,0,0,4,0,0,4,0,0,0,0,0,0,0,0,0,4,Sitio Arqueológico
20240315,2021,13,La Libertad,Zona Arqueologica Monumental El Brujo,3,Marzo,2,0,0,0,0,0,198,57,37,292,0,0,0,0,0,17,10,3,30,322,Sitio Arqueológico
20240315,2021,13,La Libertad,Zona Arqueologica Monumental El Brujo,4,Abril,0,0,0,0,0,0,118,26,15,159,0,0,0,0,0,1,1,0,2,161,Sitio Arqueológico
20240315,2021,13,La Libertad,Zona Arqueologica Monumental El Brujo,4,Abril,1,0,0,0,0,0,4,0,0,4,0,0,0,0,0,0,0,0,0,4,Sitio Arqueológico
20240315,2021,13,La Libertad,Zona Arqueologica Monumental El Brujo,4,Abril,2,0,0,0,0,0,122,26,15,163,0,0,0,0,0,1,1,0,2,165,Sitio Arqueológico
20240315,2021,13,La Libertad,Zona Arqueologica Monumental El Brujo,5,Mayo,0,0,0,0,0,0,298,83,87,468,0,0,0,0,0,8,6,3,17,485,Sitio Arqueológico
20240315,2021,13,La Libertad,Zona Arqueologica Monumental El Brujo,5,Mayo,1,0,0,0,0,0,11,2,7,20,0,0,0,0,0,0,0,0,0,20,Sitio Arqueológico
20240315,2021,13,La Libertad,Zona Arqueologica Monumental El Brujo,5,Mayo,2,0,0,0,0,0,309,85,94,488,0,0,0,0,0,8,6,3,17,505,Sitio Arqueológico
20240315,2021,13,La Libertad,Zona Arqueologica Monumental El Brujo,6,Junio,0,0,0,0,0,0,368,113,74,555,0,0,0,0,0,15,11,5,31,586,Sitio Arqueológico
20240315,2021,13,La Libertad,Zona Arqueologica Monumental El Brujo,6,Junio,1,0,0,0,0,0,11,4,0,15,0,0,0,0,0,0,0,0,0,15,Sitio Arqueológico
20240315,2021,13,La Libertad,Zona Arqueologica Monumental El Brujo,6,Junio,2,0,0,0,0,0,379,117,74,570,0,0,0,0,0,15,11,5,31,601,Sitio Arqueológico
20240315,2021,13,La Libertad,Zona Arqueologica Monumental El Brujo,7,Julio,0,0,0,0,0,0,1423,458,401,2282,0,0,0,0,0,37,6,9,52,2334,Sitio Arqueológico
20240315,2021,13,La Libertad,Zona Arqueologica Monumental El Brujo,7,Julio,1,0,0,0,0,0,43,4,0,47,0,0,0,0,0,0,0,0,0,47,Sitio Arqueológico
20240315,2021,13,La Libertad,Zona Arqueologica Monumental El Brujo,7,Julio,2,0,0,0,0,0,1466,462,401,2329,0,0,0,0,0,37,6,9,52,2381,Sitio Arqueológico
20240315,2021,13,La Libertad,Zona Arqueologica Monumental El Brujo,8,Agosto,0,0,0,0,0,0,1423,620,475,2518,0,0,0,0,0,251,133,154,538,3056,Sitio Arqueológico
20240315,2021,13,La Libertad,Zona Arqueologica Monumental El Brujo,8,Agosto,1,0,0,0,0,0,62,9,4,75,0,0,0,0,0,0,0,0,0,75,Sitio Arqueológico
20240315,2021,13,La Libertad,Zona Arqueologica Monumental El Brujo,8,Agosto,2,0,0,0,0,0,1485,629,479,2593,0,0,0,0,0,251,133,154,538,3131,Sitio Arqueológico
20240315,2021,13,La Libertad,Zona Arqueologica Monumental El Brujo,9,Setiembre,0,0,0,0,0,0,798,300,179,1277,0,0,0,0,0,135,69,40,244,1521,Sitio Arqueológico
20240315,2021,13,La Libertad,Zona Arqueologica Monumental El Brujo,9,Setiembre,1,0,0,0,0,0,47,9,1,57,0,0,0,0,0,0,0,0,0,57,Sitio Arqueológico
20240315,2021,13,La Libertad,Zona Arqueologica Monumental El Brujo,9,Setiembre,2,0,0,0,0,0,845,309,180,1334,0,0,0,0,0,135,69,40,244,1578,Sitio Arqueológico
20240315,2021,13,La Libertad,Zona Arqueologica Monumental El Brujo,10,Octubre,0,0,0,0,0,0,1365,535,448,2348,0,0,0,0,0,159,106,76,341,2689,Sitio Arqueológico
20240315,2021,13,La Libertad,Zona Arqueologica Monumental El Brujo,10,Octubre,1,0,0,0,0,0,62,19,1,82,0,0,0,0,0,0,0,0,0,82,Sitio Arqueológico
20240315,2021,13,La Libertad,Zona Arqueologica Monumental El Brujo,10,Octubre,2,0,0,0,0,0,1427,554,449,2430,0,0,0,0,0,159,106,76,341,2771,Sitio Arqueológico
20240315,2021,13,La Libertad,Zona Arqueologica Monumental El Brujo,11,Noviembre,0,0,0,0,0,0,733,323,207,1263,0,0,0,0,0,83,51,27,161,1424,Sitio Arqueológico
20240315,2021,13,La Libertad,Zona Arqueologica Monumental El Brujo,11,Noviembre,1,0,0,0,0,0,109,25,6,140,0,0,0,0,0,0,0,0,0,140,Sitio Arqueológico
20240315,2021,13,La Libertad,Zona Arqueologica Monumental El Brujo,11,Noviembre,2,0,0,0,0,0,842,348,213,1403,0,0,0,0,0,83,51,27,161,1564,Sitio Arqueológico
20240315,2021,13,La Libertad,Zona Arqueologica Monumental El Brujo,12,Diciembre,0,0,0,0,0,0,652,344,181,1177,0,0,0,0,0,93,38,32,163,1340,Sitio Arqueológico
20240315,2021,13,La Libertad,Zona Arqueologica Monumental El Brujo,12,Diciembre,1,0,0,0,0,0,92,20,5,117,0,0,0,0,0,0,0,0,0,117,Sitio Arqueológico
20240315,2021,13,La Libertad,Zona Arqueologica Monumental El Brujo,12,Diciembre,2,0,0,0,0,0,744,364,186,1294,0,0,0,0,0,93,38,32,163,1457,Sitio Arqueológico
20240315,2021,13,La Libertad,Sitio Arqueologico Huaca Arco Iris (Huaca El Dragon),1,Enero,0,0,0,0,0,0,0,0,0,0,0,0,0,0,0,0,0,0,0,0,Sitio Arqueológico
20240315,2021,13,La Libertad,Sitio Arqueologico Huaca Arco Iris (Huaca El Dragon),1,Enero,1,0,0,0,0,0,0,0,0,0,0,0,0,0,0,0,0,0,0,0,Sitio Arqueológico
20240315,2021,13,La Libertad,Sitio Arqueologico Huaca Arco Iris (Huaca El Dragon),1,Enero,2,0,0,0,0,0,0,0,0,0,0,0,0,0,0,0,0,0,0,0,Sitio Arqueológico
20240315,2021,13,La Libertad,Sitio Arqueologico Huaca Arco Iris (Huaca El Dragon),2,Febrero,0,0,0,0,0,0,0,0,0,0,0,0,0,0,0,0,0,0,0,0,Sitio Arqueológico
20240315,2021,13,La Libertad,Sitio Arqueologico Huaca Arco Iris (Huaca El Dragon),2,Febrero,1,0,0,0,0,0,0,0,0,0,0,0,0,0,0,0,0,0,0,0,Sitio Arqueológico
20240315,2021,13,La Libertad,Sitio Arqueologico Huaca Arco Iris (Huaca El Dragon),2,Febrero,2,0,0,0,0,0,0,0,0,0,0,0,0,0,0,0,0,0,0,0,Sitio Arqueológico
20240315,2021,13,La Libertad,Sitio Arqueologico Huaca Arco Iris (Huaca El Dragon),3,Marzo,0,0,0,0,0,0,0,0,0,0,0,0,0,0,0,0,0,0,0,0,Sitio Arqueológico
20240315,2021,13,La Libertad,Sitio Arqueologico Huaca Arco Iris (Huaca El Dragon),3,Marzo,1,0,0,0,0,0,0,0,0,0,0,0,0,0,0,0,0,0,0,0,Sitio Arqueológico
20240315,2021,13,La Libertad,Sitio Arqueologico Huaca Arco Iris (Huaca El Dragon),3,Marzo,2,0,0,0,0,0,0,0,0,0,0,0,0,0,0,0,0,0,0,0,Sitio Arqueológico
20240315,2021,13,La Libertad,Sitio Arqueologico Huaca Arco Iris (Huaca El Dragon),4,Abril,0,0,0,0,0,0,0,0,0,0,0,0,0,0,0,0,0,0,0,0,Sitio Arqueológico
20240315,2021,13,La Libertad,Sitio Arqueologico Huaca Arco Iris (Huaca El Dragon),4,Abril,1,0,0,0,0,0,0,0,0,0,0,0,0,0,0,0,0,0,0,0,Sitio Arqueológico
20240315,2021,13,La Libertad,Sitio Arqueologico Huaca Arco Iris (Huaca El Dragon),4,Abril,2,0,0,0,0,0,0,0,0,0,0,0,0,0,0,0,0,0,0,0,Sitio Arqueológico
20240315,2021,13,La Libertad,Sitio Arqueologico Huaca Arco Iris (Huaca El Dragon),5,Mayo,0,0,0,0,0,0,0,0,0,0,0,0,0,0,0,0,0,0,0,0,Sitio Arqueológico
20240315,2021,13,La Libertad,Sitio Arqueologico Huaca Arco Iris (Huaca El Dragon),5,Mayo,1,0,0,0,0,0,0,0,0,0,0,0,0,0,0,0,0,0,0,0,Sitio Arqueológico
20240315,2021,13,La Libertad,Sitio Arqueologico Huaca Arco Iris (Huaca El Dragon),5,Mayo,2,0,0,0,0,0,0,0,0,0,0,0,0,0,0,0,0,0,0,0,Sitio Arqueológico
20240315,2021,13,La Libertad,Sitio Arqueologico Huaca Arco Iris (Huaca El Dragon),6,Junio,0,0,0,0,0,0,0,0,0,0,0,0,0,0,0,0,0,0,0,0,Sitio Arqueológico
20240315,2021,13,La Libertad,Sitio Arqueologico Huaca Arco Iris (Huaca El Dragon),6,Junio,1,0,0,0,0,0,0,0,0,0,0,0,0,0,0,0,0,0,0,0,Sitio Arqueológico
20240315,2021,13,La Libertad,Sitio Arqueologico Huaca Arco Iris (Huaca El Dragon),6,Junio,2,0,0,0,0,0,0,0,0,0,0,0,0,0,0,0,0,0,0,0,Sitio Arqueológico
20240315,2021,13,La Libertad,Sitio Arqueologico Huaca Arco Iris (Huaca El Dragon),7,Julio,0,0,0,0,0,0,0,0,0,0,0,0,0,0,0,0,0,0,0,0,Sitio Arqueológico
20240315,2021,13,La Libertad,Sitio Arqueologico Huaca Arco Iris (Huaca El Dragon),7,Julio,1,0,0,0,0,0,0,0,0,0,0,0,0,0,0,0,0,0,0,0,Sitio Arqueológico
20240315,2021,13,La Libertad,Sitio Arqueologico Huaca Arco Iris (Huaca El Dragon),7,Julio,2,0,0,0,0,0,0,0,0,0,0,0,0,0,0,0,0,0,0,0,Sitio Arqueológico
20240315,2021,13,La Libertad,Sitio Arqueologico Huaca Arco Iris (Huaca El Dragon),8,Agosto,0,0,0,0,0,0,0,0,0,0,0,0,0,0,0,0,0,0,0,0,Sitio Arqueológico
20240315,2021,13,La Libertad,Sitio Arqueologico Huaca Arco Iris (Huaca El Dragon),8,Agosto,1,0,0,0,0,0,0,0,0,0,0,0,0,0,0,0,0,0,0,0,Sitio Arqueológico
20240315,2021,13,La Libertad,Sitio Arqueologico Huaca Arco Iris (Huaca El Dragon),8,Agosto,2,0,0,0,0,0,0,0,0,0,0,0,0,0,0,0,0,0,0,0,Sitio Arqueológico
20240315,2021,13,La Libertad,Sitio Arqueologico Huaca Arco Iris (Huaca El Dragon),9,Setiembre,0,0,0,0,0,0,0,0,0,0,0,0,0,0,0,0,0,0,0,0,Sitio Arqueológico
20240315,2021,13,La Libertad,Sitio Arqueologico Huaca Arco Iris (Huaca El Dragon),9,Setiembre,1,0,0,0,0,0,0,0,0,0,0,0,0,0,0,0,0,0,0,0,Sitio Arqueológico
20240315,2021,13,La Libertad,Sitio Arqueologico Huaca Arco Iris (Huaca El Dragon),9,Setiembre,2,0,0,0,0,0,0,0,0,0,0,0,0,0,0,0,0,0,0,0,Sitio Arqueológico
20240315,2021,13,La Libertad,Sitio Arqueologico Huaca Arco Iris (Huaca El Dragon),10,Octubre,0,0,0,0,0,0,0,0,0,0,0,0,0,0,0,0,0,0,0,0,Sitio Arqueológico
20240315,2021,13,La Libertad,Sitio Arqueologico Huaca Arco Iris (Huaca El Dragon),10,Octubre,1,0,0,0,0,0,0,0,0,0,0,0,0,0,0,0,0,0,0,0,Sitio Arqueológico
20240315,2021,13,La Libertad,Sitio Arqueologico Huaca Arco Iris (Huaca El Dragon),10,Octubre,2,0,0,0,0,0,0,0,0,0,0,0,0,0,0,0,0,0,0,0,Sitio Arqueológico
20240315,2021,13,La Libertad,Sitio Arqueologico Huaca Arco Iris (Huaca El Dragon),11,Noviembre,0,0,0,0,0,0,0,0,0,0,0,0,0,0,0,0,0,0,0,0,Sitio Arqueológico
20240315,2021,13,La Libertad,Sitio Arqueologico Huaca Arco Iris (Huaca El Dragon),11,Noviembre,1,0,0,0,0,0,0,0,0,0,0,0,0,0,0,0,0,0,0,0,Sitio Arqueológico
20240315,2021,13,La Libertad,Sitio Arqueologico Huaca Arco Iris (Huaca El Dragon),11,Noviembre,2,0,0,0,0,0,0,0,0,0,0,0,0,0,0,0,0,0,0,0,Sitio Arqueológico
20240315,2021,13,La Libertad,Sitio Arqueologico Huaca Arco Iris (Huaca El Dragon),12,Diciembre,0,0,0,0,0,0,0,0,0,0,0,0,0,0,0,0,0,0,0,0,Sitio Arqueológico
20240315,2021,13,La Libertad,Sitio Arqueologico Huaca Arco Iris (Huaca El Dragon),12,Diciembre,1,0,0,0,0,0,0,0,0,0,0,0,0,0,0,0,0,0,0,0,Sitio Arqueológico
20240315,2021,13,La Libertad,Sitio Arqueologico Huaca Arco Iris (Huaca El Dragon),12,Diciembre,2,0,0,0,0,0,0,0,0,0,0,0,0,0,0,0,0,0,0,0,Sitio Arqueológico
20240315,2021,14,Lambayeque,Sitio Arqueologico Cerro Ventarron,1,Enero,0,0,0,0,0,0,12,0,0,12,0,0,0,0,0,0,0,0,0,12,Sitio Arqueológico
20240315,2021,14,Lambayeque,Sitio Arqueologico Cerro Ventarron,1,Enero,1,0,0,0,0,0,0,0,0,0,0,0,0,0,0,0,0,0,0,0,Sitio Arqueológico
20240315,2021,14,Lambayeque,Sitio Arqueologico Cerro Ventarron,1,Enero,2,0,0,0,0,0,12,0,0,12,0,0,0,0,0,0,0,0,0,12,Sitio Arqueológico
20240315,2021,14,Lambayeque,Sitio Arqueologico Cerro Ventarron,2,Febrero,0,0,0,0,0,0,5,0,1,6,0,0,0,0,0,0,0,0,0,6,Sitio Arqueológico
20240315,2021,14,Lambayeque,Sitio Arqueologico Cerro Ventarron,2,Febrero,1,0,0,0,0,0,0,0,0,0,0,0,0,0,0,0,0,0,0,0,Sitio Arqueológico
20240315,2021,14,Lambayeque,Sitio Arqueologico Cerro Ventarron,2,Febrero,2,0,0,0,0,0,5,0,1,6,0,0,0,0,0,0,0,0,0,6,Sitio Arqueológico
20240315,2021,14,Lambayeque,Sitio Arqueologico Cerro Ventarron,3,Marzo,0,0,0,0,0,0,4,0,3,7,0,0,0,0,0,0,0,0,0,7,Sitio Arqueológico
20240315,2021,14,Lambayeque,Sitio Arqueologico Cerro Ventarron,3,Marzo,1,0,0,0,0,0,0,0,0,0,0,0,0,0,0,0,0,0,0,0,Sitio Arqueológico
20240315,2021,14,Lambayeque,Sitio Arqueologico Cerro Ventarron,3,Marzo,2,0,0,0,0,0,4,0,3,7,0,0,0,0,0,0,0,0,0,7,Sitio Arqueológico
20240315,2021,14,Lambayeque,Sitio Arqueologico Cerro Ventarron,4,Abril,0,0,0,0,0,0,0,0,0,0,0,0,0,0,0,0,0,0,0,0,Sitio Arqueológico
20240315,2021,14,Lambayeque,Sitio Arqueologico Cerro Ventarron,4,Abril,1,0,0,0,0,0,0,0,0,0,0,0,0,0,0,0,0,0,0,0,Sitio Arqueológico
20240315,2021,14,Lambayeque,Sitio Arqueologico Cerro Ventarron,4,Abril,2,0,0,0,0,0,0,0,0,0,0,0,0,0,0,0,0,0,0,0,Sitio Arqueológico
20240315,2021,14,Lambayeque,Sitio Arqueologico Cerro Ventarron,5,Mayo,0,0,0,0,0,0,0,0,0,0,0,0,0,0,0,0,0,0,0,0,Sitio Arqueológico
20240315,2021,14,Lambayeque,Sitio Arqueologico Cerro Ventarron,5,Mayo,1,0,0,0,0,0,0,0,0,0,0,0,0,0,0,0,0,0,0,0,Sitio Arqueológico
20240315,2021,14,Lambayeque,Sitio Arqueologico Cerro Ventarron,5,Mayo,2,0,0,0,0,0,0,0,0,0,0,0,0,0,0,0,0,0,0,0,Sitio Arqueológico
20240315,2021,14,Lambayeque,Sitio Arqueologico Cerro Ventarron,6,Junio,0,0,0,0,0,0,0,0,0,0,0,0,0,0,0,0,0,0,0,0,Sitio Arqueológico
20240315,2021,14,Lambayeque,Sitio Arqueologico Cerro Ventarron,6,Junio,1,0,0,0,0,0,0,0,0,0,0,0,0,0,0,0,0,0,0,0,Sitio Arqueológico
20240315,2021,14,Lambayeque,Sitio Arqueologico Cerro Ventarron,6,Junio,2,0,0,0,0,0,0,0,0,0,0,0,0,0,0,0,0,0,0,0,Sitio Arqueológico
20240315,2021,14,Lambayeque,Sitio Arqueologico Cerro Ventarron,7,Julio,0,0,0,0,0,0,33,0,8,41,0,0,0,0,0,0,0,0,0,41,Sitio Arqueológico
20240315,2021,14,Lambayeque,Sitio Arqueologico Cerro Ventarron,7,Julio,1,0,0,0,0,0,0,0,0,0,0,0,0,0,0,0,0,0,0,0,Sitio Arqueológico
20240315,2021,14,Lambayeque,Sitio Arqueologico Cerro Ventarron,7,Julio,2,0,0,0,0,0,33,0,8,41,0,0,0,0,0,0,0,0,0,41,Sitio Arqueológico
20240315,2021,14,Lambayeque,Sitio Arqueologico Cerro Ventarron,8,Agosto,0,0,0,0,0,0,0,0,0,0,0,0,0,0,0,0,0,0,0,0,Sitio Arqueológico
20240315,2021,14,Lambayeque,Sitio Arqueologico Cerro Ventarron,8,Agosto,1,0,0,0,0,0,0,0,0,0,0,0,0,0,0,0,0,0,0,0,Sitio Arqueológico
20240315,2021,14,Lambayeque,Sitio Arqueologico Cerro Ventarron,8,Agosto,2,0,0,0,0,0,0,0,0,0,0,0,0,0,0,0,0,0,0,0,Sitio Arqueológico
20240315,2021,14,Lambayeque,Sitio Arqueologico Cerro Ventarron,9,Setiembre,0,0,0,0,0,0,0,0,0,0,0,0,0,0,0,0,0,0,0,0,Sitio Arqueológico
20240315,2021,14,Lambayeque,Sitio Arqueologico Cerro Ventarron,9,Setiembre,1,0,0,0,0,0,0,0,0,0,0,0,0,0,0,0,0,0,0,0,Sitio Arqueológico
20240315,2021,14,Lambayeque,Sitio Arqueologico Cerro Ventarron,9,Setiembre,2,0,0,0,0,0,0,0,0,0,0,0,0,0,0,0,0,0,0,0,Sitio Arqueológico
20240315,2021,14,Lambayeque,Sitio Arqueologico Cerro Ventarron,10,Octubre,0,0,0,0,0,0,46,3,12,61,0,0,0,0,0,0,0,0,0,61,Sitio Arqueológico
20240315,2021,14,Lambayeque,Sitio Arqueologico Cerro Ventarron,10,Octubre,1,0,0,0,0,0,9,0,0,9,0,0,0,0,0,0,0,0,0,9,Sitio Arqueológico
20240315,2021,14,Lambayeque,Sitio Arqueologico Cerro Ventarron,10,Octubre,2,0,0,0,0,0,55,3,12,70,0,0,0,0,0,0,0,0,0,70,Sitio Arqueológico
20240315,2021,14,Lambayeque,Sitio Arqueologico Cerro Ventarron,11,Noviembre,0,0,0,0,0,0,7,3,2,12,0,0,0,0,0,0,0,0,0,12,Sitio Arqueológico
20240315,2021,14,Lambayeque,Sitio Arqueologico Cerro Ventarron,11,Noviembre,1,0,0,0,0,0,0,0,0,0,0,0,0,0,0,0,0,0,0,0,Sitio Arqueológico
20240315,2021,14,Lambayeque,Sitio Arqueologico Cerro Ventarron,11,Noviembre,2,0,0,0,0,0,7,3,2,12,0,0,0,0,0,0,0,0,0,12,Sitio Arqueológico
20240315,2021,14,Lambayeque,Sitio Arqueologico Cerro Ventarron,12,Diciembre,0,0,0,0,0,0,11,0,2,13,0,0,0,0,0,0,0,0,0,13,Sitio Arqueológico
20240315,2021,14,Lambayeque,Sitio Arqueologico Cerro Ventarron,12,Diciembre,1,0,0,0,0,0,4,0,0,4,0,0,0,0,0,0,0,0,0,4,Sitio Arqueológico
20240315,2021,14,Lambayeque,Sitio Arqueologico Cerro Ventarron,12,Diciembre,2,0,0,0,0,0,15,0,2,17,0,0,0,0,0,0,0,0,0,17,Sitio Arqueológico
20240315,2021,15,Lima,Sitio Arqueologico Caral,1,Enero,0,0,0,0,0,0,672,123,294,1089,0,0,0,0,0,347,0,0,347,1436,Sitio Arqueológico
20240315,2021,15,Lima,Sitio Arqueologico Caral,1,Enero,1,0,0,0,0,0,11,0,0,11,0,0,0,0,0,0,0,0,0,11,Sitio Arqueológico
20240315,2021,15,Lima,Sitio Arqueologico Caral,1,Enero,2,0,0,0,0,0,683,123,294,1100,0,0,0,0,0,347,0,0,347,1447,Sitio Arqueológico
20240315,2021,15,Lima,Sitio Arqueologico Caral,2,Febrero,0,0,0,0,0,0,0,0,0,0,0,0,0,0,0,0,0,0,0,0,Sitio Arqueológico
20240315,2021,15,Lima,Sitio Arqueologico Caral,2,Febrero,1,0,0,0,0,0,0,0,0,0,0,0,0,0,0,0,0,0,0,0,Sitio Arqueológico
20240315,2021,15,Lima,Sitio Arqueologico Caral,2,Febrero,2,0,0,0,0,0,0,0,0,0,0,0,0,0,0,0,0,0,0,0,Sitio Arqueológico
20240315,2021,15,Lima,Sitio Arqueologico Caral,3,Marzo,0,0,0,0,0,0,166,50,55,271,0,0,0,0,0,0,0,0,0,271,Sitio Arqueológico
20240315,2021,15,Lima,Sitio Arqueologico Caral,3,Marzo,1,0,0,0,0,0,18,0,1,19,0,0,0,0,0,11,0,0,11,30,Sitio Arqueológico
20240315,2021,15,Lima,Sitio Arqueologico Caral,3,Marzo,2,0,0,0,0,0,184,50,56,290,0,0,0,0,0,11,0,0,11,301,Sitio Arqueológico
20240315,2021,15,Lima,Sitio Arqueologico Caral,4,Abril,0,0,0,0,0,0,151,41,35,227,0,0,0,0,0,1,0,0,1,228,Sitio Arqueológico
20240315,2021,15,Lima,Sitio Arqueologico Caral,4,Abril,1,0,0,0,0,0,11,2,0,13,0,0,0,0,0,0,0,0,0,13,Sitio Arqueológico
20240315,2021,15,Lima,Sitio Arqueologico Caral,4,Abril,2,0,0,0,0,0,162,43,35,240,0,0,0,0,0,1,0,0,1,241,Sitio Arqueológico
20240315,2021,15,Lima,Sitio Arqueologico Caral,5,Mayo,0,0,0,0,0,0,487,118,292,897,0,0,0,0,0,2,0,0,2,899,Sitio Arqueológico
20240315,2021,15,Lima,Sitio Arqueologico Caral,5,Mayo,1,0,0,0,0,0,19,0,0,19,0,0,0,0,0,32,0,0,32,51,Sitio Arqueológico
20240315,2021,15,Lima,Sitio Arqueologico Caral,5,Mayo,2,0,0,0,0,0,506,118,292,916,0,0,0,0,0,34,0,0,34,950,Sitio Arqueológico
20240315,2021,15,Lima,Sitio Arqueologico Caral,6,Junio,0,0,0,0,0,0,512,108,228,848,0,0,0,0,0,91,0,0,91,939,Sitio Arqueológico
20240315,2021,15,Lima,Sitio Arqueologico Caral,6,Junio,1,0,0,0,0,0,11,0,0,11,0,0,0,0,0,0,0,0,0,11,Sitio Arqueológico
20240315,2021,15,Lima,Sitio Arqueologico Caral,6,Junio,2,0,0,0,0,0,523,108,228,859,0,0,0,0,0,91,0,0,91,950,Sitio Arqueológico
20240315,2021,15,Lima,Sitio Arqueologico Caral,7,Julio,0,0,0,0,0,0,2636,537,1547,4720,0,0,0,0,0,1572,0,0,1572,6292,Sitio Arqueológico
20240315,2021,15,Lima,Sitio Arqueologico Caral,7,Julio,1,0,0,0,0,0,91,0,0,91,0,0,0,0,0,0,0,0,0,91,Sitio Arqueológico
20240315,2021,15,Lima,Sitio Arqueologico Caral,7,Julio,2,0,0,0,0,0,2727,537,1547,4811,0,0,0,0,0,1572,0,0,1572,6383,Sitio Arqueológico
20240315,2021,15,Lima,Sitio Arqueologico Caral,8,Agosto,0,0,0,0,0,0,2462,533,1374,4369,0,0,0,0,0,408,0,0,408,4777,Sitio Arqueológico
20240315,2021,15,Lima,Sitio Arqueologico Caral,8,Agosto,1,0,0,0,0,0,25,7,2,34,0,0,0,0,0,27,0,0,27,61,Sitio Arqueológico
20240315,2021,15,Lima,Sitio Arqueologico Caral,8,Agosto,2,0,0,0,0,0,2487,540,1376,4403,0,0,0,0,0,435,0,0,435,4838,Sitio Arqueológico
20240315,2021,15,Lima,Sitio Arqueologico Caral,9,Setiembre,0,0,0,0,0,0,1030,169,481,1680,0,0,0,0,0,473,0,0,473,2153,Sitio Arqueológico
20240315,2021,15,Lima,Sitio Arqueologico Caral,9,Setiembre,1,0,0,0,0,0,25,2,0,27,0,0,0,0,0,0,0,0,0,27,Sitio Arqueológico
20240315,2021,15,Lima,Sitio Arqueologico Caral,9,Setiembre,2,0,0,0,0,0,1055,171,481,1707,0,0,0,0,0,473,0,0,473,2180,Sitio Arqueológico
20240315,2021,15,Lima,Sitio Arqueologico Caral,10,Octubre,0,0,0,0,0,0,1911,417,1274,3602,0,0,0,0,0,322,0,0,322,3924,Sitio Arqueológico
20240315,2021,15,Lima,Sitio Arqueologico Caral,10,Octubre,1,0,0,0,0,0,64,5,7,76,0,0,0,0,0,0,0,0,0,76,Sitio Arqueológico
20240315,2021,15,Lima,Sitio Arqueologico Caral,10,Octubre,2,0,0,0,0,0,1975,422,1281,3678,0,0,0,0,0,322,0,0,322,4000,Sitio Arqueológico
20240315,2021,15,Lima,Sitio Arqueologico Caral,11,Noviembre,0,0,0,0,0,0,1213,209,462,1884,0,0,0,0,0,291,0,0,291,2175,Sitio Arqueológico
20240315,2021,15,Lima,Sitio Arqueologico Caral,11,Noviembre,1,0,0,0,0,0,63,4,8,75,0,0,0,0,0,0,0,0,0,75,Sitio Arqueológico
20240315,2021,15,Lima,Sitio Arqueologico Caral,11,Noviembre,2,0,0,0,0,0,1276,213,470,1959,0,0,0,0,0,291,0,0,291,2250,Sitio Arqueológico
20240315,2021,15,Lima,Sitio Arqueologico Caral,12,Diciembre,0,0,0,0,0,0,860,224,420,1504,0,0,0,0,0,184,0,0,184,1688,Sitio Arqueológico
20240315,2021,15,Lima,Sitio Arqueologico Caral,12,Diciembre,1,0,0,0,0,0,59,0,1,60,0,0,0,0,0,0,0,0,0,60,Sitio Arqueológico
20240315,2021,15,Lima,Sitio Arqueologico Caral,12,Diciembre,2,0,0,0,0,0,919,224,421,1564,0,0,0,0,0,184,0,0,184,1748,Sitio Arqueológico
20240315,2021,15,Lima,Zona Arqueologica de Huaycan de Cieneguilla,1,Enero,0,0,0,0,0,44,852,113,84,1093,56,0,0,0,19,0,0,13,88,1181,Sitio Arqueológico
20240315,2021,15,Lima,Zona Arqueologica de Huaycan de Cieneguilla,1,Enero,1,0,0,0,0,0,0,0,0,0,0,0,0,0,0,0,0,0,0,0,Sitio Arqueológico
20240315,2021,15,Lima,Zona Arqueologica de Huaycan de Cieneguilla,1,Enero,2,0,0,0,0,44,852,113,84,1093,56,0,0,0,19,0,0,13,88,1181,Sitio Arqueológico
20240315,2021,15,Lima,Zona Arqueologica de Huaycan de Cieneguilla,2,Febrero,0,0,0,0,0,0,0,0,0,0,0,0,0,0,0,0,0,0,0,0,Sitio Arqueológico
20240315,2021,15,Lima,Zona Arqueologica de Huaycan de Cieneguilla,2,Febrero,1,0,0,0,0,0,0,0,0,0,0,0,0,0,0,0,0,0,0,0,Sitio Arqueológico
20240315,2021,15,Lima,Zona Arqueologica de Huaycan de Cieneguilla,2,Febrero,2,0,0,0,0,0,0,0,0,0,0,0,0,0,0,0,0,0,0,0,Sitio Arqueológico
20240315,2021,15,Lima,Zona Arqueologica de Huaycan de Cieneguilla,3,Marzo,0,0,0,0,0,0,0,0,0,0,0,0,0,0,0,0,0,0,0,0,Sitio Arqueológico
20240315,2021,15,Lima,Zona Arqueologica de Huaycan de Cieneguilla,3,Marzo,1,0,0,0,0,0,0,0,0,0,0,0,0,0,0,0,0,0,0,0,Sitio Arqueológico
20240315,2021,15,Lima,Zona Arqueologica de Huaycan de Cieneguilla,3,Marzo,2,0,0,0,0,0,0,0,0,0,0,0,0,0,0,0,0,0,0,0,Sitio Arqueológico
20240315,2021,15,Lima,Zona Arqueologica de Huaycan de Cieneguilla,4,Abril,0,0,0,0,0,0,0,0,0,0,0,0,0,0,0,0,0,0,0,0,Sitio Arqueológico
20240315,2021,15,Lima,Zona Arqueologica de Huaycan de Cieneguilla,4,Abril,1,0,0,0,0,0,0,0,0,0,0,0,0,0,0,0,0,0,0,0,Sitio Arqueológico
20240315,2021,15,Lima,Zona Arqueologica de Huaycan de Cieneguilla,4,Abril,2,0,0,0,0,0,0,0,0,0,0,0,0,0,0,0,0,0,0,0,Sitio Arqueológico
20240315,2021,15,Lima,Zona Arqueologica de Huaycan de Cieneguilla,5,Mayo,0,0,0,0,0,0,0,0,0,0,0,0,0,0,0,0,0,0,0,0,Sitio Arqueológico
20240315,2021,15,Lima,Zona Arqueologica de Huaycan de Cieneguilla,5,Mayo,1,0,0,0,0,0,0,0,0,0,0,0,0,0,0,0,0,0,0,0,Sitio Arqueológico
20240315,2021,15,Lima,Zona Arqueologica de Huaycan de Cieneguilla,5,Mayo,2,0,0,0,0,0,0,0,0,0,0,0,0,0,0,0,0,0,0,0,Sitio Arqueológico
20240315,2021,15,Lima,Zona Arqueologica de Huaycan de Cieneguilla,6,Junio,0,0,0,0,0,0,0,0,0,0,0,0,0,0,0,0,0,0,0,0,Sitio Arqueológico
20240315,2021,15,Lima,Zona Arqueologica de Huaycan de Cieneguilla,6,Junio,1,0,0,0,0,0,0,0,0,0,0,0,0,0,0,0,0,0,0,0,Sitio Arqueológico
20240315,2021,15,Lima,Zona Arqueologica de Huaycan de Cieneguilla,6,Junio,2,0,0,0,0,0,0,0,0,0,0,0,0,0,0,0,0,0,0,0,Sitio Arqueológico
20240315,2021,15,Lima,Zona Arqueologica de Huaycan de Cieneguilla,7,Julio,0,0,0,0,0,0,0,0,0,0,0,0,0,0,0,0,0,0,0,0,Sitio Arqueológico
20240315,2021,15,Lima,Zona Arqueologica de Huaycan de Cieneguilla,7,Julio,1,0,0,0,0,0,0,0,0,0,0,0,0,0,0,0,0,0,0,0,Sitio Arqueológico
20240315,2021,15,Lima,Zona Arqueologica de Huaycan de Cieneguilla,7,Julio,2,0,0,0,0,0,0,0,0,0,0,0,0,0,0,0,0,0,0,0,Sitio Arqueológico
20240315,2021,15,Lima,Zona Arqueologica de Huaycan de Cieneguilla,8,Agosto,0,0,0,0,0,0,0,0,0,0,0,0,0,0,0,0,0,0,0,0,Sitio Arqueológico
20240315,2021,15,Lima,Zona Arqueologica de Huaycan de Cieneguilla,8,Agosto,1,0,0,0,0,0,0,0,0,0,0,0,0,0,0,0,0,0,0,0,Sitio Arqueológico
20240315,2021,15,Lima,Zona Arqueologica de Huaycan de Cieneguilla,8,Agosto,2,0,0,0,0,0,0,0,0,0,0,0,0,0,0,0,0,0,0,0,Sitio Arqueológico
20240315,2021,15,Lima,Zona Arqueologica de Huaycan de Cieneguilla,9,Setiembre,0,0,0,0,0,0,0,0,0,0,0,0,0,0,0,0,0,0,0,0,Sitio Arqueológico
20240315,2021,15,Lima,Zona Arqueologica de Huaycan de Cieneguilla,9,Setiembre,1,0,0,0,0,0,0,0,0,0,0,0,0,0,0,0,0,0,0,0,Sitio Arqueológico
20240315,2021,15,Lima,Zona Arqueologica de Huaycan de Cieneguilla,9,Setiembre,2,0,0,0,0,0,0,0,0,0,0,0,0,0,0,0,0,0,0,0,Sitio Arqueológico
20240315,2021,15,Lima,Zona Arqueologica de Huaycan de Cieneguilla,10,Octubre,0,0,0,0,0,0,0,0,0,0,0,0,0,0,0,0,0,0,0,0,Sitio Arqueológico
20240315,2021,15,Lima,Zona Arqueologica de Huaycan de Cieneguilla,10,Octubre,1,0,0,0,0,0,0,0,0,0,0,0,0,0,0,0,0,0,0,0,Sitio Arqueológico
20240315,2021,15,Lima,Zona Arqueologica de Huaycan de Cieneguilla,10,Octubre,2,0,0,0,0,0,0,0,0,0,0,0,0,0,0,0,0,0,0,0,Sitio Arqueológico
20240315,2021,15,Lima,Zona Arqueologica de Huaycan de Cieneguilla,11,Noviembre,0,0,0,0,0,0,0,0,0,0,0,0,0,0,0,0,0,0,0,0,Sitio Arqueológico
20240315,2021,15,Lima,Zona Arqueologica de Huaycan de Cieneguilla,11,Noviembre,1,0,0,0,0,0,0,0,0,0,0,0,0,0,0,0,0,0,0,0,Sitio Arqueológico
20240315,2021,15,Lima,Zona Arqueologica de Huaycan de Cieneguilla,11,Noviembre,2,0,0,0,0,0,0,0,0,0,0,0,0,0,0,0,0,0,0,0,Sitio Arqueológico
20240315,2021,15,Lima,Zona Arqueologica de Huaycan de Cieneguilla,12,Diciembre,0,0,0,0,0,0,0,0,0,0,0,0,0,0,0,0,0,0,0,0,Sitio Arqueológico
20240315,2021,15,Lima,Zona Arqueologica de Huaycan de Cieneguilla,12,Diciembre,1,0,0,0,0,0,0,0,0,0,0,0,0,0,0,0,0,0,0,0,Sitio Arqueológico
20240315,2021,15,Lima,Zona Arqueologica de Huaycan de Cieneguilla,12,Diciembre,2,0,0,0,0,0,0,0,0,0,0,0,0,0,0,0,0,0,0,0,Sitio Arqueológico
20240315,2021,15,Lima,Complejo Arqueologico Mateo Salado,1,Enero,0,0,0,0,0,8,31,15,12,66,0,0,0,0,0,8,0,3,11,77,Sitio Arqueológico
20240315,2021,15,Lima,Complejo Arqueologico Mateo Salado,1,Enero,1,0,0,0,0,0,7,0,0,7,0,0,0,0,0,0,0,0,0,7,Sitio Arqueológico
20240315,2021,15,Lima,Complejo Arqueologico Mateo Salado,1,Enero,2,0,0,0,0,8,38,15,12,73,0,0,0,0,0,8,0,3,11,84,Sitio Arqueológico
20240315,2021,15,Lima,Complejo Arqueologico Mateo Salado,2,Febrero,0,0,0,0,0,0,0,0,0,0,0,0,0,0,0,0,0,0,0,0,Sitio Arqueológico
20240315,2021,15,Lima,Complejo Arqueologico Mateo Salado,2,Febrero,1,0,0,0,0,0,0,0,0,0,0,0,0,0,0,0,0,0,0,0,Sitio Arqueológico
20240315,2021,15,Lima,Complejo Arqueologico Mateo Salado,2,Febrero,2,0,0,0,0,0,0,0,0,0,0,0,0,0,0,0,0,0,0,0,Sitio Arqueológico
20240315,2021,15,Lima,Complejo Arqueologico Mateo Salado,3,Marzo,0,0,0,0,0,0,0,0,0,0,0,0,0,0,0,0,0,0,0,0,Sitio Arqueológico
20240315,2021,15,Lima,Complejo Arqueologico Mateo Salado,3,Marzo,1,0,0,0,0,0,0,0,0,0,0,0,0,0,0,0,0,0,0,0,Sitio Arqueológico
20240315,2021,15,Lima,Complejo Arqueologico Mateo Salado,3,Marzo,2,0,0,0,0,0,0,0,0,0,0,0,0,0,0,0,0,0,0,0,Sitio Arqueológico
20240315,2021,15,Lima,Complejo Arqueologico Mateo Salado,4,Abril,0,0,0,0,0,1,29,6,6,42,0,0,0,0,0,2,0,0,2,44,Sitio Arqueológico
20240315,2021,15,Lima,Complejo Arqueologico Mateo Salado,4,Abril,1,0,0,0,0,0,1,0,0,1,0,0,0,0,0,0,0,0,0,1,Sitio Arqueológico
20240315,2021,15,Lima,Complejo Arqueologico Mateo Salado,4,Abril,2,0,0,0,0,1,30,6,6,43,0,0,0,0,0,2,0,0,2,45,Sitio Arqueológico
20240315,2021,15,Lima,Complejo Arqueologico Mateo Salado,5,Mayo,0,1,0,0,0,2,30,0,11,44,0,0,0,0,0,48,0,14,62,106,Sitio Arqueológico
20240315,2021,15,Lima,Complejo Arqueologico Mateo Salado,5,Mayo,1,0,0,0,0,1,2,0,0,3,0,0,0,0,0,1,0,0,1,4,Sitio Arqueológico
20240315,2021,15,Lima,Complejo Arqueologico Mateo Salado,5,Mayo,2,1,0,0,0,3,32,0,11,47,0,0,0,0,0,49,0,14,63,110,Sitio Arqueológico
20240315,2021,15,Lima,Complejo Arqueologico Mateo Salado,6,Junio,0,0,0,0,0,9,34,6,8,57,0,0,0,0,0,2,0,0,2,59,Sitio Arqueológico
20240315,2021,15,Lima,Complejo Arqueologico Mateo Salado,6,Junio,1,0,0,0,0,0,2,0,0,2,0,0,0,0,0,0,0,0,0,2,Sitio Arqueológico
20240315,2021,15,Lima,Complejo Arqueologico Mateo Salado,6,Junio,2,0,0,0,0,9,36,6,8,59,0,0,0,0,0,2,0,0,2,61,Sitio Arqueológico
20240315,2021,15,Lima,Complejo Arqueologico Mateo Salado,7,Julio,0,0,0,0,0,4,73,9,28,114,0,0,0,0,0,0,0,0,0,114,Sitio Arqueológico
20240315,2021,15,Lima,Complejo Arqueologico Mateo Salado,7,Julio,1,0,0,0,0,0,2,0,0,2,0,0,0,0,0,0,0,0,0,2,Sitio Arqueológico
20240315,2021,15,Lima,Complejo Arqueologico Mateo Salado,7,Julio,2,0,0,0,0,4,75,9,28,116,0,0,0,0,0,0,0,0,0,116,Sitio Arqueológico
20240315,2021,15,Lima,Complejo Arqueologico Mateo Salado,8,Agosto,0,0,0,0,0,8,91,15,38,152,0,0,0,0,0,0,0,0,0,152,Sitio Arqueológico
20240315,2021,15,Lima,Complejo Arqueologico Mateo Salado,8,Agosto,1,0,0,0,0,0,33,0,0,33,0,0,0,0,0,0,0,0,0,33,Sitio Arqueológico
20240315,2021,15,Lima,Complejo Arqueologico Mateo Salado,8,Agosto,2,0,0,0,0,8,124,15,38,185,0,0,0,0,0,0,0,0,0,185,Sitio Arqueológico
20240315,2021,15,Lima,Complejo Arqueologico Mateo Salado,9,Setiembre,0,0,0,0,0,6,68,18,27,119,0,0,0,0,0,0,0,0,0,119,Sitio Arqueológico
20240315,2021,15,Lima,Complejo Arqueologico Mateo Salado,9,Setiembre,1,0,0,0,0,1,21,0,0,22,0,0,0,0,0,0,0,0,0,22,Sitio Arqueológico
20240315,2021,15,Lima,Complejo Arqueologico Mateo Salado,9,Setiembre,2,0,0,0,0,7,89,18,27,141,0,0,0,0,0,0,0,0,0,141,Sitio Arqueológico
20240315,2021,15,Lima,Complejo Arqueologico Mateo Salado,10,Octubre,0,1,0,0,0,5,73,39,37,155,0,0,0,0,15,30,4,13,62,217,Sitio Arqueológico
20240315,2021,15,Lima,Complejo Arqueologico Mateo Salado,10,Octubre,1,0,0,0,0,2,12,0,0,14,0,0,0,0,0,0,0,0,0,14,Sitio Arqueológico
20240315,2021,15,Lima,Complejo Arqueologico Mateo Salado,10,Octubre,2,1,0,0,0,7,85,39,37,169,0,0,0,0,15,30,4,13,62,231,Sitio Arqueológico
20240315,2021,15,Lima,Complejo Arqueologico Mateo Salado,11,Noviembre,0,0,0,0,0,1,24,2,9,36,0,0,0,0,0,7,0,4,11,47,Sitio Arqueológico
20240315,2021,15,Lima,Complejo Arqueologico Mateo Salado,11,Noviembre,1,0,0,0,0,0,15,0,0,15,0,0,0,0,0,0,0,0,0,15,Sitio Arqueológico
20240315,2021,15,Lima,Complejo Arqueologico Mateo Salado,11,Noviembre,2,0,0,0,0,1,39,2,9,51,0,0,0,0,0,7,0,4,11,62,Sitio Arqueológico
20240315,2021,15,Lima,Complejo Arqueologico Mateo Salado,12,Diciembre,0,0,0,0,0,7,18,4,4,33,0,0,0,0,0,28,2,13,43,76,Sitio Arqueológico
20240315,2021,15,Lima,Complejo Arqueologico Mateo Salado,12,Diciembre,1,0,0,0,0,0,15,4,0,19,0,0,0,0,0,0,0,0,0,19,Sitio Arqueológico
20240315,2021,15,Lima,Complejo Arqueologico Mateo Salado,12,Diciembre,2,0,0,0,0,7,33,8,4,52,0,0,0,0,0,28,2,13,43,95,Sitio Arqueológico
20240315,2021,18,Moquegua,Sitio Arqueologico de Cerro Baul,1,Enero,0,0,0,0,0,0,0,0,0,0,0,0,0,0,0,0,0,0,0,0,Sitio Arqueológico
20240315,2021,18,Moquegua,Sitio Arqueologico de Cerro Baul,1,Enero,1,0,0,0,0,0,0,0,0,0,0,0,0,0,0,0,0,0,0,0,Sitio Arqueológico
20240315,2021,18,Moquegua,Sitio Arqueologico de Cerro Baul,1,Enero,2,0,0,0,0,0,0,0,0,0,0,0,0,0,0,0,0,0,0,0,Sitio Arqueológico
20240315,2021,18,Moquegua,Sitio Arqueologico de Cerro Baul,2,Febrero,0,0,0,0,0,0,0,0,0,0,0,0,0,0,0,0,0,0,0,0,Sitio Arqueológico
20240315,2021,18,Moquegua,Sitio Arqueologico de Cerro Baul,2,Febrero,1,0,0,0,0,0,0,0,0,0,0,0,0,0,0,0,0,0,0,0,Sitio Arqueológico
20240315,2021,18,Moquegua,Sitio Arqueologico de Cerro Baul,2,Febrero,2,0,0,0,0,0,0,0,0,0,0,0,0,0,0,0,0,0,0,0,Sitio Arqueológico
20240315,2021,18,Moquegua,Sitio Arqueologico de Cerro Baul,3,Marzo,0,0,0,0,0,0,0,0,0,0,0,0,0,0,0,0,0,0,0,0,Sitio Arqueológico
20240315,2021,18,Moquegua,Sitio Arqueologico de Cerro Baul,3,Marzo,1,0,0,0,0,0,0,0,0,0,0,0,0,0,0,0,0,0,0,0,Sitio Arqueológico
20240315,2021,18,Moquegua,Sitio Arqueologico de Cerro Baul,3,Marzo,2,0,0,0,0,0,0,0,0,0,0,0,0,0,0,0,0,0,0,0,Sitio Arqueológico
20240315,2021,18,Moquegua,Sitio Arqueologico de Cerro Baul,4,Abril,0,0,0,0,0,0,0,0,0,0,0,0,0,0,0,0,0,0,0,0,Sitio Arqueológico
20240315,2021,18,Moquegua,Sitio Arqueologico de Cerro Baul,4,Abril,1,0,0,0,0,0,0,0,0,0,0,0,0,0,0,0,0,0,0,0,Sitio Arqueológico
20240315,2021,18,Moquegua,Sitio Arqueologico de Cerro Baul,4,Abril,2,0,0,0,0,0,0,0,0,0,0,0,0,0,0,0,0,0,0,0,Sitio Arqueológico
20240315,2021,18,Moquegua,Sitio Arqueologico de Cerro Baul,5,Mayo,0,0,0,0,0,0,0,0,0,0,0,0,0,0,0,0,0,0,0,0,Sitio Arqueológico
20240315,2021,18,Moquegua,Sitio Arqueologico de Cerro Baul,5,Mayo,1,0,0,0,0,0,0,0,0,0,0,0,0,0,0,0,0,0,0,0,Sitio Arqueológico
20240315,2021,18,Moquegua,Sitio Arqueologico de Cerro Baul,5,Mayo,2,0,0,0,0,0,0,0,0,0,0,0,0,0,0,0,0,0,0,0,Sitio Arqueológico
20240315,2021,18,Moquegua,Sitio Arqueologico de Cerro Baul,6,Junio,0,0,0,0,0,0,0,0,0,0,0,0,0,0,0,0,0,0,0,0,Sitio Arqueológico
20240315,2021,18,Moquegua,Sitio Arqueologico de Cerro Baul,6,Junio,1,0,0,0,0,0,0,0,0,0,0,0,0,0,0,0,0,0,0,0,Sitio Arqueológico
20240315,2021,18,Moquegua,Sitio Arqueologico de Cerro Baul,6,Junio,2,0,0,0,0,0,0,0,0,0,0,0,0,0,0,0,0,0,0,0,Sitio Arqueológico
20240315,2021,18,Moquegua,Sitio Arqueologico de Cerro Baul,7,Julio,0,0,0,0,0,0,0,0,0,0,0,0,0,0,0,0,0,0,0,0,Sitio Arqueológico
20240315,2021,18,Moquegua,Sitio Arqueologico de Cerro Baul,7,Julio,1,0,0,0,0,0,0,0,0,0,0,0,0,0,0,0,0,0,0,0,Sitio Arqueológico
20240315,2021,18,Moquegua,Sitio Arqueologico de Cerro Baul,7,Julio,2,0,0,0,0,0,0,0,0,0,0,0,0,0,0,0,0,0,0,0,Sitio Arqueológico
20240315,2021,18,Moquegua,Sitio Arqueologico de Cerro Baul,8,Agosto,0,0,0,0,0,0,0,0,0,0,0,0,0,0,0,0,0,0,0,0,Sitio Arqueológico
20240315,2021,18,Moquegua,Sitio Arqueologico de Cerro Baul,8,Agosto,1,0,0,0,0,0,0,0,0,0,0,0,0,0,0,0,0,0,0,0,Sitio Arqueológico
20240315,2021,18,Moquegua,Sitio Arqueologico de Cerro Baul,8,Agosto,2,0,0,0,0,0,0,0,0,0,0,0,0,0,0,0,0,0,0,0,Sitio Arqueológico
20240315,2021,18,Moquegua,Sitio Arqueologico de Cerro Baul,9,Setiembre,0,0,0,0,0,0,0,0,0,0,0,0,0,0,0,0,0,0,0,0,Sitio Arqueológico
20240315,2021,18,Moquegua,Sitio Arqueologico de Cerro Baul,9,Setiembre,1,0,0,0,0,0,0,0,0,0,0,0,0,0,0,0,0,0,0,0,Sitio Arqueológico
20240315,2021,18,Moquegua,Sitio Arqueologico de Cerro Baul,9,Setiembre,2,0,0,0,0,0,0,0,0,0,0,0,0,0,0,0,0,0,0,0,Sitio Arqueológico
20240315,2021,18,Moquegua,Sitio Arqueologico de Cerro Baul,10,Octubre,0,0,0,0,0,0,0,0,0,0,0,0,0,0,0,0,0,0,0,0,Sitio Arqueológico
20240315,2021,18,Moquegua,Sitio Arqueologico de Cerro Baul,10,Octubre,1,0,0,0,0,0,0,0,0,0,0,0,0,0,0,0,0,0,0,0,Sitio Arqueológico
20240315,2021,18,Moquegua,Sitio Arqueologico de Cerro Baul,10,Octubre,2,0,0,0,0,0,0,0,0,0,0,0,0,0,0,0,0,0,0,0,Sitio Arqueológico
20240315,2021,18,Moquegua,Sitio Arqueologico de Cerro Baul,11,Noviembre,0,0,0,0,0,0,0,0,0,0,0,0,0,0,0,0,0,0,0,0,Sitio Arqueológico
20240315,2021,18,Moquegua,Sitio Arqueologico de Cerro Baul,11,Noviembre,1,0,0,0,0,0,0,0,0,0,0,0,0,0,0,0,0,0,0,0,Sitio Arqueológico
20240315,2021,18,Moquegua,Sitio Arqueologico de Cerro Baul,11,Noviembre,2,0,0,0,0,0,0,0,0,0,0,0,0,0,0,0,0,0,0,0,Sitio Arqueológico
20240315,2021,18,Moquegua,Sitio Arqueologico de Cerro Baul,12,Diciembre,0,0,0,0,0,0,0,0,0,0,0,0,0,0,0,0,0,0,0,0,Sitio Arqueológico
20240315,2021,18,Moquegua,Sitio Arqueologico de Cerro Baul,12,Diciembre,1,0,0,0,0,0,0,0,0,0,0,0,0,0,0,0,0,0,0,0,Sitio Arqueológico
20240315,2021,18,Moquegua,Sitio Arqueologico de Cerro Baul,12,Diciembre,2,0,0,0,0,0,0,0,0,0,0,0,0,0,0,0,0,0,0,0,Sitio Arqueológico
20240315,2021,21,Puno,Monumento Arqueologico de Cutimbo,1,Enero,0,0,0,0,0,0,0,0,0,0,0,0,0,0,0,0,0,0,0,0,Sitio Arqueológico
20240315,2021,21,Puno,Monumento Arqueologico de Cutimbo,1,Enero,1,0,0,0,0,0,0,0,0,0,0,0,0,0,0,0,0,0,0,0,Sitio Arqueológico
20240315,2021,21,Puno,Monumento Arqueologico de Cutimbo,1,Enero,2,0,0,0,0,0,0,0,0,0,0,0,0,0,0,0,0,0,0,0,Sitio Arqueológico
20240315,2021,21,Puno,Monumento Arqueologico de Cutimbo,2,Febrero,0,0,0,0,0,0,0,0,0,0,0,0,0,0,0,0,0,0,0,0,Sitio Arqueológico
20240315,2021,21,Puno,Monumento Arqueologico de Cutimbo,2,Febrero,1,0,0,0,0,0,0,0,0,0,0,0,0,0,0,0,0,0,0,0,Sitio Arqueológico
20240315,2021,21,Puno,Monumento Arqueologico de Cutimbo,2,Febrero,2,0,0,0,0,0,0,0,0,0,0,0,0,0,0,0,0,0,0,0,Sitio Arqueológico
20240315,2021,21,Puno,Monumento Arqueologico de Cutimbo,3,Marzo,0,0,0,0,0,0,0,0,0,0,0,0,0,0,0,0,0,0,0,0,Sitio Arqueológico
20240315,2021,21,Puno,Monumento Arqueologico de Cutimbo,3,Marzo,1,0,0,0,0,0,0,0,0,0,0,0,0,0,0,0,0,0,0,0,Sitio Arqueológico
20240315,2021,21,Puno,Monumento Arqueologico de Cutimbo,3,Marzo,2,0,0,0,0,0,0,0,0,0,0,0,0,0,0,0,0,0,0,0,Sitio Arqueológico
20240315,2021,21,Puno,Monumento Arqueologico de Cutimbo,4,Abril,0,0,0,0,0,0,0,0,0,0,0,0,0,0,0,0,0,0,0,0,Sitio Arqueológico
20240315,2021,21,Puno,Monumento Arqueologico de Cutimbo,4,Abril,1,0,0,0,0,0,0,0,0,0,0,0,0,0,0,0,0,0,0,0,Sitio Arqueológico
20240315,2021,21,Puno,Monumento Arqueologico de Cutimbo,4,Abril,2,0,0,0,0,0,0,0,0,0,0,0,0,0,0,0,0,0,0,0,Sitio Arqueológico
20240315,2021,21,Puno,Monumento Arqueologico de Cutimbo,5,Mayo,0,0,0,0,0,0,0,0,0,0,0,0,0,0,0,0,0,0,0,0,Sitio Arqueológico
20240315,2021,21,Puno,Monumento Arqueologico de Cutimbo,5,Mayo,1,0,0,0,0,0,0,0,0,0,0,0,0,0,0,0,0,0,0,0,Sitio Arqueológico
20240315,2021,21,Puno,Monumento Arqueologico de Cutimbo,5,Mayo,2,0,0,0,0,0,0,0,0,0,0,0,0,0,0,0,0,0,0,0,Sitio Arqueológico
20240315,2021,21,Puno,Monumento Arqueologico de Cutimbo,6,Junio,0,0,0,0,0,0,0,0,0,0,0,0,0,0,0,0,0,0,0,0,Sitio Arqueológico
20240315,2021,21,Puno,Monumento Arqueologico de Cutimbo,6,Junio,1,0,0,0,0,0,0,0,0,0,0,0,0,0,0,0,0,0,0,0,Sitio Arqueológico
20240315,2021,21,Puno,Monumento Arqueologico de Cutimbo,6,Junio,2,0,0,0,0,0,0,0,0,0,0,0,0,0,0,0,0,0,0,0,Sitio Arqueológico
20240315,2021,21,Puno,Monumento Arqueologico de Cutimbo,7,Julio,0,0,0,0,0,0,0,0,0,0,0,0,0,0,0,0,0,0,0,0,Sitio Arqueológico
20240315,2021,21,Puno,Monumento Arqueologico de Cutimbo,7,Julio,1,0,0,0,0,0,0,0,0,0,0,0,0,0,0,0,0,0,0,0,Sitio Arqueológico
20240315,2021,21,Puno,Monumento Arqueologico de Cutimbo,7,Julio,2,0,0,0,0,0,0,0,0,0,0,0,0,0,0,0,0,0,0,0,Sitio Arqueológico
20240315,2021,21,Puno,Monumento Arqueologico de Cutimbo,8,Agosto,0,0,0,0,0,0,0,0,0,0,0,0,0,0,0,0,0,0,0,0,Sitio Arqueológico
20240315,2021,21,Puno,Monumento Arqueologico de Cutimbo,8,Agosto,1,0,0,0,0,0,0,0,0,0,0,0,0,0,0,0,0,0,0,0,Sitio Arqueológico
20240315,2021,21,Puno,Monumento Arqueologico de Cutimbo,8,Agosto,2,0,0,0,0,0,0,0,0,0,0,0,0,0,0,0,0,0,0,0,Sitio Arqueológico
20240315,2021,21,Puno,Monumento Arqueologico de Cutimbo,9,Setiembre,0,0,0,0,0,0,0,0,0,0,0,0,0,0,0,0,0,0,0,0,Sitio Arqueológico
20240315,2021,21,Puno,Monumento Arqueologico de Cutimbo,9,Setiembre,1,0,0,0,0,0,0,0,0,0,0,0,0,0,0,0,0,0,0,0,Sitio Arqueológico
20240315,2021,21,Puno,Monumento Arqueologico de Cutimbo,9,Setiembre,2,0,0,0,0,0,0,0,0,0,0,0,0,0,0,0,0,0,0,0,Sitio Arqueológico
20240315,2021,21,Puno,Monumento Arqueologico de Cutimbo,10,Octubre,0,0,0,0,0,0,0,0,0,0,0,0,0,0,0,0,0,0,0,0,Sitio Arqueológico
20240315,2021,21,Puno,Monumento Arqueologico de Cutimbo,10,Octubre,1,0,0,0,0,0,0,0,0,0,0,0,0,0,0,0,0,0,0,0,Sitio Arqueológico
20240315,2021,21,Puno,Monumento Arqueologico de Cutimbo,10,Octubre,2,0,0,0,0,0,0,0,0,0,0,0,0,0,0,0,0,0,0,0,Sitio Arqueológico
20240315,2021,21,Puno,Monumento Arqueologico de Cutimbo,11,Noviembre,0,0,0,0,0,0,0,0,0,0,0,0,0,0,0,0,0,0,0,0,Sitio Arqueológico
20240315,2021,21,Puno,Monumento Arqueologico de Cutimbo,11,Noviembre,1,0,0,0,0,0,0,0,0,0,0,0,0,0,0,0,0,0,0,0,Sitio Arqueológico
20240315,2021,21,Puno,Monumento Arqueologico de Cutimbo,11,Noviembre,2,0,0,0,0,0,0,0,0,0,0,0,0,0,0,0,0,0,0,0,Sitio Arqueológico
20240315,2021,21,Puno,Monumento Arqueologico de Cutimbo,12,Diciembre,0,0,0,0,0,0,0,0,0,0,0,0,0,0,0,0,0,0,0,0,Sitio Arqueológico
20240315,2021,21,Puno,Monumento Arqueologico de Cutimbo,12,Diciembre,1,0,0,0,0,0,0,0,0,0,0,0,0,0,0,0,0,0,0,0,Sitio Arqueológico
20240315,2021,21,Puno,Monumento Arqueologico de Cutimbo,12,Diciembre,2,0,0,0,0,0,0,0,0,0,0,0,0,0,0,0,0,0,0,0,Sitio Arqueológico
20240315,2021,21,Puno,Sitio Arqueologico de Sillustani,1,Enero,0,1,0,0,0,0,442,61,51,555,0,0,0,0,0,0,0,0,0,555,Sitio Arqueológico
20240315,2021,21,Puno,Sitio Arqueologico de Sillustani,1,Enero,1,0,0,0,0,0,14,0,0,14,0,0,0,0,0,0,0,0,0,14,Sitio Arqueológico
20240315,2021,21,Puno,Sitio Arqueologico de Sillustani,1,Enero,2,1,0,0,0,0,456,61,51,569,0,0,0,0,0,0,0,0,0,569,Sitio Arqueológico
20240315,2021,21,Puno,Sitio Arqueologico de Sillustani,2,Febrero,0,0,0,0,0,0,0,0,0,0,0,0,0,0,0,0,0,0,0,0,Sitio Arqueológico
20240315,2021,21,Puno,Sitio Arqueologico de Sillustani,2,Febrero,1,0,0,0,0,0,0,0,0,0,0,0,0,0,0,0,0,0,0,0,Sitio Arqueológico
20240315,2021,21,Puno,Sitio Arqueologico de Sillustani,2,Febrero,2,0,0,0,0,0,0,0,0,0,0,0,0,0,0,0,0,0,0,0,Sitio Arqueológico
20240315,2021,21,Puno,Sitio Arqueologico de Sillustani,3,Marzo,0,0,0,0,0,0,692,147,107,946,0,0,0,0,0,0,0,0,0,946,Sitio Arqueológico
20240315,2021,21,Puno,Sitio Arqueologico de Sillustani,3,Marzo,1,0,0,0,0,0,46,0,0,46,0,0,0,0,0,0,0,0,0,46,Sitio Arqueológico
20240315,2021,21,Puno,Sitio Arqueologico de Sillustani,3,Marzo,2,0,0,0,0,0,738,147,107,992,0,0,0,0,0,0,0,0,0,992,Sitio Arqueológico
20240315,2021,21,Puno,Sitio Arqueologico de Sillustani,4,Abril,0,0,0,0,0,0,690,48,19,757,0,0,0,0,0,0,0,0,0,757,Sitio Arqueológico
20240315,2021,21,Puno,Sitio Arqueologico de Sillustani,4,Abril,1,0,0,0,0,0,33,0,0,33,0,0,0,0,0,0,0,0,0,33,Sitio Arqueológico
20240315,2021,21,Puno,Sitio Arqueologico de Sillustani,4,Abril,2,0,0,0,0,0,723,48,19,790,0,0,0,0,0,0,0,0,0,790,Sitio Arqueológico
20240315,2021,21,Puno,Sitio Arqueologico de Sillustani,5,Mayo,0,2,0,0,0,0,916,164,140,1222,0,0,0,0,0,0,0,0,0,1222,Sitio Arqueológico
20240315,2021,21,Puno,Sitio Arqueologico de Sillustani,5,Mayo,1,0,0,0,0,0,518,19,7,544,0,0,0,0,0,0,0,0,0,544,Sitio Arqueológico
20240315,2021,21,Puno,Sitio Arqueologico de Sillustani,5,Mayo,2,2,0,0,0,0,1434,183,147,1766,0,0,0,0,0,0,0,0,0,1766,Sitio Arqueológico
20240315,2021,21,Puno,Sitio Arqueologico de Sillustani,6,Junio,0,6,0,0,0,0,1246,238,143,1633,0,0,0,0,0,17,7,5,29,1662,Sitio Arqueológico
20240315,2021,21,Puno,Sitio Arqueologico de Sillustani,6,Junio,1,0,0,0,0,0,760,34,4,798,0,0,0,0,0,0,0,0,0,798,Sitio Arqueológico
20240315,2021,21,Puno,Sitio Arqueologico de Sillustani,6,Junio,2,6,0,0,0,0,2006,272,147,2431,0,0,0,0,0,17,7,5,29,2460,Sitio Arqueológico
20240315,2021,21,Puno,Sitio Arqueologico de Sillustani,7,Julio,0,9,0,0,0,0,2677,465,493,3644,0,0,0,0,0,224,87,50,361,4005,Sitio Arqueológico
20240315,2021,21,Puno,Sitio Arqueologico de Sillustani,7,Julio,1,0,0,0,0,0,1087,95,58,1240,0,0,0,0,0,0,0,0,0,1240,Sitio Arqueológico
20240315,2021,21,Puno,Sitio Arqueologico de Sillustani,7,Julio,2,9,0,0,0,0,3764,560,551,4884,0,0,0,0,0,224,87,50,361,5245,Sitio Arqueológico
20240315,2021,21,Puno,Sitio Arqueologico de Sillustani,8,Agosto,0,0,0,0,0,0,4964,784,1062,6810,0,0,0,0,0,419,209,103,731,7541,Sitio Arqueológico
20240315,2021,21,Puno,Sitio Arqueologico de Sillustani,8,Agosto,1,0,0,0,0,0,1119,69,60,1248,0,0,0,0,0,0,0,0,0,1248,Sitio Arqueológico
20240315,2021,21,Puno,Sitio Arqueologico de Sillustani,8,Agosto,2,0,0,0,0,0,6083,853,1122,8058,0,0,0,0,0,419,209,103,731,8789,Sitio Arqueológico
20240315,2021,21,Puno,Sitio Arqueologico de Sillustani,9,Setiembre,0,4,0,0,0,0,1716,420,275,2415,0,0,0,0,0,483,111,101,695,3110,Sitio Arqueológico
20240315,2021,21,Puno,Sitio Arqueologico de Sillustani,9,Setiembre,1,0,0,0,0,0,1552,72,28,1652,0,0,0,0,0,0,0,0,0,1652,Sitio Arqueológico
20240315,2021,21,Puno,Sitio Arqueologico de Sillustani,9,Setiembre,2,4,0,0,0,0,3268,492,303,4067,0,0,0,0,0,483,111,101,695,4762,Sitio Arqueológico
20240315,2021,21,Puno,Sitio Arqueologico de Sillustani,10,Octubre,0,0,0,0,0,0,2386,504,766,3656,0,0,0,0,0,364,122,86,572,4228,Sitio Arqueológico
20240315,2021,21,Puno,Sitio Arqueologico de Sillustani,10,Octubre,1,0,0,0,0,0,2417,102,79,2598,0,0,0,0,0,0,0,0,0,2598,Sitio Arqueológico
20240315,2021,21,Puno,Sitio Arqueologico de Sillustani,10,Octubre,2,0,0,0,0,0,4803,606,845,6254,0,0,0,0,0,364,122,86,572,6826,Sitio Arqueológico
20240315,2021,21,Puno,Sitio Arqueologico de Sillustani,11,Noviembre,0,5,0,0,0,0,1656,430,461,2552,0,0,0,0,0,359,89,80,528,3080,Sitio Arqueológico
20240315,2021,21,Puno,Sitio Arqueologico de Sillustani,11,Noviembre,1,0,0,0,0,0,1816,78,56,1950,0,0,0,0,0,0,0,0,0,1950,Sitio Arqueológico
20240315,2021,21,Puno,Sitio Arqueologico de Sillustani,11,Noviembre,2,5,0,0,0,0,3472,508,517,4502,0,0,0,0,0,359,89,80,528,5030,Sitio Arqueológico
20240315,2021,21,Puno,Sitio Arqueologico de Sillustani,12,Diciembre,0,3,0,0,0,0,1281,439,496,2219,0,0,0,0,0,314,75,44,433,2652,Sitio Arqueológico
20240315,2021,21,Puno,Sitio Arqueologico de Sillustani,12,Diciembre,1,0,0,0,0,0,1375,69,45,1489,0,0,0,0,0,0,0,0,0,1489,Sitio Arqueológico
20240315,2021,21,Puno,Sitio Arqueologico de Sillustani,12,Diciembre,2,3,0,0,0,0,2656,508,541,3708,0,0,0,0,0,314,75,44,433,4141,Sitio Arqueológico
20240315,2021,24,Tumbes,Zona Arqueologica Monumental Cabeza de Vaca,1,Enero,0,0,0,0,0,2,21,8,4,35,0,0,0,3,1,10,1,0,15,50,Sitio Arqueológico
20240315,2021,24,Tumbes,Zona Arqueologica Monumental Cabeza de Vaca,1,Enero,1,0,0,0,0,0,0,0,0,0,0,0,0,0,0,0,0,0,0,0,Sitio Arqueológico
20240315,2021,24,Tumbes,Zona Arqueologica Monumental Cabeza de Vaca,1,Enero,2,0,0,0,0,2,21,8,4,35,0,0,0,3,1,10,1,0,15,50,Sitio Arqueológico
20240315,2021,24,Tumbes,Zona Arqueologica Monumental Cabeza de Vaca,2,Febrero,0,0,0,0,0,0,0,0,0,0,0,0,0,0,0,0,0,0,0,0,Sitio Arqueológico
20240315,2021,24,Tumbes,Zona Arqueologica Monumental Cabeza de Vaca,2,Febrero,1,0,0,0,0,0,0,0,0,0,0,0,0,0,0,0,0,0,0,0,Sitio Arqueológico
20240315,2021,24,Tumbes,Zona Arqueologica Monumental Cabeza de Vaca,2,Febrero,2,0,0,0,0,0,0,0,0,0,0,0,0,0,0,0,0,0,0,0,Sitio Arqueológico
20240315,2021,24,Tumbes,Zona Arqueologica Monumental Cabeza de Vaca,3,Marzo,0,0,0,0,0,1,7,5,3,16,0,0,0,0,0,8,0,0,8,24,Sitio Arqueológico
20240315,2021,24,Tumbes,Zona Arqueologica Monumental Cabeza de Vaca,3,Marzo,1,0,0,0,0,0,0,0,0,0,0,0,0,0,0,0,0,0,0,0,Sitio Arqueológico
20240315,2021,24,Tumbes,Zona Arqueologica Monumental Cabeza de Vaca,3,Marzo,2,0,0,0,0,1,7,5,3,16,0,0,0,0,0,8,0,0,8,24,Sitio Arqueológico
20240315,2021,24,Tumbes,Zona Arqueologica Monumental Cabeza de Vaca,4,Abril,0,0,0,0,0,0,0,0,0,0,0,0,0,0,0,0,0,0,0,0,Sitio Arqueológico
20240315,2021,24,Tumbes,Zona Arqueologica Monumental Cabeza de Vaca,4,Abril,1,0,0,0,0,0,0,0,0,0,0,0,0,0,0,0,0,0,0,0,Sitio Arqueológico
20240315,2021,24,Tumbes,Zona Arqueologica Monumental Cabeza de Vaca,4,Abril,2,0,0,0,0,0,0,0,0,0,0,0,0,0,0,0,0,0,0,0,Sitio Arqueológico
20240315,2021,24,Tumbes,Zona Arqueologica Monumental Cabeza de Vaca,5,Mayo,0,0,0,0,0,1,6,3,4,14,0,0,0,0,1,13,4,0,18,32,Sitio Arqueológico
20240315,2021,24,Tumbes,Zona Arqueologica Monumental Cabeza de Vaca,5,Mayo,1,0,0,0,0,0,0,0,0,0,0,0,0,0,0,0,0,0,0,0,Sitio Arqueológico
20240315,2021,24,Tumbes,Zona Arqueologica Monumental Cabeza de Vaca,5,Mayo,2,0,0,0,0,1,6,3,4,14,0,0,0,0,1,13,4,0,18,32,Sitio Arqueológico
20240315,2021,24,Tumbes,Zona Arqueologica Monumental Cabeza de Vaca,6,Junio,0,0,0,0,0,1,10,0,0,11,0,0,0,0,0,12,7,0,19,30,Sitio Arqueológico
20240315,2021,24,Tumbes,Zona Arqueologica Monumental Cabeza de Vaca,6,Junio,1,0,0,0,0,0,0,0,0,0,0,0,0,0,0,0,0,0,0,0,Sitio Arqueológico
20240315,2021,24,Tumbes,Zona Arqueologica Monumental Cabeza de Vaca,6,Junio,2,0,0,0,0,1,10,0,0,11,0,0,0,0,0,12,7,0,19,30,Sitio Arqueológico
20240315,2021,24,Tumbes,Zona Arqueologica Monumental Cabeza de Vaca,7,Julio,0,0,0,0,0,6,41,2,10,59,0,0,0,3,0,36,2,1,42,101,Sitio Arqueológico
20240315,2021,24,Tumbes,Zona Arqueologica Monumental Cabeza de Vaca,7,Julio,1,0,0,0,0,0,0,0,0,0,0,0,0,0,0,0,0,0,0,0,Sitio Arqueológico
20240315,2021,24,Tumbes,Zona Arqueologica Monumental Cabeza de Vaca,7,Julio,2,0,0,0,0,6,41,2,10,59,0,0,0,3,0,36,2,1,42,101,Sitio Arqueológico
20240315,2021,24,Tumbes,Zona Arqueologica Monumental Cabeza de Vaca,8,Agosto,0,0,0,0,0,3,38,16,10,67,0,0,0,0,0,15,7,0,22,89,Sitio Arqueológico
20240315,2021,24,Tumbes,Zona Arqueologica Monumental Cabeza de Vaca,8,Agosto,1,0,0,0,0,0,0,0,0,0,0,0,0,0,0,0,0,0,0,0,Sitio Arqueológico
20240315,2021,24,Tumbes,Zona Arqueologica Monumental Cabeza de Vaca,8,Agosto,2,0,0,0,0,3,38,16,10,67,0,0,0,0,0,15,7,0,22,89,Sitio Arqueológico
20240315,2021,24,Tumbes,Zona Arqueologica Monumental Cabeza de Vaca,9,Setiembre,0,0,0,0,0,8,42,0,4,54,0,0,0,0,0,0,0,0,0,54,Sitio Arqueológico
20240315,2021,24,Tumbes,Zona Arqueologica Monumental Cabeza de Vaca,9,Setiembre,1,0,0,0,0,0,0,0,0,0,0,0,0,0,0,0,0,0,0,0,Sitio Arqueológico
20240315,2021,24,Tumbes,Zona Arqueologica Monumental Cabeza de Vaca,9,Setiembre,2,0,0,0,0,8,42,0,4,54,0,0,0,0,0,0,0,0,0,54,Sitio Arqueológico
20240315,2021,24,Tumbes,Zona Arqueologica Monumental Cabeza de Vaca,10,Octubre,0,0,0,0,0,3,43,0,3,49,0,0,0,0,5,30,37,5,77,126,Sitio Arqueológico
20240315,2021,24,Tumbes,Zona Arqueologica Monumental Cabeza de Vaca,10,Octubre,1,0,0,0,0,0,0,0,0,0,0,0,0,0,0,0,0,0,0,0,Sitio Arqueológico
20240315,2021,24,Tumbes,Zona Arqueologica Monumental Cabeza de Vaca,10,Octubre,2,0,0,0,0,3,43,0,3,49,0,0,0,0,5,30,37,5,77,126,Sitio Arqueológico
20240315,2021,24,Tumbes,Zona Arqueologica Monumental Cabeza de Vaca,11,Noviembre,0,0,0,0,0,9,29,0,1,39,0,0,0,0,3,33,0,2,38,77,Sitio Arqueológico
20240315,2021,24,Tumbes,Zona Arqueologica Monumental Cabeza de Vaca,11,Noviembre,1,0,0,0,0,0,1,0,0,1,0,0,0,0,1,0,0,0,1,2,Sitio Arqueológico
20240315,2021,24,Tumbes,Zona Arqueologica Monumental Cabeza de Vaca,11,Noviembre,2,0,0,0,0,9,30,0,1,40,0,0,0,0,4,33,0,2,39,79,Sitio Arqueológico
20240315,2021,24,Tumbes,Zona Arqueologica Monumental Cabeza de Vaca,12,Diciembre,0,0,0,0,0,2,36,0,5,43,0,0,0,0,1,10,0,0,11,54,Sitio Arqueológico
20240315,2021,24,Tumbes,Zona Arqueologica Monumental Cabeza de Vaca,12,Diciembre,1,0,0,0,0,0,2,0,0,2,0,0,0,0,0,0,0,0,0,2,Sitio Arqueológico
20240315,2021,24,Tumbes,Zona Arqueologica Monumental Cabeza de Vaca,12,Diciembre,2,0,0,0,0,2,38,0,5,45,0,0,0,0,1,10,0,0,11,56,Sitio Arqueológico
20240315,2022,1,Amazonas,Zona Arqueologica Monumental Kuelap,1,Enero,0,0,0,0,133,516,2791,732,989,5161,0,0,0,14,106,597,97,77,891,6052,Sitio Arqueológico
20240315,2022,1,Amazonas,Zona Arqueologica Monumental Kuelap,1,Enero,1,0,0,0,0,39,267,56,7,369,0,0,0,0,0,0,0,0,0,369,Sitio Arqueológico
20240315,2022,1,Amazonas,Zona Arqueologica Monumental Kuelap,1,Enero,2,0,0,0,133,555,3058,788,996,5530,0,0,0,14,106,597,97,77,891,6421,Sitio Arqueológico
20240315,2022,1,Amazonas,Zona Arqueologica Monumental Kuelap,2,Febrero,0,0,0,0,134,580,2240,664,895,4513,0,0,0,22,48,199,41,46,356,4869,Sitio Arqueológico
20240315,2022,1,Amazonas,Zona Arqueologica Monumental Kuelap,2,Febrero,1,0,0,0,0,12,223,70,6,311,0,0,0,0,0,0,0,0,0,311,Sitio Arqueológico
20240315,2022,1,Amazonas,Zona Arqueologica Monumental Kuelap,2,Febrero,2,0,0,0,134,592,2463,734,901,4824,0,0,0,22,48,199,41,46,356,5180,Sitio Arqueológico
20240315,2022,1,Amazonas,Zona Arqueologica Monumental Kuelap,3,Marzo,0,0,0,0,58,286,1564,419,277,2604,0,0,0,7,31,222,47,27,334,2938,Sitio Arqueológico
20240315,2022,1,Amazonas,Zona Arqueologica Monumental Kuelap,3,Marzo,1,0,0,0,0,25,185,85,0,295,0,0,0,0,0,0,0,0,0,295,Sitio Arqueológico
20240315,2022,1,Amazonas,Zona Arqueologica Monumental Kuelap,3,Marzo,2,0,0,0,58,311,1749,504,277,2899,0,0,0,7,31,222,47,27,334,3233,Sitio Arqueológico
20240315,2022,1,Amazonas,Zona Arqueologica Monumental Kuelap,4,Abril,0,0,0,0,4,54,274,80,28,440,0,0,0,6,36,88,17,11,158,598,Sitio Arqueológico
20240315,2022,1,Amazonas,Zona Arqueologica Monumental Kuelap,4,Abril,1,0,0,0,0,13,70,23,4,110,0,0,0,0,0,0,0,0,0,110,Sitio Arqueológico
20240315,2022,1,Amazonas,Zona Arqueologica Monumental Kuelap,4,Abril,2,0,0,0,4,67,344,103,32,550,0,0,0,6,36,88,17,11,158,708,Sitio Arqueológico
20240315,2022,1,Amazonas,Zona Arqueologica Monumental Kuelap,5,Mayo,0,0,0,0,0,0,0,0,0,0,0,0,0,0,0,0,0,0,0,0,Sitio Arqueológico
20240315,2022,1,Amazonas,Zona Arqueologica Monumental Kuelap,5,Mayo,1,0,0,0,0,0,0,0,0,0,0,0,0,0,0,0,0,0,0,0,Sitio Arqueológico
20240315,2022,1,Amazonas,Zona Arqueologica Monumental Kuelap,5,Mayo,2,0,0,0,0,0,0,0,0,0,0,0,0,0,0,0,0,0,0,0,Sitio Arqueológico
20240315,2022,1,Amazonas,Zona Arqueologica Monumental Kuelap,6,Junio,0,0,0,0,0,0,0,0,0,0,0,0,0,0,0,0,0,0,0,0,Sitio Arqueológico
20240315,2022,1,Amazonas,Zona Arqueologica Monumental Kuelap,6,Junio,1,0,0,0,0,0,0,0,0,0,0,0,0,0,0,0,0,0,0,0,Sitio Arqueológico
20240315,2022,1,Amazonas,Zona Arqueologica Monumental Kuelap,6,Junio,2,0,0,0,0,0,0,0,0,0,0,0,0,0,0,0,0,0,0,0,Sitio Arqueológico
20240315,2022,1,Amazonas,Zona Arqueologica Monumental Kuelap,7,Julio,0,0,0,0,0,0,0,0,0,0,0,0,0,0,0,4465,411,833,5709,5709,Sitio Arqueológico
20240315,2022,1,Amazonas,Zona Arqueologica Monumental Kuelap,7,Julio,1,0,0,0,0,0,0,0,0,0,0,0,0,0,0,321,20,19,360,360,Sitio Arqueológico
20240315,2022,1,Amazonas,Zona Arqueologica Monumental Kuelap,7,Julio,2,0,0,0,0,0,0,0,0,0,0,0,0,0,0,4786,431,852,6069,6069,Sitio Arqueológico
20240315,2022,1,Amazonas,Zona Arqueologica Monumental Kuelap,8,Agosto,0,0,0,0,0,0,0,0,0,0,0,0,0,0,0,3501,168,344,4013,4013,Sitio Arqueológico
20240315,2022,1,Amazonas,Zona Arqueologica Monumental Kuelap,8,Agosto,1,0,0,0,0,0,0,0,0,0,0,0,0,0,0,234,8,9,251,251,Sitio Arqueológico
20240315,2022,1,Amazonas,Zona Arqueologica Monumental Kuelap,8,Agosto,2,0,0,0,0,0,0,0,0,0,0,0,0,0,0,3735,176,353,4264,4264,Sitio Arqueológico
20240315,2022,1,Amazonas,Zona Arqueologica Monumental Kuelap,9,Setiembre,0,0,0,0,0,0,0,0,0,0,0,0,0,0,443,2050,675,361,3529,3529,Sitio Arqueológico
20240315,2022,1,Amazonas,Zona Arqueologica Monumental Kuelap,9,Setiembre,1,0,0,0,0,0,0,0,0,0,0,0,0,0,0,0,0,0,0,0,Sitio Arqueológico
20240315,2022,1,Amazonas,Zona Arqueologica Monumental Kuelap,9,Setiembre,2,0,0,0,0,0,0,0,0,0,0,0,0,0,443,2050,675,361,3529,3529,Sitio Arqueológico
20240315,2022,1,Amazonas,Zona Arqueologica Monumental Kuelap,10,Octubre,0,0,0,0,0,0,0,0,0,0,0,0,0,0,608,2123,778,580,4089,4089,Sitio Arqueológico
20240315,2022,1,Amazonas,Zona Arqueologica Monumental Kuelap,10,Octubre,1,0,0,0,0,0,0,0,0,0,0,0,0,0,0,0,0,0,0,0,Sitio Arqueológico
20240315,2022,1,Amazonas,Zona Arqueologica Monumental Kuelap,10,Octubre,2,0,0,0,0,0,0,0,0,0,0,0,0,0,608,2123,778,580,4089,4089,Sitio Arqueológico
20240315,2022,1,Amazonas,Zona Arqueologica Monumental Kuelap,11,Noviembre,0,0,0,0,0,0,0,0,0,0,0,0,0,0,346,2297,492,345,3480,3480,Sitio Arqueológico
20240315,2022,1,Amazonas,Zona Arqueologica Monumental Kuelap,11,Noviembre,1,0,0,0,0,0,0,0,0,0,0,0,0,0,64,127,1,6,198,198,Sitio Arqueológico
20240315,2022,1,Amazonas,Zona Arqueologica Monumental Kuelap,11,Noviembre,2,0,0,0,0,0,0,0,0,0,0,0,0,0,410,2424,493,351,3678,3678,Sitio Arqueológico
20240315,2022,1,Amazonas,Zona Arqueologica Monumental Kuelap,12,Diciembre,0,0,0,0,0,0,0,0,0,0,0,0,0,0,198,1896,190,321,2605,2605,Sitio Arqueológico
20240315,2022,1,Amazonas,Zona Arqueologica Monumental Kuelap,12,Diciembre,1,0,0,0,0,0,0,0,0,0,0,0,0,0,16,129,7,11,163,163,Sitio Arqueológico
20240315,2022,1,Amazonas,Zona Arqueologica Monumental Kuelap,12,Diciembre,2,0,0,0,0,0,0,0,0,0,0,0,0,0,214,2025,197,332,2768,2768,Sitio Arqueológico
20240315,2022,2,Ancash,Zona Arqueologica Monumental Chavin de Huantar,1,Enero,0,0,0,0,0,412,3092,361,876,4741,0,0,0,0,64,1066,30,192,1352,6093,Sitio Arqueológico
20240315,2022,2,Ancash,Zona Arqueologica Monumental Chavin de Huantar,1,Enero,1,0,0,0,0,2,68,5,1,76,0,0,0,0,0,0,0,0,0,76,Sitio Arqueológico
20240315,2022,2,Ancash,Zona Arqueologica Monumental Chavin de Huantar,1,Enero,2,0,0,0,0,414,3160,366,877,4817,0,0,0,0,64,1066,30,192,1352,6169,Sitio Arqueológico
20240315,2022,2,Ancash,Zona Arqueologica Monumental Chavin de Huantar,2,Febrero,0,0,0,0,0,523,3088,407,907,4925,0,0,0,0,28,351,7,85,471,5396,Sitio Arqueológico
20240315,2022,2,Ancash,Zona Arqueologica Monumental Chavin de Huantar,2,Febrero,1,0,0,0,0,2,104,1,0,107,0,0,0,0,0,0,0,0,0,107,Sitio Arqueológico
20240315,2022,2,Ancash,Zona Arqueologica Monumental Chavin de Huantar,2,Febrero,2,0,0,0,0,525,3192,408,907,5032,0,0,0,0,28,351,7,85,471,5503,Sitio Arqueológico
20240315,2022,2,Ancash,Zona Arqueologica Monumental Chavin de Huantar,3,Marzo,0,0,0,0,0,219,1694,218,293,2424,0,0,0,0,14,370,3,81,468,2892,Sitio Arqueológico
20240315,2022,2,Ancash,Zona Arqueologica Monumental Chavin de Huantar,3,Marzo,1,0,0,0,0,0,99,1,0,100,0,0,0,0,0,0,0,0,0,100,Sitio Arqueológico
20240315,2022,2,Ancash,Zona Arqueologica Monumental Chavin de Huantar,3,Marzo,2,0,0,0,0,219,1793,219,293,2524,0,0,0,0,14,370,3,81,468,2992,Sitio Arqueológico
20240315,2022,2,Ancash,Zona Arqueologica Monumental Chavin de Huantar,4,Abril,0,0,0,0,0,548,5330,529,834,7241,0,0,0,0,21,433,10,104,568,7809,Sitio Arqueológico
20240315,2022,2,Ancash,Zona Arqueologica Monumental Chavin de Huantar,4,Abril,1,0,0,0,0,0,180,9,0,189,0,0,0,0,0,0,0,0,0,189,Sitio Arqueológico
20240315,2022,2,Ancash,Zona Arqueologica Monumental Chavin de Huantar,4,Abril,2,0,0,0,0,548,5510,538,834,7430,0,0,0,0,21,433,10,104,568,7998,Sitio Arqueológico
20240315,2022,2,Ancash,Zona Arqueologica Monumental Chavin de Huantar,5,Mayo,0,0,0,0,0,669,3240,409,851,5169,0,0,0,1,51,551,33,98,734,5903,Sitio Arqueológico
20240315,2022,2,Ancash,Zona Arqueologica Monumental Chavin de Huantar,5,Mayo,1,0,0,0,0,3,278,0,0,281,0,0,0,0,0,15,0,0,15,296,Sitio Arqueológico
20240315,2022,2,Ancash,Zona Arqueologica Monumental Chavin de Huantar,5,Mayo,2,0,0,0,0,672,3518,409,851,5450,0,0,0,1,51,566,33,98,749,6199,Sitio Arqueológico
20240315,2022,2,Ancash,Zona Arqueologica Monumental Chavin de Huantar,6,Junio,0,0,0,0,0,482,2853,316,386,4037,0,0,0,1,44,681,17,188,931,4968,Sitio Arqueológico
20240315,2022,2,Ancash,Zona Arqueologica Monumental Chavin de Huantar,6,Junio,1,0,0,0,0,13,314,3,0,330,0,0,0,0,0,0,0,0,0,330,Sitio Arqueológico
20240315,2022,2,Ancash,Zona Arqueologica Monumental Chavin de Huantar,6,Junio,2,0,0,0,0,495,3167,319,386,4367,0,0,0,1,44,681,17,188,931,5298,Sitio Arqueológico
20240315,2022,2,Ancash,Zona Arqueologica Monumental Chavin de Huantar,7,Julio,0,0,0,0,0,424,4086,500,1175,6185,0,0,0,0,0,0,0,0,0,6185,Sitio Arqueológico
20240315,2022,2,Ancash,Zona Arqueologica Monumental Chavin de Huantar,7,Julio,1,0,0,0,0,0,13,0,0,13,0,0,0,0,0,0,0,0,0,13,Sitio Arqueológico
20240315,2022,2,Ancash,Zona Arqueologica Monumental Chavin de Huantar,7,Julio,2,0,0,0,0,424,4099,500,1175,6198,0,0,0,0,0,0,0,0,0,6198,Sitio Arqueológico
20240315,2022,2,Ancash,Zona Arqueologica Monumental Chavin de Huantar,8,Agosto,0,0,0,0,0,160,1957,423,971,3511,0,0,0,1,92,571,41,201,906,4417,Sitio Arqueológico
20240315,2022,2,Ancash,Zona Arqueologica Monumental Chavin de Huantar,8,Agosto,1,0,0,0,0,0,44,0,0,44,0,0,0,0,0,0,0,0,0,44,Sitio Arqueológico
20240315,2022,2,Ancash,Zona Arqueologica Monumental Chavin de Huantar,8,Agosto,2,0,0,0,0,160,2001,423,971,3555,0,0,0,1,92,571,41,201,906,4461,Sitio Arqueológico
20240315,2022,2,Ancash,Zona Arqueologica Monumental Chavin de Huantar,9,Setiembre,0,0,0,0,0,213,1002,146,235,1596,0,0,0,0,0,51,16,82,149,1745,Sitio Arqueológico
20240315,2022,2,Ancash,Zona Arqueologica Monumental Chavin de Huantar,9,Setiembre,1,0,0,0,0,12,48,1,0,61,0,0,0,0,0,0,0,0,0,61,Sitio Arqueológico
20240315,2022,2,Ancash,Zona Arqueologica Monumental Chavin de Huantar,9,Setiembre,2,0,0,0,0,225,1050,147,235,1657,0,0,0,0,0,51,16,82,149,1806,Sitio Arqueológico
20240315,2022,2,Ancash,Zona Arqueologica Monumental Chavin de Huantar,10,Octubre,0,0,0,0,0,709,4605,696,2098,8108,0,0,0,10,27,311,144,132,624,8732,Sitio Arqueológico
20240315,2022,2,Ancash,Zona Arqueologica Monumental Chavin de Huantar,10,Octubre,1,0,0,0,0,19,166,12,3,200,0,0,0,0,0,0,0,0,0,200,Sitio Arqueológico
20240315,2022,2,Ancash,Zona Arqueologica Monumental Chavin de Huantar,10,Octubre,2,0,0,0,0,728,4771,708,2101,8308,0,0,0,10,27,311,144,132,624,8932,Sitio Arqueológico
20240315,2022,2,Ancash,Zona Arqueologica Monumental Chavin de Huantar,11,Noviembre,0,0,0,0,0,466,2210,782,1311,4769,0,0,0,3,32,701,44,260,1040,5809,Sitio Arqueológico
20240315,2022,2,Ancash,Zona Arqueologica Monumental Chavin de Huantar,11,Noviembre,1,0,0,0,0,28,171,14,0,213,0,0,0,0,0,40,0,0,40,253,Sitio Arqueológico
20240315,2022,2,Ancash,Zona Arqueologica Monumental Chavin de Huantar,11,Noviembre,2,0,0,0,0,494,2381,796,1311,4982,0,0,0,3,32,741,44,260,1080,6062,Sitio Arqueológico
20240315,2022,2,Ancash,Zona Arqueologica Monumental Chavin de Huantar,12,Diciembre,0,0,0,0,0,259,2072,431,693,3455,0,0,0,2,23,474,14,425,938,4393,Sitio Arqueológico
20240315,2022,2,Ancash,Zona Arqueologica Monumental Chavin de Huantar,12,Diciembre,1,0,0,0,0,6,149,6,2,163,0,0,0,0,0,16,0,0,16,179,Sitio Arqueológico
20240315,2022,2,Ancash,Zona Arqueologica Monumental Chavin de Huantar,12,Diciembre,2,0,0,0,0,265,2221,437,695,3618,0,0,0,2,23,490,14,425,954,4572,Sitio Arqueológico
20240315,2022,2,Ancash,Sitio Arqueologico Pañamarca,1,Enero,0,0,0,0,0,0,34,41,0,75,0,0,0,0,0,2,0,2,4,79,Sitio Arqueológico
20240315,2022,2,Ancash,Sitio Arqueologico Pañamarca,1,Enero,1,0,0,0,0,0,0,0,0,0,0,0,0,0,0,0,0,0,0,0,Sitio Arqueológico
20240315,2022,2,Ancash,Sitio Arqueologico Pañamarca,1,Enero,2,0,0,0,0,0,34,41,0,75,0,0,0,0,0,2,0,2,4,79,Sitio Arqueológico
20240315,2022,2,Ancash,Sitio Arqueologico Pañamarca,2,Febrero,0,0,0,0,0,0,52,4,0,56,0,0,0,0,0,15,0,10,25,81,Sitio Arqueológico
20240315,2022,2,Ancash,Sitio Arqueologico Pañamarca,2,Febrero,1,0,0,0,0,0,0,0,0,0,0,0,0,0,0,0,0,0,0,0,Sitio Arqueológico
20240315,2022,2,Ancash,Sitio Arqueologico Pañamarca,2,Febrero,2,0,0,0,0,0,52,4,0,56,0,0,0,0,0,15,0,10,25,81,Sitio Arqueológico
20240315,2022,2,Ancash,Sitio Arqueologico Pañamarca,3,Marzo,0,0,0,0,0,0,27,1,7,35,0,0,0,0,0,0,0,0,0,35,Sitio Arqueológico
20240315,2022,2,Ancash,Sitio Arqueologico Pañamarca,3,Marzo,1,0,0,0,0,0,0,0,0,0,0,0,0,0,0,0,0,0,0,0,Sitio Arqueológico
20240315,2022,2,Ancash,Sitio Arqueologico Pañamarca,3,Marzo,2,0,0,0,0,0,27,1,7,35,0,0,0,0,0,0,0,0,0,35,Sitio Arqueológico
20240315,2022,2,Ancash,Sitio Arqueologico Pañamarca,4,Abril,0,0,0,0,0,0,68,5,12,85,0,0,0,0,0,0,0,0,0,85,Sitio Arqueológico
20240315,2022,2,Ancash,Sitio Arqueologico Pañamarca,4,Abril,1,0,0,0,0,0,0,0,0,0,0,0,0,0,0,0,0,0,0,0,Sitio Arqueológico
20240315,2022,2,Ancash,Sitio Arqueologico Pañamarca,4,Abril,2,0,0,0,0,0,68,5,12,85,0,0,0,0,0,0,0,0,0,85,Sitio Arqueológico
20240315,2022,2,Ancash,Sitio Arqueologico Pañamarca,5,Mayo,0,0,0,0,0,0,60,10,14,84,0,0,0,0,0,2,0,2,4,88,Sitio Arqueológico
20240315,2022,2,Ancash,Sitio Arqueologico Pañamarca,5,Mayo,1,0,0,0,0,0,0,0,0,0,0,0,0,0,0,0,0,0,0,0,Sitio Arqueológico
20240315,2022,2,Ancash,Sitio Arqueologico Pañamarca,5,Mayo,2,0,0,0,0,0,60,10,14,84,0,0,0,0,0,2,0,2,4,88,Sitio Arqueológico
20240315,2022,2,Ancash,Sitio Arqueologico Pañamarca,6,Junio,0,0,0,0,0,0,43,11,22,76,0,0,0,0,1,11,0,3,15,91,Sitio Arqueológico
20240315,2022,2,Ancash,Sitio Arqueologico Pañamarca,6,Junio,1,0,0,0,0,0,6,0,0,6,0,0,0,0,0,0,0,0,0,6,Sitio Arqueológico
20240315,2022,2,Ancash,Sitio Arqueologico Pañamarca,6,Junio,2,0,0,0,0,0,49,11,22,82,0,0,0,0,1,11,0,3,15,97,Sitio Arqueológico
20240315,2022,2,Ancash,Sitio Arqueologico Pañamarca,7,Julio,0,0,0,0,0,0,135,20,59,214,0,0,0,0,0,4,0,4,8,222,Sitio Arqueológico
20240315,2022,2,Ancash,Sitio Arqueologico Pañamarca,7,Julio,1,0,0,0,0,0,0,0,0,0,0,0,0,0,0,0,0,0,0,0,Sitio Arqueológico
20240315,2022,2,Ancash,Sitio Arqueologico Pañamarca,7,Julio,2,0,0,0,0,0,135,20,59,214,0,0,0,0,0,4,0,4,8,222,Sitio Arqueológico
20240315,2022,2,Ancash,Sitio Arqueologico Pañamarca,8,Agosto,0,0,0,0,0,0,127,13,96,236,0,0,0,0,9,0,0,0,9,245,Sitio Arqueológico
20240315,2022,2,Ancash,Sitio Arqueologico Pañamarca,8,Agosto,1,0,0,0,0,0,0,0,0,0,0,0,0,0,0,0,0,0,0,0,Sitio Arqueológico
20240315,2022,2,Ancash,Sitio Arqueologico Pañamarca,8,Agosto,2,0,0,0,0,0,127,13,96,236,0,0,0,0,9,0,0,0,9,245,Sitio Arqueológico
20240315,2022,2,Ancash,Sitio Arqueologico Pañamarca,9,Setiembre,0,0,0,0,0,0,75,44,648,767,0,0,0,0,0,6,0,1,7,774,Sitio Arqueológico
20240315,2022,2,Ancash,Sitio Arqueologico Pañamarca,9,Setiembre,1,0,0,0,0,0,0,0,0,0,0,0,0,0,0,0,0,0,0,0,Sitio Arqueológico
20240315,2022,2,Ancash,Sitio Arqueologico Pañamarca,9,Setiembre,2,0,0,0,0,0,75,44,648,767,0,0,0,0,0,6,0,1,7,774,Sitio Arqueológico
20240315,2022,2,Ancash,Sitio Arqueologico Pañamarca,10,Octubre,0,0,0,0,0,0,130,32,180,342,0,0,0,0,0,0,0,0,0,342,Sitio Arqueológico
20240315,2022,2,Ancash,Sitio Arqueologico Pañamarca,10,Octubre,1,0,0,0,0,0,0,0,0,0,0,0,0,0,0,0,0,0,0,0,Sitio Arqueológico
20240315,2022,2,Ancash,Sitio Arqueologico Pañamarca,10,Octubre,2,0,0,0,0,0,130,32,180,342,0,0,0,0,0,0,0,0,0,342,Sitio Arqueológico
20240315,2022,2,Ancash,Sitio Arqueologico Pañamarca,11,Noviembre,0,0,0,0,0,0,63,0,340,403,0,0,0,0,0,0,0,0,0,403,Sitio Arqueológico
20240315,2022,2,Ancash,Sitio Arqueologico Pañamarca,11,Noviembre,1,0,0,0,0,0,8,0,3,11,0,0,0,0,0,0,0,0,0,11,Sitio Arqueológico
20240315,2022,2,Ancash,Sitio Arqueologico Pañamarca,11,Noviembre,2,0,0,0,0,0,71,0,343,414,0,0,0,0,0,0,0,0,0,414,Sitio Arqueológico
20240315,2022,2,Ancash,Sitio Arqueologico Pañamarca,12,Diciembre,0,0,0,0,0,0,0,0,0,0,0,0,0,0,0,0,0,0,0,0,Sitio Arqueológico
20240315,2022,2,Ancash,Sitio Arqueologico Pañamarca,12,Diciembre,1,0,0,0,0,0,0,0,0,0,0,0,0,0,0,0,0,0,0,0,Sitio Arqueológico
20240315,2022,2,Ancash,Sitio Arqueologico Pañamarca,12,Diciembre,2,0,0,0,0,0,0,0,0,0,0,0,0,0,0,0,0,0,0,0,Sitio Arqueológico
20240315,2022,3,Apurimac,Sitio Arqueologico Saihuite,1,Enero,0,0,0,0,0,0,133,170,60,363,0,0,0,0,2,14,8,42,66,429,Sitio Arqueológico
20240315,2022,3,Apurimac,Sitio Arqueologico Saihuite,1,Enero,1,0,0,0,0,0,0,0,0,0,0,0,0,0,0,0,0,0,0,0,Sitio Arqueológico
20240315,2022,3,Apurimac,Sitio Arqueologico Saihuite,1,Enero,2,0,0,0,0,0,133,170,60,363,0,0,0,0,2,14,8,42,66,429,Sitio Arqueológico
20240315,2022,3,Apurimac,Sitio Arqueologico Saihuite,2,Febrero,0,0,0,0,0,0,146,128,57,331,0,0,0,0,4,40,6,8,58,389,Sitio Arqueológico
20240315,2022,3,Apurimac,Sitio Arqueologico Saihuite,2,Febrero,1,0,0,0,0,0,0,0,0,0,0,0,0,0,0,0,0,0,0,0,Sitio Arqueológico
20240315,2022,3,Apurimac,Sitio Arqueologico Saihuite,2,Febrero,2,0,0,0,0,0,146,128,57,331,0,0,0,0,4,40,6,8,58,389,Sitio Arqueológico
20240315,2022,3,Apurimac,Sitio Arqueologico Saihuite,3,Marzo,0,0,0,0,0,0,202,170,15,387,0,0,0,0,4,18,13,10,45,432,Sitio Arqueológico
20240315,2022,3,Apurimac,Sitio Arqueologico Saihuite,3,Marzo,1,0,0,0,0,0,0,0,0,0,0,0,0,0,0,0,0,0,0,0,Sitio Arqueológico
20240315,2022,3,Apurimac,Sitio Arqueologico Saihuite,3,Marzo,2,0,0,0,0,0,202,170,15,387,0,0,0,0,4,18,13,10,45,432,Sitio Arqueológico
20240315,2022,3,Apurimac,Sitio Arqueologico Saihuite,4,Abril,0,0,0,0,0,0,336,297,37,670,0,0,0,0,8,10,8,8,34,704,Sitio Arqueológico
20240315,2022,3,Apurimac,Sitio Arqueologico Saihuite,4,Abril,1,0,0,0,0,0,0,0,0,0,0,0,0,0,0,0,0,0,0,0,Sitio Arqueológico
20240315,2022,3,Apurimac,Sitio Arqueologico Saihuite,4,Abril,2,0,0,0,0,0,336,297,37,670,0,0,0,0,8,10,8,8,34,704,Sitio Arqueológico
20240315,2022,3,Apurimac,Sitio Arqueologico Saihuite,5,Mayo,0,0,0,0,0,0,293,113,10,416,0,0,0,0,0,0,0,0,0,416,Sitio Arqueológico
20240315,2022,3,Apurimac,Sitio Arqueologico Saihuite,5,Mayo,1,0,0,0,0,11,17,13,16,57,0,0,0,0,0,0,0,0,0,57,Sitio Arqueológico
20240315,2022,3,Apurimac,Sitio Arqueologico Saihuite,5,Mayo,2,0,0,0,0,11,310,126,26,473,0,0,0,0,0,0,0,0,0,473,Sitio Arqueológico
20240315,2022,3,Apurimac,Sitio Arqueologico Saihuite,6,Junio,0,0,0,0,0,0,185,136,17,338,0,0,0,0,0,0,0,0,0,338,Sitio Arqueológico
20240315,2022,3,Apurimac,Sitio Arqueologico Saihuite,6,Junio,1,0,0,0,0,12,17,16,20,65,0,0,0,0,0,0,0,0,0,65,Sitio Arqueológico
20240315,2022,3,Apurimac,Sitio Arqueologico Saihuite,6,Junio,2,0,0,0,0,12,202,152,37,403,0,0,0,0,0,0,0,0,0,403,Sitio Arqueológico
20240315,2022,3,Apurimac,Sitio Arqueologico Saihuite,7,Julio,0,0,0,0,0,0,442,354,104,900,0,0,0,3,3,21,21,14,62,962,Sitio Arqueológico
20240315,2022,3,Apurimac,Sitio Arqueologico Saihuite,7,Julio,1,0,0,0,0,0,0,0,0,0,0,0,0,0,0,0,0,0,0,0,Sitio Arqueológico
20240315,2022,3,Apurimac,Sitio Arqueologico Saihuite,7,Julio,2,0,0,0,0,0,442,354,104,900,0,0,0,3,3,21,21,14,62,962,Sitio Arqueológico
20240315,2022,3,Apurimac,Sitio Arqueologico Saihuite,8,Agosto,0,0,0,0,0,0,403,312,106,821,0,0,0,0,4,18,16,7,45,866,Sitio Arqueológico
20240315,2022,3,Apurimac,Sitio Arqueologico Saihuite,8,Agosto,1,0,0,0,0,0,0,0,0,0,0,0,0,0,0,0,0,0,0,0,Sitio Arqueológico
20240315,2022,3,Apurimac,Sitio Arqueologico Saihuite,8,Agosto,2,0,0,0,0,0,403,312,106,821,0,0,0,0,4,18,16,7,45,866,Sitio Arqueológico
20240315,2022,3,Apurimac,Sitio Arqueologico Saihuite,9,Setiembre,0,0,0,0,0,0,247,280,41,568,0,0,0,0,3,50,5,7,65,633,Sitio Arqueológico
20240315,2022,3,Apurimac,Sitio Arqueologico Saihuite,9,Setiembre,1,0,0,0,0,0,0,0,0,0,0,0,0,0,0,0,0,0,0,0,Sitio Arqueológico
20240315,2022,3,Apurimac,Sitio Arqueologico Saihuite,9,Setiembre,2,0,0,0,0,0,247,280,41,568,0,0,0,0,3,50,5,7,65,633,Sitio Arqueológico
20240315,2022,3,Apurimac,Sitio Arqueologico Saihuite,10,Octubre,0,0,0,0,0,47,271,216,236,770,0,0,0,0,1,16,3,1,21,791,Sitio Arqueológico
20240315,2022,3,Apurimac,Sitio Arqueologico Saihuite,10,Octubre,1,0,0,0,0,0,0,0,0,0,0,0,0,0,0,0,0,0,0,0,Sitio Arqueológico
20240315,2022,3,Apurimac,Sitio Arqueologico Saihuite,10,Octubre,2,0,0,0,0,47,271,216,236,770,0,0,0,0,1,16,3,1,21,791,Sitio Arqueológico
20240315,2022,3,Apurimac,Sitio Arqueologico Saihuite,11,Noviembre,0,0,0,0,0,79,236,82,322,719,0,0,0,0,3,11,0,37,51,770,Sitio Arqueológico
20240315,2022,3,Apurimac,Sitio Arqueologico Saihuite,11,Noviembre,1,0,0,0,0,0,0,0,0,0,0,0,0,0,0,0,0,0,0,0,Sitio Arqueológico
20240315,2022,3,Apurimac,Sitio Arqueologico Saihuite,11,Noviembre,2,0,0,0,0,79,236,82,322,719,0,0,0,0,3,11,0,37,51,770,Sitio Arqueológico
20240315,2022,3,Apurimac,Sitio Arqueologico Saihuite,12,Diciembre,0,0,0,0,0,13,100,43,99,255,0,0,0,0,2,58,0,31,91,346,Sitio Arqueológico
20240315,2022,3,Apurimac,Sitio Arqueologico Saihuite,12,Diciembre,1,0,0,0,0,0,0,0,0,0,0,0,0,0,0,0,0,0,0,0,Sitio Arqueológico
20240315,2022,3,Apurimac,Sitio Arqueologico Saihuite,12,Diciembre,2,0,0,0,0,13,100,43,99,255,0,0,0,0,2,58,0,31,91,346,Sitio Arqueológico
20240315,2022,4,Arequipa,Complejo Arqueologico Toro Muerto,1,Enero,0,0,0,0,0,0,90,16,9,115,0,0,0,0,0,0,0,0,0,115,Sitio Arqueológico
20240315,2022,4,Arequipa,Complejo Arqueologico Toro Muerto,1,Enero,1,0,0,0,0,0,0,0,0,0,0,0,0,0,0,0,0,0,0,0,Sitio Arqueológico
20240315,2022,4,Arequipa,Complejo Arqueologico Toro Muerto,1,Enero,2,0,0,0,0,0,90,16,9,115,0,0,0,0,0,0,0,0,0,115,Sitio Arqueológico
20240315,2022,4,Arequipa,Complejo Arqueologico Toro Muerto,2,Febrero,0,0,0,0,0,0,62,6,11,79,0,0,0,0,0,0,0,0,0,79,Sitio Arqueológico
20240315,2022,4,Arequipa,Complejo Arqueologico Toro Muerto,2,Febrero,1,0,0,0,0,0,0,0,0,0,0,0,0,0,0,0,0,0,0,0,Sitio Arqueológico
20240315,2022,4,Arequipa,Complejo Arqueologico Toro Muerto,2,Febrero,2,0,0,0,0,0,62,6,11,79,0,0,0,0,0,0,0,0,0,79,Sitio Arqueológico
20240315,2022,4,Arequipa,Complejo Arqueologico Toro Muerto,3,Marzo,0,0,0,0,0,0,77,17,9,103,0,0,0,0,0,19,4,13,36,139,Sitio Arqueológico
20240315,2022,4,Arequipa,Complejo Arqueologico Toro Muerto,3,Marzo,1,0,0,0,0,0,0,0,0,0,0,0,0,0,0,0,0,0,0,0,Sitio Arqueológico
20240315,2022,4,Arequipa,Complejo Arqueologico Toro Muerto,3,Marzo,2,0,0,0,0,0,77,17,9,103,0,0,0,0,0,19,4,13,36,139,Sitio Arqueológico
20240315,2022,4,Arequipa,Complejo Arqueologico Toro Muerto,4,Abril,0,0,0,0,0,0,232,54,86,372,0,0,0,0,0,5,0,0,5,377,Sitio Arqueológico
20240315,2022,4,Arequipa,Complejo Arqueologico Toro Muerto,4,Abril,1,0,0,0,0,0,0,0,0,0,0,0,0,0,0,0,0,0,0,0,Sitio Arqueológico
20240315,2022,4,Arequipa,Complejo Arqueologico Toro Muerto,4,Abril,2,0,0,0,0,0,232,54,86,372,0,0,0,0,0,5,0,0,5,377,Sitio Arqueológico
20240315,2022,4,Arequipa,Complejo Arqueologico Toro Muerto,5,Mayo,0,0,0,0,0,0,118,20,25,163,0,0,0,0,0,14,0,6,20,183,Sitio Arqueológico
20240315,2022,4,Arequipa,Complejo Arqueologico Toro Muerto,5,Mayo,1,0,0,0,0,0,0,0,0,0,0,0,0,0,0,0,0,0,0,0,Sitio Arqueológico
20240315,2022,4,Arequipa,Complejo Arqueologico Toro Muerto,5,Mayo,2,0,0,0,0,0,118,20,25,163,0,0,0,0,0,14,0,6,20,183,Sitio Arqueológico
20240315,2022,4,Arequipa,Complejo Arqueologico Toro Muerto,6,Junio,0,0,0,0,0,0,157,25,14,196,0,0,0,0,0,30,0,2,32,228,Sitio Arqueológico
20240315,2022,4,Arequipa,Complejo Arqueologico Toro Muerto,6,Junio,1,0,0,0,0,0,0,0,0,0,0,0,0,0,0,0,0,0,0,0,Sitio Arqueológico
20240315,2022,4,Arequipa,Complejo Arqueologico Toro Muerto,6,Junio,2,0,0,0,0,0,157,25,14,196,0,0,0,0,0,30,0,2,32,228,Sitio Arqueológico
20240315,2022,4,Arequipa,Complejo Arqueologico Toro Muerto,7,Julio,0,0,0,0,0,0,365,64,137,566,0,0,0,0,0,12,2,30,44,610,Sitio Arqueológico
20240315,2022,4,Arequipa,Complejo Arqueologico Toro Muerto,7,Julio,1,0,0,0,0,0,0,0,0,0,0,0,0,0,0,0,0,0,0,0,Sitio Arqueológico
20240315,2022,4,Arequipa,Complejo Arqueologico Toro Muerto,7,Julio,2,0,0,0,0,0,365,64,137,566,0,0,0,0,0,12,2,30,44,610,Sitio Arqueológico
20240315,2022,4,Arequipa,Complejo Arqueologico Toro Muerto,8,Agosto,0,0,0,0,0,0,261,21,110,392,0,0,0,0,0,55,15,8,78,470,Sitio Arqueológico
20240315,2022,4,Arequipa,Complejo Arqueologico Toro Muerto,8,Agosto,1,0,0,0,0,0,0,0,0,0,0,0,0,0,0,0,0,0,0,0,Sitio Arqueológico
20240315,2022,4,Arequipa,Complejo Arqueologico Toro Muerto,8,Agosto,2,0,0,0,0,0,261,21,110,392,0,0,0,0,0,55,15,8,78,470,Sitio Arqueológico
20240315,2022,4,Arequipa,Complejo Arqueologico Toro Muerto,9,Setiembre,0,0,0,0,0,0,88,10,180,278,0,0,0,0,0,30,0,8,38,316,Sitio Arqueológico
20240315,2022,4,Arequipa,Complejo Arqueologico Toro Muerto,9,Setiembre,1,0,0,0,0,0,0,0,0,0,0,0,0,0,0,0,0,0,0,0,Sitio Arqueológico
20240315,2022,4,Arequipa,Complejo Arqueologico Toro Muerto,9,Setiembre,2,0,0,0,0,0,88,10,180,278,0,0,0,0,0,30,0,8,38,316,Sitio Arqueológico
20240315,2022,4,Arequipa,Complejo Arqueologico Toro Muerto,10,Octubre,0,0,0,0,0,0,181,46,20,247,0,0,0,0,0,0,0,0,0,247,Sitio Arqueológico
20240315,2022,4,Arequipa,Complejo Arqueologico Toro Muerto,10,Octubre,1,0,0,0,0,0,0,0,0,0,0,0,0,0,0,0,0,0,0,0,Sitio Arqueológico
20240315,2022,4,Arequipa,Complejo Arqueologico Toro Muerto,10,Octubre,2,0,0,0,0,0,181,46,20,247,0,0,0,0,0,0,0,0,0,247,Sitio Arqueológico
20240315,2022,4,Arequipa,Complejo Arqueologico Toro Muerto,11,Noviembre,0,0,0,0,0,0,120,7,96,223,0,0,0,0,0,0,0,0,0,223,Sitio Arqueológico
20240315,2022,4,Arequipa,Complejo Arqueologico Toro Muerto,11,Noviembre,1,0,0,0,0,0,0,0,0,0,0,0,0,0,0,0,0,0,0,0,Sitio Arqueológico
20240315,2022,4,Arequipa,Complejo Arqueologico Toro Muerto,11,Noviembre,2,0,0,0,0,0,120,7,96,223,0,0,0,0,0,0,0,0,0,223,Sitio Arqueológico
20240315,2022,4,Arequipa,Complejo Arqueologico Toro Muerto,12,Diciembre,0,0,0,0,0,0,16,3,25,44,0,0,0,0,0,16,5,8,29,73,Sitio Arqueológico
20240315,2022,4,Arequipa,Complejo Arqueologico Toro Muerto,12,Diciembre,1,0,0,0,0,0,0,0,0,0,0,0,0,0,0,0,0,0,0,0,Sitio Arqueológico
20240315,2022,4,Arequipa,Complejo Arqueologico Toro Muerto,12,Diciembre,2,0,0,0,0,0,16,3,25,44,0,0,0,0,0,16,5,8,29,73,Sitio Arqueológico
20240315,2022,4,Arequipa,Complejo Arqueologico de Uyo Uyo,1,Enero,0,0,0,0,0,0,19,1,0,20,0,0,0,0,0,0,0,0,0,20,Sitio Arqueológico
20240315,2022,4,Arequipa,Complejo Arqueologico de Uyo Uyo,1,Enero,1,0,0,0,0,0,0,0,0,0,0,0,0,0,0,0,0,0,0,0,Sitio Arqueológico
20240315,2022,4,Arequipa,Complejo Arqueologico de Uyo Uyo,1,Enero,2,0,0,0,0,0,19,1,0,20,0,0,0,0,0,0,0,0,0,20,Sitio Arqueológico
20240315,2022,4,Arequipa,Complejo Arqueologico de Uyo Uyo,2,Febrero,0,0,0,0,0,0,0,0,0,0,0,0,0,0,0,0,0,0,0,0,Sitio Arqueológico
20240315,2022,4,Arequipa,Complejo Arqueologico de Uyo Uyo,2,Febrero,1,0,0,0,0,0,0,0,0,0,0,0,0,0,0,0,0,0,0,0,Sitio Arqueológico
20240315,2022,4,Arequipa,Complejo Arqueologico de Uyo Uyo,2,Febrero,2,0,0,0,0,0,0,0,0,0,0,0,0,0,0,0,0,0,0,0,Sitio Arqueológico
20240315,2022,4,Arequipa,Complejo Arqueologico de Uyo Uyo,3,Marzo,0,0,0,0,0,0,25,0,0,25,0,0,0,0,0,2,0,3,5,30,Sitio Arqueológico
20240315,2022,4,Arequipa,Complejo Arqueologico de Uyo Uyo,3,Marzo,1,0,0,0,0,0,0,0,0,0,0,0,0,0,0,0,0,0,0,0,Sitio Arqueológico
20240315,2022,4,Arequipa,Complejo Arqueologico de Uyo Uyo,3,Marzo,2,0,0,0,0,0,25,0,0,25,0,0,0,0,0,2,0,3,5,30,Sitio Arqueológico
20240315,2022,4,Arequipa,Complejo Arqueologico de Uyo Uyo,4,Abril,0,0,0,0,0,0,33,9,0,42,0,0,0,0,0,0,0,0,0,42,Sitio Arqueológico
20240315,2022,4,Arequipa,Complejo Arqueologico de Uyo Uyo,4,Abril,1,0,0,0,0,0,0,0,0,0,0,0,0,0,0,0,0,0,0,0,Sitio Arqueológico
20240315,2022,4,Arequipa,Complejo Arqueologico de Uyo Uyo,4,Abril,2,0,0,0,0,0,33,9,0,42,0,0,0,0,0,0,0,0,0,42,Sitio Arqueológico
20240315,2022,4,Arequipa,Complejo Arqueologico de Uyo Uyo,5,Mayo,0,0,0,0,0,0,33,0,0,33,0,0,0,0,0,5,0,1,6,39,Sitio Arqueológico
20240315,2022,4,Arequipa,Complejo Arqueologico de Uyo Uyo,5,Mayo,1,0,0,0,0,0,0,0,0,0,0,0,0,0,0,0,0,0,0,0,Sitio Arqueológico
20240315,2022,4,Arequipa,Complejo Arqueologico de Uyo Uyo,5,Mayo,2,0,0,0,0,0,33,0,0,33,0,0,0,0,0,5,0,1,6,39,Sitio Arqueológico
20240315,2022,4,Arequipa,Complejo Arqueologico de Uyo Uyo,6,Junio,0,0,0,0,0,0,17,1,0,18,0,0,0,0,0,6,0,1,7,25,Sitio Arqueológico
20240315,2022,4,Arequipa,Complejo Arqueologico de Uyo Uyo,6,Junio,1,0,0,0,0,0,0,0,0,0,0,0,0,0,0,0,0,0,0,0,Sitio Arqueológico
20240315,2022,4,Arequipa,Complejo Arqueologico de Uyo Uyo,6,Junio,2,0,0,0,0,0,17,1,0,18,0,0,0,0,0,6,0,1,7,25,Sitio Arqueológico
20240315,2022,4,Arequipa,Complejo Arqueologico de Uyo Uyo,7,Julio,0,0,0,0,0,0,41,0,0,41,0,0,0,0,0,3,0,0,3,44,Sitio Arqueológico
20240315,2022,4,Arequipa,Complejo Arqueologico de Uyo Uyo,7,Julio,1,0,0,0,0,0,0,0,0,0,0,0,0,0,0,0,0,0,0,0,Sitio Arqueológico
20240315,2022,4,Arequipa,Complejo Arqueologico de Uyo Uyo,7,Julio,2,0,0,0,0,0,41,0,0,41,0,0,0,0,0,3,0,0,3,44,Sitio Arqueológico
20240315,2022,4,Arequipa,Complejo Arqueologico de Uyo Uyo,8,Agosto,0,0,0,0,0,0,43,0,0,43,0,0,0,0,0,8,0,9,17,60,Sitio Arqueológico
20240315,2022,4,Arequipa,Complejo Arqueologico de Uyo Uyo,8,Agosto,1,0,0,0,0,0,0,0,0,0,0,0,0,0,0,0,0,0,0,0,Sitio Arqueológico
20240315,2022,4,Arequipa,Complejo Arqueologico de Uyo Uyo,8,Agosto,2,0,0,0,0,0,43,0,0,43,0,0,0,0,0,8,0,9,17,60,Sitio Arqueológico
20240315,2022,4,Arequipa,Complejo Arqueologico de Uyo Uyo,9,Setiembre,0,0,0,0,0,0,19,0,0,19,0,0,0,0,0,0,0,0,0,19,Sitio Arqueológico
20240315,2022,4,Arequipa,Complejo Arqueologico de Uyo Uyo,9,Setiembre,1,0,0,0,0,0,0,0,0,0,0,0,0,0,0,0,0,0,0,0,Sitio Arqueológico
20240315,2022,4,Arequipa,Complejo Arqueologico de Uyo Uyo,9,Setiembre,2,0,0,0,0,0,19,0,0,19,0,0,0,0,0,0,0,0,0,19,Sitio Arqueológico
20240315,2022,4,Arequipa,Complejo Arqueologico de Uyo Uyo,10,Octubre,0,0,0,0,0,0,36,0,0,36,0,0,0,0,0,0,0,0,0,36,Sitio Arqueológico
20240315,2022,4,Arequipa,Complejo Arqueologico de Uyo Uyo,10,Octubre,1,0,0,0,0,0,0,0,0,0,0,0,0,0,0,0,0,0,0,0,Sitio Arqueológico
20240315,2022,4,Arequipa,Complejo Arqueologico de Uyo Uyo,10,Octubre,2,0,0,0,0,0,36,0,0,36,0,0,0,0,0,0,0,0,0,36,Sitio Arqueológico
20240315,2022,4,Arequipa,Complejo Arqueologico de Uyo Uyo,11,Noviembre,0,0,0,0,0,0,21,0,0,21,0,0,0,0,0,0,0,0,0,21,Sitio Arqueológico
20240315,2022,4,Arequipa,Complejo Arqueologico de Uyo Uyo,11,Noviembre,1,0,0,0,0,0,0,0,0,0,0,0,0,0,0,0,0,0,0,0,Sitio Arqueológico
20240315,2022,4,Arequipa,Complejo Arqueologico de Uyo Uyo,11,Noviembre,2,0,0,0,0,0,21,0,0,21,0,0,0,0,0,0,0,0,0,21,Sitio Arqueológico
20240315,2022,4,Arequipa,Complejo Arqueologico de Uyo Uyo,12,Diciembre,0,0,0,0,0,0,10,0,0,10,0,0,0,0,0,0,0,0,0,10,Sitio Arqueológico
20240315,2022,4,Arequipa,Complejo Arqueologico de Uyo Uyo,12,Diciembre,1,0,0,0,0,0,0,0,0,0,0,0,0,0,0,0,0,0,0,0,Sitio Arqueológico
20240315,2022,4,Arequipa,Complejo Arqueologico de Uyo Uyo,12,Diciembre,2,0,0,0,0,0,10,0,0,10,0,0,0,0,0,0,0,0,0,10,Sitio Arqueológico
20240315,2022,5,Ayacucho,Sitio Arqueologico Intihuatana,1,Enero,0,0,0,0,0,0,2230,694,199,3123,0,0,0,0,0,260,68,18,346,3469,Sitio Arqueológico
20240315,2022,5,Ayacucho,Sitio Arqueologico Intihuatana,1,Enero,1,0,0,0,0,0,0,0,0,0,0,0,0,0,0,0,0,0,0,0,Sitio Arqueológico
20240315,2022,5,Ayacucho,Sitio Arqueologico Intihuatana,1,Enero,2,0,0,0,0,0,2230,694,199,3123,0,0,0,0,0,260,68,18,346,3469,Sitio Arqueológico
20240315,2022,5,Ayacucho,Sitio Arqueologico Intihuatana,2,Febrero,0,0,0,0,0,0,2112,933,314,3359,0,0,0,0,0,124,8,13,145,3504,Sitio Arqueológico
20240315,2022,5,Ayacucho,Sitio Arqueologico Intihuatana,2,Febrero,1,0,0,0,0,0,0,0,0,0,0,0,0,0,0,0,0,0,0,0,Sitio Arqueológico
20240315,2022,5,Ayacucho,Sitio Arqueologico Intihuatana,2,Febrero,2,0,0,0,0,0,2112,933,314,3359,0,0,0,0,0,124,8,13,145,3504,Sitio Arqueológico
20240315,2022,5,Ayacucho,Sitio Arqueologico Intihuatana,3,Marzo,0,0,0,0,0,0,1287,618,111,2016,0,0,0,0,0,89,60,9,158,2174,Sitio Arqueológico
20240315,2022,5,Ayacucho,Sitio Arqueologico Intihuatana,3,Marzo,1,0,0,0,0,0,0,0,0,0,0,0,0,0,0,0,0,0,0,0,Sitio Arqueológico
20240315,2022,5,Ayacucho,Sitio Arqueologico Intihuatana,3,Marzo,2,0,0,0,0,0,1287,618,111,2016,0,0,0,0,0,89,60,9,158,2174,Sitio Arqueológico
20240315,2022,5,Ayacucho,Sitio Arqueologico Intihuatana,4,Abril,0,0,0,0,0,0,2713,1917,4571,9201,0,0,0,0,0,93,30,15,138,9339,Sitio Arqueológico
20240315,2022,5,Ayacucho,Sitio Arqueologico Intihuatana,4,Abril,1,0,0,0,0,0,93,30,15,138,0,0,0,0,0,0,0,0,0,138,Sitio Arqueológico
20240315,2022,5,Ayacucho,Sitio Arqueologico Intihuatana,4,Abril,2,0,0,0,0,0,2806,1947,4586,9339,0,0,0,0,0,93,30,15,138,9477,Sitio Arqueológico
20240315,2022,5,Ayacucho,Sitio Arqueologico Intihuatana,5,Mayo,0,0,0,0,0,0,691,275,5647,6613,0,0,0,0,0,204,58,59,321,6934,Sitio Arqueológico
20240315,2022,5,Ayacucho,Sitio Arqueologico Intihuatana,5,Mayo,1,0,0,0,0,0,204,58,59,321,0,0,0,0,0,0,0,0,0,321,Sitio Arqueológico
20240315,2022,5,Ayacucho,Sitio Arqueologico Intihuatana,5,Mayo,2,0,0,0,0,0,895,333,5706,6934,0,0,0,0,0,204,58,59,321,7255,Sitio Arqueológico
20240315,2022,5,Ayacucho,Sitio Arqueologico Intihuatana,6,Junio,0,0,0,0,0,0,1372,524,0,1896,0,0,0,0,0,117,9,7,133,2029,Sitio Arqueológico
20240315,2022,5,Ayacucho,Sitio Arqueologico Intihuatana,6,Junio,1,0,0,0,0,0,0,0,0,0,0,0,0,0,0,0,0,0,0,0,Sitio Arqueológico
20240315,2022,5,Ayacucho,Sitio Arqueologico Intihuatana,6,Junio,2,0,0,0,0,0,1372,524,0,1896,0,0,0,0,0,117,9,7,133,2029,Sitio Arqueológico
20240315,2022,5,Ayacucho,Sitio Arqueologico Intihuatana,7,Julio,0,0,0,0,0,0,3281,993,301,4575,0,0,0,0,0,77,10,3,90,4665,Sitio Arqueológico
20240315,2022,5,Ayacucho,Sitio Arqueologico Intihuatana,7,Julio,1,0,0,0,0,0,0,0,0,0,0,0,0,0,0,0,0,0,0,0,Sitio Arqueológico
20240315,2022,5,Ayacucho,Sitio Arqueologico Intihuatana,7,Julio,2,0,0,0,0,0,3281,993,301,4575,0,0,0,0,0,77,10,3,90,4665,Sitio Arqueológico
20240315,2022,5,Ayacucho,Sitio Arqueologico Intihuatana,8,Agosto,0,0,0,0,0,0,2157,2164,455,4776,0,0,0,0,0,134,45,54,233,5009,Sitio Arqueológico
20240315,2022,5,Ayacucho,Sitio Arqueologico Intihuatana,8,Agosto,1,0,0,0,0,0,0,0,0,0,0,0,0,0,0,0,0,0,0,0,Sitio Arqueológico
20240315,2022,5,Ayacucho,Sitio Arqueologico Intihuatana,8,Agosto,2,0,0,0,0,0,2157,2164,455,4776,0,0,0,0,0,134,45,54,233,5009,Sitio Arqueológico
20240315,2022,5,Ayacucho,Sitio Arqueologico Intihuatana,9,Setiembre,0,0,0,0,0,0,1089,538,2286,3913,0,0,0,0,0,131,6,91,228,4141,Sitio Arqueológico
20240315,2022,5,Ayacucho,Sitio Arqueologico Intihuatana,9,Setiembre,1,0,0,0,0,0,0,0,0,0,0,0,0,0,0,0,0,0,0,0,Sitio Arqueológico
20240315,2022,5,Ayacucho,Sitio Arqueologico Intihuatana,9,Setiembre,2,0,0,0,0,0,1089,538,2286,3913,0,0,0,0,0,131,6,91,228,4141,Sitio Arqueológico
20240315,2022,5,Ayacucho,Sitio Arqueologico Intihuatana,10,Octubre,0,0,0,0,0,0,1879,1150,589,3618,0,0,0,0,0,126,8,6,140,3758,Sitio Arqueológico
20240315,2022,5,Ayacucho,Sitio Arqueologico Intihuatana,10,Octubre,1,0,0,0,0,0,0,0,0,0,0,0,0,0,0,0,0,0,0,0,Sitio Arqueológico
20240315,2022,5,Ayacucho,Sitio Arqueologico Intihuatana,10,Octubre,2,0,0,0,0,0,1879,1150,589,3618,0,0,0,0,0,126,8,6,140,3758,Sitio Arqueológico
20240315,2022,5,Ayacucho,Sitio Arqueologico Intihuatana,11,Noviembre,0,0,0,0,0,0,1122,842,704,2668,0,0,0,0,0,127,9,17,153,2821,Sitio Arqueológico
20240315,2022,5,Ayacucho,Sitio Arqueologico Intihuatana,11,Noviembre,1,0,0,0,0,0,0,0,0,0,0,0,0,0,0,0,0,0,0,0,Sitio Arqueológico
20240315,2022,5,Ayacucho,Sitio Arqueologico Intihuatana,11,Noviembre,2,0,0,0,0,0,1122,842,704,2668,0,0,0,0,0,127,9,17,153,2821,Sitio Arqueológico
20240315,2022,5,Ayacucho,Sitio Arqueologico Intihuatana,12,Diciembre,0,0,0,0,0,0,806,463,325,1594,0,0,0,0,0,112,85,23,220,1814,Sitio Arqueológico
20240315,2022,5,Ayacucho,Sitio Arqueologico Intihuatana,12,Diciembre,1,0,0,0,0,0,0,0,0,0,0,0,0,0,0,0,0,0,0,0,Sitio Arqueológico
20240315,2022,5,Ayacucho,Sitio Arqueologico Intihuatana,12,Diciembre,2,0,0,0,0,0,806,463,325,1594,0,0,0,0,0,112,85,23,220,1814,Sitio Arqueológico
20240315,2022,6,Cajamarca,Paisaje Cultural Arqueologico Cumbemayo,1,Enero,0,0,0,0,39,228,1788,434,720,3209,0,0,0,5,25,303,46,90,469,3678,Sitio Arqueológico
20240315,2022,6,Cajamarca,Paisaje Cultural Arqueologico Cumbemayo,1,Enero,1,0,0,0,0,18,65,17,16,116,0,0,0,0,0,0,0,0,0,116,Sitio Arqueológico
20240315,2022,6,Cajamarca,Paisaje Cultural Arqueologico Cumbemayo,1,Enero,2,0,0,0,39,246,1853,451,736,3325,0,0,0,5,25,303,46,90,469,3794,Sitio Arqueológico
20240315,2022,6,Cajamarca,Paisaje Cultural Arqueologico Cumbemayo,2,Febrero,0,0,0,0,60,0,1766,784,721,3331,0,0,0,0,18,187,43,51,299,3630,Sitio Arqueológico
20240315,2022,6,Cajamarca,Paisaje Cultural Arqueologico Cumbemayo,2,Febrero,1,0,0,0,0,0,51,13,0,64,0,0,0,0,0,0,0,0,0,64,Sitio Arqueológico
20240315,2022,6,Cajamarca,Paisaje Cultural Arqueologico Cumbemayo,2,Febrero,2,0,0,0,60,0,1817,797,721,3395,0,0,0,0,18,187,43,51,299,3694,Sitio Arqueológico
20240315,2022,6,Cajamarca,Paisaje Cultural Arqueologico Cumbemayo,3,Marzo,0,0,0,0,31,185,967,309,226,1718,0,0,0,2,25,138,39,55,259,1977,Sitio Arqueológico
20240315,2022,6,Cajamarca,Paisaje Cultural Arqueologico Cumbemayo,3,Marzo,1,0,0,0,0,7,64,35,1,107,0,0,0,0,0,0,0,0,0,107,Sitio Arqueológico
20240315,2022,6,Cajamarca,Paisaje Cultural Arqueologico Cumbemayo,3,Marzo,2,0,0,0,31,192,1031,344,227,1825,0,0,0,2,25,138,39,55,259,2084,Sitio Arqueológico
20240315,2022,6,Cajamarca,Paisaje Cultural Arqueologico Cumbemayo,4,Abril,0,0,0,0,29,189,1594,445,310,2567,0,0,0,0,39,59,18,19,135,2702,Sitio Arqueológico
20240315,2022,6,Cajamarca,Paisaje Cultural Arqueologico Cumbemayo,4,Abril,1,0,0,0,0,0,75,10,0,85,0,0,0,0,0,0,0,0,0,85,Sitio Arqueológico
20240315,2022,6,Cajamarca,Paisaje Cultural Arqueologico Cumbemayo,4,Abril,2,0,0,0,29,189,1669,455,310,2652,0,0,0,0,39,59,18,19,135,2787,Sitio Arqueológico
20240315,2022,6,Cajamarca,Paisaje Cultural Arqueologico Cumbemayo,5,Mayo,0,0,0,0,26,25,1150,567,390,2158,0,0,0,0,21,212,25,50,308,2466,Sitio Arqueológico
20240315,2022,6,Cajamarca,Paisaje Cultural Arqueologico Cumbemayo,5,Mayo,1,0,0,0,0,1,89,31,7,128,0,0,0,0,0,0,0,0,0,128,Sitio Arqueológico
20240315,2022,6,Cajamarca,Paisaje Cultural Arqueologico Cumbemayo,5,Mayo,2,0,0,0,26,26,1239,598,397,2286,0,0,0,0,21,212,25,50,308,2594,Sitio Arqueológico
20240315,2022,6,Cajamarca,Paisaje Cultural Arqueologico Cumbemayo,6,Junio,0,0,0,0,21,239,1286,409,268,2223,0,0,0,4,21,153,33,48,259,2482,Sitio Arqueológico
20240315,2022,6,Cajamarca,Paisaje Cultural Arqueologico Cumbemayo,6,Junio,1,0,0,0,0,0,77,30,1,108,0,0,0,0,0,0,0,0,0,108,Sitio Arqueológico
20240315,2022,6,Cajamarca,Paisaje Cultural Arqueologico Cumbemayo,6,Junio,2,0,0,0,21,239,1363,439,269,2331,0,0,0,4,21,153,33,48,259,2590,Sitio Arqueológico
20240315,2022,6,Cajamarca,Paisaje Cultural Arqueologico Cumbemayo,7,Julio,0,0,0,0,46,456,3002,897,1058,5459,0,0,0,1,15,95,19,25,155,5614,Sitio Arqueológico
20240315,2022,6,Cajamarca,Paisaje Cultural Arqueologico Cumbemayo,7,Julio,1,0,0,0,0,23,212,100,32,367,0,0,0,0,0,0,0,0,0,367,Sitio Arqueológico
20240315,2022,6,Cajamarca,Paisaje Cultural Arqueologico Cumbemayo,7,Julio,2,0,0,0,46,479,3214,997,1090,5826,0,0,0,1,15,95,19,25,155,5981,Sitio Arqueológico
20240315,2022,6,Cajamarca,Paisaje Cultural Arqueologico Cumbemayo,8,Agosto,0,0,0,0,69,450,2544,897,1041,5001,0,0,0,0,57,190,94,83,424,5425,Sitio Arqueológico
20240315,2022,6,Cajamarca,Paisaje Cultural Arqueologico Cumbemayo,8,Agosto,1,0,0,0,0,55,153,84,12,304,0,0,0,0,0,0,0,0,0,304,Sitio Arqueológico
20240315,2022,6,Cajamarca,Paisaje Cultural Arqueologico Cumbemayo,8,Agosto,2,0,0,0,69,505,2697,981,1053,5305,0,0,0,0,57,190,94,83,424,5729,Sitio Arqueológico
20240315,2022,6,Cajamarca,Paisaje Cultural Arqueologico Cumbemayo,9,Setiembre,0,0,0,0,31,519,1564,489,576,3179,0,0,0,2,12,141,17,23,195,3374,Sitio Arqueológico
20240315,2022,6,Cajamarca,Paisaje Cultural Arqueologico Cumbemayo,9,Setiembre,1,0,0,0,0,0,140,51,5,196,0,0,0,0,0,0,0,0,0,196,Sitio Arqueológico
20240315,2022,6,Cajamarca,Paisaje Cultural Arqueologico Cumbemayo,9,Setiembre,2,0,0,0,31,519,1704,540,581,3375,0,0,0,2,12,141,17,23,195,3570,Sitio Arqueológico
20240315,2022,6,Cajamarca,Paisaje Cultural Arqueologico Cumbemayo,10,Octubre,0,0,0,0,40,471,1952,578,2059,5100,0,0,0,0,6,30,7,5,48,5148,Sitio Arqueológico
20240315,2022,6,Cajamarca,Paisaje Cultural Arqueologico Cumbemayo,10,Octubre,1,0,0,0,0,51,203,52,6,312,0,0,0,0,0,0,0,0,0,312,Sitio Arqueológico
20240315,2022,6,Cajamarca,Paisaje Cultural Arqueologico Cumbemayo,10,Octubre,2,0,0,0,40,522,2155,630,2065,5412,0,0,0,0,6,30,7,5,48,5460,Sitio Arqueológico
20240315,2022,6,Cajamarca,Paisaje Cultural Arqueologico Cumbemayo,11,Noviembre,0,0,0,0,12,265,1056,651,930,2914,0,0,0,0,14,191,42,142,389,3303,Sitio Arqueológico
20240315,2022,6,Cajamarca,Paisaje Cultural Arqueologico Cumbemayo,11,Noviembre,1,0,0,0,0,0,93,35,6,134,0,0,0,0,0,0,0,0,0,134,Sitio Arqueológico
20240315,2022,6,Cajamarca,Paisaje Cultural Arqueologico Cumbemayo,11,Noviembre,2,0,0,0,12,265,1149,686,936,3048,0,0,0,0,14,191,42,142,389,3437,Sitio Arqueológico
20240315,2022,6,Cajamarca,Paisaje Cultural Arqueologico Cumbemayo,12,Diciembre,0,0,0,0,6,183,918,528,457,2092,0,0,0,0,18,56,34,40,148,2240,Sitio Arqueológico
20240315,2022,6,Cajamarca,Paisaje Cultural Arqueologico Cumbemayo,12,Diciembre,1,0,0,0,0,33,81,25,5,144,0,0,0,0,0,0,0,0,0,144,Sitio Arqueológico
20240315,2022,6,Cajamarca,Paisaje Cultural Arqueologico Cumbemayo,12,Diciembre,2,0,0,0,6,216,999,553,462,2236,0,0,0,0,18,56,34,40,148,2384,Sitio Arqueológico
20240315,2022,6,Cajamarca,Centro Arqueologico Ventanilla de Otuzco,1,Enero,0,0,0,0,0,0,2297,310,660,3267,0,0,0,2,46,418,39,98,603,3870,Sitio Arqueológico
20240315,2022,6,Cajamarca,Centro Arqueologico Ventanilla de Otuzco,1,Enero,1,0,0,0,0,0,26,2,0,28,0,0,0,0,0,0,0,0,0,28,Sitio Arqueológico
20240315,2022,6,Cajamarca,Centro Arqueologico Ventanilla de Otuzco,1,Enero,2,0,0,0,0,0,2323,312,660,3295,0,0,0,2,46,418,39,98,603,3898,Sitio Arqueológico
20240315,2022,6,Cajamarca,Centro Arqueologico Ventanilla de Otuzco,2,Febrero,0,0,0,0,35,0,3187,552,966,4740,0,0,0,0,47,280,22,83,432,5172,Sitio Arqueológico
20240315,2022,6,Cajamarca,Centro Arqueologico Ventanilla de Otuzco,2,Febrero,1,0,0,0,0,0,52,0,0,52,0,0,0,0,0,0,0,0,0,52,Sitio Arqueológico
20240315,2022,6,Cajamarca,Centro Arqueologico Ventanilla de Otuzco,2,Febrero,2,0,0,0,35,0,3239,552,966,4792,0,0,0,0,47,280,22,83,432,5224,Sitio Arqueológico
20240315,2022,6,Cajamarca,Centro Arqueologico Ventanilla de Otuzco,3,Marzo,0,0,0,0,8,0,1745,337,339,2429,0,0,0,0,23,315,32,84,454,2883,Sitio Arqueológico
20240315,2022,6,Cajamarca,Centro Arqueologico Ventanilla de Otuzco,3,Marzo,1,0,0,0,0,0,35,2,0,37,0,0,0,0,0,0,0,0,0,37,Sitio Arqueológico
20240315,2022,6,Cajamarca,Centro Arqueologico Ventanilla de Otuzco,3,Marzo,2,0,0,0,8,0,1780,339,339,2466,0,0,0,0,23,315,32,84,454,2920,Sitio Arqueológico
20240315,2022,6,Cajamarca,Centro Arqueologico Ventanilla de Otuzco,4,Abril,0,0,0,0,2,0,2765,401,421,3589,0,0,0,0,35,155,11,27,228,3817,Sitio Arqueológico
20240315,2022,6,Cajamarca,Centro Arqueologico Ventanilla de Otuzco,4,Abril,1,0,0,0,0,0,109,0,0,109,0,0,0,0,0,0,0,0,0,109,Sitio Arqueológico
20240315,2022,6,Cajamarca,Centro Arqueologico Ventanilla de Otuzco,4,Abril,2,0,0,0,2,0,2874,401,421,3698,0,0,0,0,35,155,11,27,228,3926,Sitio Arqueológico
20240315,2022,6,Cajamarca,Centro Arqueologico Ventanilla de Otuzco,5,Mayo,0,0,0,0,0,35,1992,357,447,2831,0,0,0,0,24,216,18,46,304,3135,Sitio Arqueológico
20240315,2022,6,Cajamarca,Centro Arqueologico Ventanilla de Otuzco,5,Mayo,1,0,0,0,0,0,100,12,0,112,0,0,0,0,0,0,0,0,0,112,Sitio Arqueológico
20240315,2022,6,Cajamarca,Centro Arqueologico Ventanilla de Otuzco,5,Mayo,2,0,0,0,0,35,2092,369,447,2943,0,0,0,0,24,216,18,46,304,3247,Sitio Arqueológico
20240315,2022,6,Cajamarca,Centro Arqueologico Ventanilla de Otuzco,6,Junio,0,0,0,0,39,329,143,4421,2116,7048,0,0,0,0,34,268,36,82,420,7468,Sitio Arqueológico
20240315,2022,6,Cajamarca,Centro Arqueologico Ventanilla de Otuzco,6,Junio,1,0,0,0,0,1,103,2,47,153,0,0,0,0,0,0,0,0,0,153,Sitio Arqueológico
20240315,2022,6,Cajamarca,Centro Arqueologico Ventanilla de Otuzco,6,Junio,2,0,0,0,39,330,246,4423,2163,7201,0,0,0,0,34,268,36,82,420,7621,Sitio Arqueológico
20240315,2022,6,Cajamarca,Centro Arqueologico Ventanilla de Otuzco,7,Julio,0,0,0,0,111,587,4969,913,1912,8492,0,0,0,5,34,171,44,50,304,8796,Sitio Arqueológico
20240315,2022,6,Cajamarca,Centro Arqueologico Ventanilla de Otuzco,7,Julio,1,0,0,0,0,84,274,27,79,464,0,0,0,0,0,0,0,0,0,464,Sitio Arqueológico
20240315,2022,6,Cajamarca,Centro Arqueologico Ventanilla de Otuzco,7,Julio,2,0,0,0,111,671,5243,940,1991,8956,0,0,0,5,34,171,44,50,304,9260,Sitio Arqueológico
20240315,2022,6,Cajamarca,Centro Arqueologico Ventanilla de Otuzco,8,Agosto,0,0,0,0,55,341,5429,751,1717,8293,0,0,0,0,74,525,43,110,752,9045,Sitio Arqueológico
20240315,2022,6,Cajamarca,Centro Arqueologico Ventanilla de Otuzco,8,Agosto,1,0,0,0,0,22,141,24,19,206,0,0,0,0,0,0,0,0,0,206,Sitio Arqueológico
20240315,2022,6,Cajamarca,Centro Arqueologico Ventanilla de Otuzco,8,Agosto,2,0,0,0,55,363,5570,775,1736,8499,0,0,0,0,74,525,43,110,752,9251,Sitio Arqueológico
20240315,2022,6,Cajamarca,Centro Arqueologico Ventanilla de Otuzco,9,Setiembre,0,0,0,0,9,247,2571,419,596,3842,0,0,0,1,36,231,35,58,361,4203,Sitio Arqueológico
20240315,2022,6,Cajamarca,Centro Arqueologico Ventanilla de Otuzco,9,Setiembre,1,0,0,0,0,25,114,9,1,149,0,0,0,0,0,0,0,0,0,149,Sitio Arqueológico
20240315,2022,6,Cajamarca,Centro Arqueologico Ventanilla de Otuzco,9,Setiembre,2,0,0,0,9,272,2685,428,597,3991,0,0,0,1,36,231,35,58,361,4352,Sitio Arqueológico
20240315,2022,6,Cajamarca,Centro Arqueologico Ventanilla de Otuzco,10,Octubre,0,0,0,0,69,354,3528,1142,1915,7008,0,0,0,5,13,102,14,27,161,7169,Sitio Arqueológico
20240315,2022,6,Cajamarca,Centro Arqueologico Ventanilla de Otuzco,10,Octubre,1,0,0,0,0,88,144,14,9,255,0,0,0,0,0,0,0,0,0,255,Sitio Arqueológico
20240315,2022,6,Cajamarca,Centro Arqueologico Ventanilla de Otuzco,10,Octubre,2,0,0,0,69,442,3672,1156,1924,7263,0,0,0,5,13,102,14,27,161,7424,Sitio Arqueológico
20240315,2022,6,Cajamarca,Centro Arqueologico Ventanilla de Otuzco,11,Noviembre,0,0,0,0,29,341,2733,678,1629,5410,0,0,0,0,56,374,53,129,612,6022,Sitio Arqueológico
20240315,2022,6,Cajamarca,Centro Arqueologico Ventanilla de Otuzco,11,Noviembre,1,0,0,0,0,35,117,5,1,158,0,0,0,0,0,0,0,0,0,158,Sitio Arqueológico
20240315,2022,6,Cajamarca,Centro Arqueologico Ventanilla de Otuzco,11,Noviembre,2,0,0,0,29,376,2850,683,1630,5568,0,0,0,0,56,374,53,129,612,6180,Sitio Arqueológico
20240315,2022,6,Cajamarca,Centro Arqueologico Ventanilla de Otuzco,12,Diciembre,0,0,0,0,40,162,1751,250,858,3061,0,0,0,0,35,126,11,84,256,3317,Sitio Arqueológico
20240315,2022,6,Cajamarca,Centro Arqueologico Ventanilla de Otuzco,12,Diciembre,1,0,0,0,0,19,59,0,0,78,0,0,0,0,0,0,0,0,0,78,Sitio Arqueológico
20240315,2022,6,Cajamarca,Centro Arqueologico Ventanilla de Otuzco,12,Diciembre,2,0,0,0,40,181,1810,250,858,3139,0,0,0,0,35,126,11,84,256,3395,Sitio Arqueológico
20240315,2022,6,Cajamarca,Monumento Arqueologico Kuntur Wasi,1,Enero,0,0,0,0,0,0,166,125,56,347,0,0,0,0,0,46,6,19,71,418,Sitio Arqueológico
20240315,2022,6,Cajamarca,Monumento Arqueologico Kuntur Wasi,1,Enero,1,0,0,0,0,0,2,3,0,5,0,0,0,0,0,0,0,0,0,5,Sitio Arqueológico
20240315,2022,6,Cajamarca,Monumento Arqueologico Kuntur Wasi,1,Enero,2,0,0,0,0,0,168,128,56,352,0,0,0,0,0,46,6,19,71,423,Sitio Arqueológico
20240315,2022,6,Cajamarca,Monumento Arqueologico Kuntur Wasi,2,Febrero,0,0,0,0,0,0,72,51,27,150,0,0,0,0,0,24,8,13,45,195,Sitio Arqueológico
20240315,2022,6,Cajamarca,Monumento Arqueologico Kuntur Wasi,2,Febrero,1,0,0,0,0,0,2,0,0,2,0,0,0,0,0,0,0,0,0,2,Sitio Arqueológico
20240315,2022,6,Cajamarca,Monumento Arqueologico Kuntur Wasi,2,Febrero,2,0,0,0,0,0,74,51,27,152,0,0,0,0,0,24,8,13,45,197,Sitio Arqueológico
20240315,2022,6,Cajamarca,Monumento Arqueologico Kuntur Wasi,3,Marzo,0,0,0,0,0,3,57,43,8,111,0,0,0,0,0,8,0,0,8,119,Sitio Arqueológico
20240315,2022,6,Cajamarca,Monumento Arqueologico Kuntur Wasi,3,Marzo,1,0,0,0,0,0,1,1,0,2,0,0,0,0,0,0,0,0,0,2,Sitio Arqueológico
20240315,2022,6,Cajamarca,Monumento Arqueologico Kuntur Wasi,3,Marzo,2,0,0,0,0,3,58,44,8,113,0,0,0,0,0,8,0,0,8,121,Sitio Arqueológico
20240315,2022,6,Cajamarca,Monumento Arqueologico Kuntur Wasi,4,Abril,0,0,0,0,0,13,158,85,45,301,0,0,0,0,1,3,0,0,4,305,Sitio Arqueológico
20240315,2022,6,Cajamarca,Monumento Arqueologico Kuntur Wasi,4,Abril,1,0,0,0,0,0,0,0,0,0,0,0,0,0,0,0,0,0,0,0,Sitio Arqueológico
20240315,2022,6,Cajamarca,Monumento Arqueologico Kuntur Wasi,4,Abril,2,0,0,0,0,13,158,85,45,301,0,0,0,0,1,3,0,0,4,305,Sitio Arqueológico
20240315,2022,6,Cajamarca,Monumento Arqueologico Kuntur Wasi,5,Mayo,0,0,0,0,0,0,116,34,70,220,0,0,0,0,0,26,9,12,47,267,Sitio Arqueológico
20240315,2022,6,Cajamarca,Monumento Arqueologico Kuntur Wasi,5,Mayo,1,0,0,0,0,0,13,0,0,13,0,0,0,0,0,0,0,0,0,13,Sitio Arqueológico
20240315,2022,6,Cajamarca,Monumento Arqueologico Kuntur Wasi,5,Mayo,2,0,0,0,0,0,129,34,70,233,0,0,0,0,0,26,9,12,47,280,Sitio Arqueológico
20240315,2022,6,Cajamarca,Monumento Arqueologico Kuntur Wasi,6,Junio,0,0,0,0,0,4,164,101,40,309,0,0,0,0,4,43,2,25,74,383,Sitio Arqueológico
20240315,2022,6,Cajamarca,Monumento Arqueologico Kuntur Wasi,6,Junio,1,0,0,0,0,0,9,2,0,11,0,0,0,0,0,0,0,0,0,11,Sitio Arqueológico
20240315,2022,6,Cajamarca,Monumento Arqueologico Kuntur Wasi,6,Junio,2,0,0,0,0,4,173,103,40,320,0,0,0,0,4,43,2,25,74,394,Sitio Arqueológico
20240315,2022,6,Cajamarca,Monumento Arqueologico Kuntur Wasi,7,Julio,0,0,0,0,0,25,263,126,155,569,0,0,0,0,1,17,13,8,39,608,Sitio Arqueológico
20240315,2022,6,Cajamarca,Monumento Arqueologico Kuntur Wasi,7,Julio,1,0,0,0,0,1,0,0,1,2,0,0,0,0,0,0,0,0,0,2,Sitio Arqueológico
20240315,2022,6,Cajamarca,Monumento Arqueologico Kuntur Wasi,7,Julio,2,0,0,0,0,26,263,126,156,571,0,0,0,0,1,17,13,8,39,610,Sitio Arqueológico
20240315,2022,6,Cajamarca,Monumento Arqueologico Kuntur Wasi,8,Agosto,0,0,0,0,4,17,250,157,359,787,0,0,0,0,3,30,2,16,51,838,Sitio Arqueológico
20240315,2022,6,Cajamarca,Monumento Arqueologico Kuntur Wasi,8,Agosto,1,0,0,0,0,0,27,0,0,27,0,0,0,0,0,0,0,0,0,27,Sitio Arqueológico
20240315,2022,6,Cajamarca,Monumento Arqueologico Kuntur Wasi,8,Agosto,2,0,0,0,4,17,277,157,359,814,0,0,0,0,3,30,2,16,51,865,Sitio Arqueológico
20240315,2022,6,Cajamarca,Monumento Arqueologico Kuntur Wasi,9,Setiembre,0,0,0,0,3,31,193,136,212,575,0,0,0,0,0,33,6,24,63,638,Sitio Arqueológico
20240315,2022,6,Cajamarca,Monumento Arqueologico Kuntur Wasi,9,Setiembre,1,0,0,0,0,4,6,6,4,20,0,0,0,0,0,0,0,0,0,20,Sitio Arqueológico
20240315,2022,6,Cajamarca,Monumento Arqueologico Kuntur Wasi,9,Setiembre,2,0,0,0,3,35,199,142,216,595,0,0,0,0,0,33,6,24,63,658,Sitio Arqueológico
20240315,2022,6,Cajamarca,Monumento Arqueologico Kuntur Wasi,10,Octubre,0,0,0,0,0,15,219,130,199,563,0,0,0,0,0,3,2,1,6,569,Sitio Arqueológico
20240315,2022,6,Cajamarca,Monumento Arqueologico Kuntur Wasi,10,Octubre,1,0,0,0,0,1,16,2,0,19,0,0,0,0,0,0,0,0,0,19,Sitio Arqueológico
20240315,2022,6,Cajamarca,Monumento Arqueologico Kuntur Wasi,10,Octubre,2,0,0,0,0,16,235,132,199,582,0,0,0,0,0,3,2,1,6,588,Sitio Arqueológico
20240315,2022,6,Cajamarca,Monumento Arqueologico Kuntur Wasi,11,Noviembre,0,0,0,0,0,7,214,111,130,462,0,0,0,0,0,30,16,11,57,519,Sitio Arqueológico
20240315,2022,6,Cajamarca,Monumento Arqueologico Kuntur Wasi,11,Noviembre,1,0,0,0,0,0,10,1,0,11,0,0,0,0,0,0,0,0,0,11,Sitio Arqueológico
20240315,2022,6,Cajamarca,Monumento Arqueologico Kuntur Wasi,11,Noviembre,2,0,0,0,0,7,224,112,130,473,0,0,0,0,0,30,16,11,57,530,Sitio Arqueológico
20240315,2022,6,Cajamarca,Monumento Arqueologico Kuntur Wasi,12,Diciembre,0,0,0,0,0,5,96,60,99,260,0,0,0,0,0,12,2,5,19,279,Sitio Arqueológico
20240315,2022,6,Cajamarca,Monumento Arqueologico Kuntur Wasi,12,Diciembre,1,0,0,0,0,0,8,4,1,13,0,0,0,0,0,0,0,0,0,13,Sitio Arqueológico
20240315,2022,6,Cajamarca,Monumento Arqueologico Kuntur Wasi,12,Diciembre,2,0,0,0,0,5,104,64,100,273,0,0,0,0,0,12,2,5,19,292,Sitio Arqueológico
20240315,2022,8,Cusco,Parque Arqueologico Macchu Picchu (Ruta 1: Camino Inka: Piscacucho Km. 82),1,Enero,0,0,0,0,0,0,8,0,0,8,0,0,0,0,0,0,0,0,0,8,Sitio Arqueológico
20240315,2022,8,Cusco,Parque Arqueologico Macchu Picchu (Ruta 1: Camino Inka: Piscacucho Km. 82),1,Enero,1,0,0,0,0,0,694,13,0,707,0,0,0,0,0,0,0,0,0,707,Sitio Arqueológico
20240315,2022,8,Cusco,Parque Arqueologico Macchu Picchu (Ruta 1: Camino Inka: Piscacucho Km. 82),1,Enero,2,0,0,0,0,0,702,13,0,715,0,0,0,0,0,0,0,0,0,715,Sitio Arqueológico
20240315,2022,8,Cusco,Parque Arqueologico Macchu Picchu (Ruta 1: Camino Inka: Piscacucho Km. 82),2,Febrero,0,0,0,0,0,0,16034,594,4016,20644,0,0,0,0,0,1526,0,0,1526,22170,Sitio Arqueológico
20240315,2022,8,Cusco,Parque Arqueologico Macchu Picchu (Ruta 1: Camino Inka: Piscacucho Km. 82),2,Febrero,1,0,0,0,0,0,13500,339,520,14359,0,0,0,0,0,0,0,0,0,14359,Sitio Arqueológico
20240315,2022,8,Cusco,Parque Arqueologico Macchu Picchu (Ruta 1: Camino Inka: Piscacucho Km. 82),2,Febrero,2,0,0,0,0,0,29534,933,4536,35003,0,0,0,0,0,1526,0,0,1526,36529,Sitio Arqueológico
20240315,2022,8,Cusco,Parque Arqueologico Macchu Picchu (Ruta 1: Camino Inka: Piscacucho Km. 82),3,Marzo,0,0,0,0,0,0,36,2,0,38,0,0,0,0,0,0,0,0,0,38,Sitio Arqueológico
20240315,2022,8,Cusco,Parque Arqueologico Macchu Picchu (Ruta 1: Camino Inka: Piscacucho Km. 82),3,Marzo,1,0,0,0,0,0,2153,90,1,2244,0,0,0,0,0,0,0,0,0,2244,Sitio Arqueológico
20240315,2022,8,Cusco,Parque Arqueologico Macchu Picchu (Ruta 1: Camino Inka: Piscacucho Km. 82),3,Marzo,2,0,0,0,0,0,2189,92,1,2282,0,0,0,0,0,0,0,0,0,2282,Sitio Arqueológico
20240315,2022,8,Cusco,Parque Arqueologico Macchu Picchu (Ruta 1: Camino Inka: Piscacucho Km. 82),4,Abril,0,0,0,0,0,0,53,1,1,55,0,0,0,0,0,0,0,0,0,55,Sitio Arqueológico
20240315,2022,8,Cusco,Parque Arqueologico Macchu Picchu (Ruta 1: Camino Inka: Piscacucho Km. 82),4,Abril,1,0,0,0,0,0,3641,49,49,3739,0,0,0,0,0,0,0,0,0,3739,Sitio Arqueológico
20240315,2022,8,Cusco,Parque Arqueologico Macchu Picchu (Ruta 1: Camino Inka: Piscacucho Km. 82),4,Abril,2,0,0,0,0,0,3694,50,50,3794,0,0,0,0,0,0,0,0,0,3794,Sitio Arqueológico
20240315,2022,8,Cusco,Parque Arqueologico Macchu Picchu (Ruta 1: Camino Inka: Piscacucho Km. 82),5,Mayo,0,0,0,0,0,0,55,90,0,145,0,0,0,0,0,0,0,0,0,145,Sitio Arqueológico
20240315,2022,8,Cusco,Parque Arqueologico Macchu Picchu (Ruta 1: Camino Inka: Piscacucho Km. 82),5,Mayo,1,0,0,0,0,0,3905,49,8,3962,0,0,0,0,0,0,0,0,0,3962,Sitio Arqueológico
20240315,2022,8,Cusco,Parque Arqueologico Macchu Picchu (Ruta 1: Camino Inka: Piscacucho Km. 82),5,Mayo,2,0,0,0,0,0,3960,139,8,4107,0,0,0,0,0,0,0,0,0,4107,Sitio Arqueológico
20240315,2022,8,Cusco,Parque Arqueologico Macchu Picchu (Ruta 1: Camino Inka: Piscacucho Km. 82),6,Junio,0,0,0,0,0,0,30,0,1,31,0,0,0,0,0,0,0,0,0,31,Sitio Arqueológico
20240315,2022,8,Cusco,Parque Arqueologico Macchu Picchu (Ruta 1: Camino Inka: Piscacucho Km. 82),6,Junio,1,0,0,0,0,0,3702,116,69,3887,0,0,0,0,0,0,0,0,0,3887,Sitio Arqueológico
20240315,2022,8,Cusco,Parque Arqueologico Macchu Picchu (Ruta 1: Camino Inka: Piscacucho Km. 82),6,Junio,2,0,0,0,0,0,3732,116,70,3918,0,0,0,0,0,0,0,0,0,3918,Sitio Arqueológico
20240315,2022,8,Cusco,Parque Arqueologico Macchu Picchu (Ruta 1: Camino Inka: Piscacucho Km. 82),7,Julio,0,0,0,0,0,0,96,162,5,263,0,0,0,0,0,0,0,0,0,263,Sitio Arqueológico
20240315,2022,8,Cusco,Parque Arqueologico Macchu Picchu (Ruta 1: Camino Inka: Piscacucho Km. 82),7,Julio,1,0,0,0,0,0,3591,122,167,3880,0,0,0,0,0,0,0,0,0,3880,Sitio Arqueológico
20240315,2022,8,Cusco,Parque Arqueologico Macchu Picchu (Ruta 1: Camino Inka: Piscacucho Km. 82),7,Julio,2,0,0,0,0,0,3687,284,172,4143,0,0,0,0,0,0,0,0,0,4143,Sitio Arqueológico
20240315,2022,8,Cusco,Parque Arqueologico Macchu Picchu (Ruta 1: Camino Inka: Piscacucho Km. 82),8,Agosto,0,0,0,0,0,0,63,7,1,71,0,0,0,0,0,0,0,0,0,71,Sitio Arqueológico
20240315,2022,8,Cusco,Parque Arqueologico Macchu Picchu (Ruta 1: Camino Inka: Piscacucho Km. 82),8,Agosto,1,0,0,0,0,0,4146,166,57,4369,0,0,0,0,0,0,0,0,0,4369,Sitio Arqueológico
20240315,2022,8,Cusco,Parque Arqueologico Macchu Picchu (Ruta 1: Camino Inka: Piscacucho Km. 82),8,Agosto,2,0,0,0,0,0,4209,173,58,4440,0,0,0,0,0,0,0,0,0,4440,Sitio Arqueológico
20240315,2022,8,Cusco,Parque Arqueologico Macchu Picchu (Ruta 1: Camino Inka: Piscacucho Km. 82),9,Setiembre,0,0,0,0,0,0,54,47,0,101,0,0,0,0,0,0,0,0,0,101,Sitio Arqueológico
20240315,2022,8,Cusco,Parque Arqueologico Macchu Picchu (Ruta 1: Camino Inka: Piscacucho Km. 82),9,Setiembre,1,0,0,0,0,0,3852,30,0,3882,0,0,0,0,0,0,0,0,0,3882,Sitio Arqueológico
20240315,2022,8,Cusco,Parque Arqueologico Macchu Picchu (Ruta 1: Camino Inka: Piscacucho Km. 82),9,Setiembre,2,0,0,0,0,0,3906,77,0,3983,0,0,0,0,0,0,0,0,0,3983,Sitio Arqueológico
20240315,2022,8,Cusco,Parque Arqueologico Macchu Picchu (Ruta 1: Camino Inka: Piscacucho Km. 82),10,Octubre,0,0,0,0,0,0,72,46,0,118,0,0,0,0,0,0,0,0,0,118,Sitio Arqueológico
20240315,2022,8,Cusco,Parque Arqueologico Macchu Picchu (Ruta 1: Camino Inka: Piscacucho Km. 82),10,Octubre,1,0,0,0,0,0,4022,48,0,4070,0,0,0,0,0,0,0,0,0,4070,Sitio Arqueológico
20240315,2022,8,Cusco,Parque Arqueologico Macchu Picchu (Ruta 1: Camino Inka: Piscacucho Km. 82),10,Octubre,2,0,0,0,0,0,4094,94,0,4188,0,0,0,0,0,0,0,0,0,4188,Sitio Arqueológico
20240315,2022,8,Cusco,Parque Arqueologico Macchu Picchu (Ruta 1: Camino Inka: Piscacucho Km. 82),11,Noviembre,0,0,0,0,0,0,37,2,0,39,0,0,0,0,0,0,0,0,0,39,Sitio Arqueológico
20240315,2022,8,Cusco,Parque Arqueologico Macchu Picchu (Ruta 1: Camino Inka: Piscacucho Km. 82),11,Noviembre,1,0,0,0,0,0,3031,23,0,3054,0,0,0,0,0,0,0,0,0,3054,Sitio Arqueológico
20240315,2022,8,Cusco,Parque Arqueologico Macchu Picchu (Ruta 1: Camino Inka: Piscacucho Km. 82),11,Noviembre,2,0,0,0,0,0,3068,25,0,3093,0,0,0,0,0,0,0,0,0,3093,Sitio Arqueológico
20240315,2022,8,Cusco,Parque Arqueologico Macchu Picchu (Ruta 1: Camino Inka: Piscacucho Km. 82),12,Diciembre,0,0,0,0,0,0,0,0,0,0,0,0,0,0,0,0,1,2,3,3,Sitio Arqueológico
20240315,2022,8,Cusco,Parque Arqueologico Macchu Picchu (Ruta 1: Camino Inka: Piscacucho Km. 82),12,Diciembre,1,0,0,0,0,0,982,20,0,1002,0,0,0,0,0,0,0,0,0,1002,Sitio Arqueológico
20240315,2022,8,Cusco,Parque Arqueologico Macchu Picchu (Ruta 1: Camino Inka: Piscacucho Km. 82),12,Diciembre,2,0,0,0,0,0,982,20,0,1002,0,0,0,0,0,0,1,2,3,1005,Sitio Arqueológico
20240315,2022,8,Cusco,Parque Arqueologico Macchu Picchu (Ruta 2: Camino Inka: Km. 88),1,Enero,0,0,0,0,0,0,0,0,0,0,0,0,0,0,0,0,0,0,0,0,Sitio Arqueológico
20240315,2022,8,Cusco,Parque Arqueologico Macchu Picchu (Ruta 2: Camino Inka: Km. 88),1,Enero,1,0,0,0,0,0,3,0,0,3,0,0,0,0,0,0,0,0,0,3,Sitio Arqueológico
20240315,2022,8,Cusco,Parque Arqueologico Macchu Picchu (Ruta 2: Camino Inka: Km. 88),1,Enero,2,0,0,0,0,0,3,0,0,3,0,0,0,0,0,0,0,0,0,3,Sitio Arqueológico
20240315,2022,8,Cusco,Parque Arqueologico Macchu Picchu (Ruta 2: Camino Inka: Km. 88),2,Febrero,0,0,0,0,0,0,0,0,0,0,0,0,0,0,0,0,0,0,0,0,Sitio Arqueológico
20240315,2022,8,Cusco,Parque Arqueologico Macchu Picchu (Ruta 2: Camino Inka: Km. 88),2,Febrero,1,0,0,0,0,0,0,0,0,0,0,0,0,0,0,0,0,0,0,0,Sitio Arqueológico
20240315,2022,8,Cusco,Parque Arqueologico Macchu Picchu (Ruta 2: Camino Inka: Km. 88),2,Febrero,2,0,0,0,0,0,0,0,0,0,0,0,0,0,0,0,0,0,0,0,Sitio Arqueológico
20240315,2022,8,Cusco,Parque Arqueologico Macchu Picchu (Ruta 2: Camino Inka: Km. 88),3,Marzo,0,0,0,0,0,0,0,0,0,0,0,0,0,0,0,0,0,0,0,0,Sitio Arqueológico
20240315,2022,8,Cusco,Parque Arqueologico Macchu Picchu (Ruta 2: Camino Inka: Km. 88),3,Marzo,1,0,0,0,0,0,5,0,0,5,0,0,0,0,0,0,0,0,0,5,Sitio Arqueológico
20240315,2022,8,Cusco,Parque Arqueologico Macchu Picchu (Ruta 2: Camino Inka: Km. 88),3,Marzo,2,0,0,0,0,0,5,0,0,5,0,0,0,0,0,0,0,0,0,5,Sitio Arqueológico
20240315,2022,8,Cusco,Parque Arqueologico Macchu Picchu (Ruta 2: Camino Inka: Km. 88),4,Abril,0,0,0,0,0,0,0,0,0,0,0,0,0,0,0,0,0,0,0,0,Sitio Arqueológico
20240315,2022,8,Cusco,Parque Arqueologico Macchu Picchu (Ruta 2: Camino Inka: Km. 88),4,Abril,1,0,0,0,0,0,156,7,0,163,0,0,0,0,0,0,0,0,0,163,Sitio Arqueológico
20240315,2022,8,Cusco,Parque Arqueologico Macchu Picchu (Ruta 2: Camino Inka: Km. 88),4,Abril,2,0,0,0,0,0,156,7,0,163,0,0,0,0,0,0,0,0,0,163,Sitio Arqueológico
20240315,2022,8,Cusco,Parque Arqueologico Macchu Picchu (Ruta 2: Camino Inka: Km. 88),5,Mayo,0,0,0,0,0,0,0,0,0,0,0,0,0,0,0,0,0,0,0,0,Sitio Arqueológico
20240315,2022,8,Cusco,Parque Arqueologico Macchu Picchu (Ruta 2: Camino Inka: Km. 88),5,Mayo,1,0,0,0,0,0,0,0,0,0,0,0,0,0,0,0,0,0,0,0,Sitio Arqueológico
20240315,2022,8,Cusco,Parque Arqueologico Macchu Picchu (Ruta 2: Camino Inka: Km. 88),5,Mayo,2,0,0,0,0,0,0,0,0,0,0,0,0,0,0,0,0,0,0,0,Sitio Arqueológico
20240315,2022,8,Cusco,Parque Arqueologico Macchu Picchu (Ruta 2: Camino Inka: Km. 88),6,Junio,0,0,0,0,0,0,0,0,5,5,0,0,0,0,0,0,0,0,0,5,Sitio Arqueológico
20240315,2022,8,Cusco,Parque Arqueologico Macchu Picchu (Ruta 2: Camino Inka: Km. 88),6,Junio,1,0,0,0,0,0,203,2,0,205,0,0,0,0,0,0,0,0,0,205,Sitio Arqueológico
20240315,2022,8,Cusco,Parque Arqueologico Macchu Picchu (Ruta 2: Camino Inka: Km. 88),6,Junio,2,0,0,0,0,0,203,2,5,210,0,0,0,0,0,0,0,0,0,210,Sitio Arqueológico
20240315,2022,8,Cusco,Parque Arqueologico Macchu Picchu (Ruta 2: Camino Inka: Km. 88),7,Julio,0,0,0,0,0,0,0,0,0,0,0,0,0,0,0,0,0,0,0,0,Sitio Arqueológico
20240315,2022,8,Cusco,Parque Arqueologico Macchu Picchu (Ruta 2: Camino Inka: Km. 88),7,Julio,1,0,0,0,0,0,133,11,9,153,0,0,0,0,0,0,0,0,0,153,Sitio Arqueológico
20240315,2022,8,Cusco,Parque Arqueologico Macchu Picchu (Ruta 2: Camino Inka: Km. 88),7,Julio,2,0,0,0,0,0,133,11,9,153,0,0,0,0,0,0,0,0,0,153,Sitio Arqueológico
20240315,2022,8,Cusco,Parque Arqueologico Macchu Picchu (Ruta 2: Camino Inka: Km. 88),8,Agosto,0,0,0,0,0,0,0,0,0,0,0,0,0,0,0,0,0,0,0,0,Sitio Arqueológico
20240315,2022,8,Cusco,Parque Arqueologico Macchu Picchu (Ruta 2: Camino Inka: Km. 88),8,Agosto,1,0,0,0,0,0,198,16,0,214,0,0,0,0,0,0,0,0,0,214,Sitio Arqueológico
20240315,2022,8,Cusco,Parque Arqueologico Macchu Picchu (Ruta 2: Camino Inka: Km. 88),8,Agosto,2,0,0,0,0,0,198,16,0,214,0,0,0,0,0,0,0,0,0,214,Sitio Arqueológico
20240315,2022,8,Cusco,Parque Arqueologico Macchu Picchu (Ruta 2: Camino Inka: Km. 88),9,Setiembre,0,0,0,0,0,0,0,0,0,0,0,0,0,0,0,0,0,0,0,0,Sitio Arqueológico
20240315,2022,8,Cusco,Parque Arqueologico Macchu Picchu (Ruta 2: Camino Inka: Km. 88),9,Setiembre,1,0,0,0,0,0,249,6,0,255,0,0,0,0,0,0,0,0,0,255,Sitio Arqueológico
20240315,2022,8,Cusco,Parque Arqueologico Macchu Picchu (Ruta 2: Camino Inka: Km. 88),9,Setiembre,2,0,0,0,0,0,249,6,0,255,0,0,0,0,0,0,0,0,0,255,Sitio Arqueológico
20240315,2022,8,Cusco,Parque Arqueologico Macchu Picchu (Ruta 2: Camino Inka: Km. 88),10,Octubre,0,0,0,0,0,0,0,0,0,0,0,0,0,0,0,0,0,0,0,0,Sitio Arqueológico
20240315,2022,8,Cusco,Parque Arqueologico Macchu Picchu (Ruta 2: Camino Inka: Km. 88),10,Octubre,1,0,0,0,0,0,164,0,0,164,0,0,0,0,0,0,0,0,0,164,Sitio Arqueológico
20240315,2022,8,Cusco,Parque Arqueologico Macchu Picchu (Ruta 2: Camino Inka: Km. 88),10,Octubre,2,0,0,0,0,0,164,0,0,164,0,0,0,0,0,0,0,0,0,164,Sitio Arqueológico
20240315,2022,8,Cusco,Parque Arqueologico Macchu Picchu (Ruta 2: Camino Inka: Km. 88),11,Noviembre,0,0,0,0,0,0,0,0,0,0,0,0,0,0,0,0,0,0,0,0,Sitio Arqueológico
20240315,2022,8,Cusco,Parque Arqueologico Macchu Picchu (Ruta 2: Camino Inka: Km. 88),11,Noviembre,1,0,0,0,0,0,88,0,0,88,0,0,0,0,0,0,0,0,0,88,Sitio Arqueológico
20240315,2022,8,Cusco,Parque Arqueologico Macchu Picchu (Ruta 2: Camino Inka: Km. 88),11,Noviembre,2,0,0,0,0,0,88,0,0,88,0,0,0,0,0,0,0,0,0,88,Sitio Arqueológico
20240315,2022,8,Cusco,Parque Arqueologico Macchu Picchu (Ruta 2: Camino Inka: Km. 88),12,Diciembre,0,0,0,0,0,0,0,0,0,0,0,0,0,0,0,0,0,0,0,0,Sitio Arqueológico
20240315,2022,8,Cusco,Parque Arqueologico Macchu Picchu (Ruta 2: Camino Inka: Km. 88),12,Diciembre,1,0,0,0,0,0,2,0,0,2,0,0,0,0,0,0,0,0,0,2,Sitio Arqueológico
20240315,2022,8,Cusco,Parque Arqueologico Macchu Picchu (Ruta 2: Camino Inka: Km. 88),12,Diciembre,2,0,0,0,0,0,2,0,0,2,0,0,0,0,0,0,0,0,0,2,Sitio Arqueológico
20240315,2022,8,Cusco,Parque Arqueologico Macchu Picchu (Ruta 5: Camino Iinka: Chanchabamba Km. 104),1,Enero,0,0,0,0,0,0,2,0,1,3,0,0,0,0,0,0,0,0,0,3,Sitio Arqueológico
20240315,2022,8,Cusco,Parque Arqueologico Macchu Picchu (Ruta 5: Camino Iinka: Chanchabamba Km. 104),1,Enero,1,0,0,0,0,0,282,7,4,293,0,0,0,0,0,0,0,0,0,293,Sitio Arqueológico
20240315,2022,8,Cusco,Parque Arqueologico Macchu Picchu (Ruta 5: Camino Iinka: Chanchabamba Km. 104),1,Enero,2,0,0,0,0,0,284,7,5,296,0,0,0,0,0,0,0,0,0,296,Sitio Arqueológico
20240315,2022,8,Cusco,Parque Arqueologico Macchu Picchu (Ruta 5: Camino Iinka: Chanchabamba Km. 104),2,Febrero,0,0,0,0,0,0,0,0,0,0,0,0,0,0,0,0,0,0,0,0,Sitio Arqueológico
20240315,2022,8,Cusco,Parque Arqueologico Macchu Picchu (Ruta 5: Camino Iinka: Chanchabamba Km. 104),2,Febrero,1,0,0,0,0,0,0,0,0,0,0,0,0,0,0,0,0,0,0,0,Sitio Arqueológico
20240315,2022,8,Cusco,Parque Arqueologico Macchu Picchu (Ruta 5: Camino Iinka: Chanchabamba Km. 104),2,Febrero,2,0,0,0,0,0,0,0,0,0,0,0,0,0,0,0,0,0,0,0,Sitio Arqueológico
20240315,2022,8,Cusco,Parque Arqueologico Macchu Picchu (Ruta 5: Camino Iinka: Chanchabamba Km. 104),3,Marzo,0,0,0,0,0,0,6,0,0,6,0,0,0,0,0,0,0,0,0,6,Sitio Arqueológico
20240315,2022,8,Cusco,Parque Arqueologico Macchu Picchu (Ruta 5: Camino Iinka: Chanchabamba Km. 104),3,Marzo,1,0,0,0,0,0,849,26,29,904,0,0,0,0,0,0,0,0,0,904,Sitio Arqueológico
20240315,2022,8,Cusco,Parque Arqueologico Macchu Picchu (Ruta 5: Camino Iinka: Chanchabamba Km. 104),3,Marzo,2,0,0,0,0,0,855,26,29,910,0,0,0,0,0,0,0,0,0,910,Sitio Arqueológico
20240315,2022,8,Cusco,Parque Arqueologico Macchu Picchu (Ruta 5: Camino Iinka: Chanchabamba Km. 104),4,Abril,0,0,0,0,0,0,15,0,0,15,0,0,0,0,0,0,0,0,0,15,Sitio Arqueológico
20240315,2022,8,Cusco,Parque Arqueologico Macchu Picchu (Ruta 5: Camino Iinka: Chanchabamba Km. 104),4,Abril,1,0,0,0,0,0,1745,109,0,1854,0,0,0,0,0,0,0,0,0,1854,Sitio Arqueológico
20240315,2022,8,Cusco,Parque Arqueologico Macchu Picchu (Ruta 5: Camino Iinka: Chanchabamba Km. 104),4,Abril,2,0,0,0,0,0,1760,109,0,1869,0,0,0,0,0,0,0,0,0,1869,Sitio Arqueológico
20240315,2022,8,Cusco,Parque Arqueologico Macchu Picchu (Ruta 5: Camino Iinka: Chanchabamba Km. 104),5,Mayo,0,0,0,0,0,0,26,4,0,30,0,0,0,0,0,0,0,0,0,30,Sitio Arqueológico
20240315,2022,8,Cusco,Parque Arqueologico Macchu Picchu (Ruta 5: Camino Iinka: Chanchabamba Km. 104),5,Mayo,1,0,0,0,0,0,2289,45,0,2334,0,0,0,0,0,0,0,0,0,2334,Sitio Arqueológico
20240315,2022,8,Cusco,Parque Arqueologico Macchu Picchu (Ruta 5: Camino Iinka: Chanchabamba Km. 104),5,Mayo,2,0,0,0,0,0,2315,49,0,2364,0,0,0,0,0,0,0,0,0,2364,Sitio Arqueológico
20240315,2022,8,Cusco,Parque Arqueologico Macchu Picchu (Ruta 5: Camino Iinka: Chanchabamba Km. 104),6,Junio,0,0,0,0,0,0,36,0,0,36,0,0,0,0,0,0,0,0,0,36,Sitio Arqueológico
20240315,2022,8,Cusco,Parque Arqueologico Macchu Picchu (Ruta 5: Camino Iinka: Chanchabamba Km. 104),6,Junio,1,0,0,0,0,0,2373,210,0,2583,0,0,0,0,0,0,0,0,0,2583,Sitio Arqueológico
20240315,2022,8,Cusco,Parque Arqueologico Macchu Picchu (Ruta 5: Camino Iinka: Chanchabamba Km. 104),6,Junio,2,0,0,0,0,0,2409,210,0,2619,0,0,0,0,0,0,0,0,0,2619,Sitio Arqueológico
20240315,2022,8,Cusco,Parque Arqueologico Macchu Picchu (Ruta 5: Camino Iinka: Chanchabamba Km. 104),7,Julio,0,0,0,0,0,0,66,2,0,68,0,0,0,0,0,0,0,0,0,68,Sitio Arqueológico
20240315,2022,8,Cusco,Parque Arqueologico Macchu Picchu (Ruta 5: Camino Iinka: Chanchabamba Km. 104),7,Julio,1,0,0,0,0,0,2792,302,0,3094,0,0,0,0,0,0,0,0,0,3094,Sitio Arqueológico
20240315,2022,8,Cusco,Parque Arqueologico Macchu Picchu (Ruta 5: Camino Iinka: Chanchabamba Km. 104),7,Julio,2,0,0,0,0,0,2858,304,0,3162,0,0,0,0,0,0,0,0,0,3162,Sitio Arqueológico
20240315,2022,8,Cusco,Parque Arqueologico Macchu Picchu (Ruta 5: Camino Iinka: Chanchabamba Km. 104),8,Agosto,0,0,0,0,0,0,15,0,7,22,0,0,0,0,0,3,0,0,3,25,Sitio Arqueológico
20240315,2022,8,Cusco,Parque Arqueologico Macchu Picchu (Ruta 5: Camino Iinka: Chanchabamba Km. 104),8,Agosto,1,0,0,0,0,0,3172,274,0,3446,0,0,0,0,0,0,0,0,0,3446,Sitio Arqueológico
20240315,2022,8,Cusco,Parque Arqueologico Macchu Picchu (Ruta 5: Camino Iinka: Chanchabamba Km. 104),8,Agosto,2,0,0,0,0,0,3187,274,7,3468,0,0,0,0,0,3,0,0,3,3471,Sitio Arqueológico
20240315,2022,8,Cusco,Parque Arqueologico Macchu Picchu (Ruta 5: Camino Iinka: Chanchabamba Km. 104),9,Setiembre,0,0,0,0,0,0,23,0,0,23,0,0,0,0,0,0,0,0,0,23,Sitio Arqueológico
20240315,2022,8,Cusco,Parque Arqueologico Macchu Picchu (Ruta 5: Camino Iinka: Chanchabamba Km. 104),9,Setiembre,1,0,0,0,0,0,2903,11,21,2935,0,0,0,0,0,0,0,0,0,2935,Sitio Arqueológico
20240315,2022,8,Cusco,Parque Arqueologico Macchu Picchu (Ruta 5: Camino Iinka: Chanchabamba Km. 104),9,Setiembre,2,0,0,0,0,0,2926,11,21,2958,0,0,0,0,0,0,0,0,0,2958,Sitio Arqueológico
20240315,2022,8,Cusco,Parque Arqueologico Macchu Picchu (Ruta 5: Camino Iinka: Chanchabamba Km. 104),10,Octubre,0,0,0,0,0,0,18,0,2,20,0,0,0,0,0,0,0,1,1,21,Sitio Arqueológico
20240315,2022,8,Cusco,Parque Arqueologico Macchu Picchu (Ruta 5: Camino Iinka: Chanchabamba Km. 104),10,Octubre,1,0,0,0,0,0,2528,46,19,2593,0,0,0,0,0,0,0,0,0,2593,Sitio Arqueológico
20240315,2022,8,Cusco,Parque Arqueologico Macchu Picchu (Ruta 5: Camino Iinka: Chanchabamba Km. 104),10,Octubre,2,0,0,0,0,0,2546,46,21,2613,0,0,0,0,0,0,0,1,1,2614,Sitio Arqueológico
20240315,2022,8,Cusco,Parque Arqueologico Macchu Picchu (Ruta 5: Camino Iinka: Chanchabamba Km. 104),11,Noviembre,0,0,0,0,0,0,14,13,1,28,0,0,0,0,0,0,0,0,0,28,Sitio Arqueológico
20240315,2022,8,Cusco,Parque Arqueologico Macchu Picchu (Ruta 5: Camino Iinka: Chanchabamba Km. 104),11,Noviembre,1,0,0,0,0,0,1510,12,2,1524,0,0,0,0,0,0,0,0,0,1524,Sitio Arqueológico
20240315,2022,8,Cusco,Parque Arqueologico Macchu Picchu (Ruta 5: Camino Iinka: Chanchabamba Km. 104),11,Noviembre,2,0,0,0,0,0,1524,25,3,1552,0,0,0,0,0,0,0,0,0,1552,Sitio Arqueológico
20240315,2022,8,Cusco,Parque Arqueologico Macchu Picchu (Ruta 5: Camino Iinka: Chanchabamba Km. 104),12,Diciembre,0,0,0,0,0,0,22,1,1,24,0,0,0,0,0,0,0,14,14,38,Sitio Arqueológico
20240315,2022,8,Cusco,Parque Arqueologico Macchu Picchu (Ruta 5: Camino Iinka: Chanchabamba Km. 104),12,Diciembre,1,0,0,0,0,0,576,11,25,612,0,0,0,0,0,0,0,0,0,612,Sitio Arqueológico
20240315,2022,8,Cusco,Parque Arqueologico Macchu Picchu (Ruta 5: Camino Iinka: Chanchabamba Km. 104),12,Diciembre,2,0,0,0,0,0,598,12,26,636,0,0,0,0,0,0,0,14,14,650,Sitio Arqueológico
20240315,2022,8,Cusco,Monumento Arqueologico de Raqchi,1,Enero,0,0,0,0,0,0,433,333,0,766,0,0,0,0,0,1083,133,41,1257,2023,Sitio Arqueológico
20240315,2022,8,Cusco,Monumento Arqueologico de Raqchi,1,Enero,1,0,0,0,0,0,704,222,0,926,0,0,0,0,0,0,0,0,0,926,Sitio Arqueológico
20240315,2022,8,Cusco,Monumento Arqueologico de Raqchi,1,Enero,2,0,0,0,0,0,1137,555,0,1692,0,0,0,0,0,1083,133,41,1257,2949,Sitio Arqueológico
20240315,2022,8,Cusco,Monumento Arqueologico de Raqchi,2,Febrero,0,0,0,0,0,0,137,551,0,688,0,0,0,0,0,621,123,35,779,1467,Sitio Arqueológico
20240315,2022,8,Cusco,Monumento Arqueologico de Raqchi,2,Febrero,1,0,0,0,0,0,703,46,0,749,0,0,0,0,0,0,0,0,0,749,Sitio Arqueológico
20240315,2022,8,Cusco,Monumento Arqueologico de Raqchi,2,Febrero,2,0,0,0,0,0,840,597,0,1437,0,0,0,0,0,621,123,35,779,2216,Sitio Arqueológico
20240315,2022,8,Cusco,Monumento Arqueologico de Raqchi,3,Marzo,0,0,0,0,0,0,181,350,0,531,0,0,0,0,0,579,196,66,841,1372,Sitio Arqueológico
20240315,2022,8,Cusco,Monumento Arqueologico de Raqchi,3,Marzo,1,0,0,0,0,0,1187,71,0,1258,0,0,0,0,0,0,0,0,0,1258,Sitio Arqueológico
20240315,2022,8,Cusco,Monumento Arqueologico de Raqchi,3,Marzo,2,0,0,0,0,0,1368,421,0,1789,0,0,0,0,0,579,196,66,841,2630,Sitio Arqueológico
20240315,2022,8,Cusco,Monumento Arqueologico de Raqchi,4,Abril,0,0,0,0,0,0,514,167,0,681,0,0,0,0,0,737,150,50,937,1618,Sitio Arqueológico
20240315,2022,8,Cusco,Monumento Arqueologico de Raqchi,4,Abril,1,0,0,0,0,0,2729,155,0,2884,0,0,0,0,0,0,0,0,0,2884,Sitio Arqueológico
20240315,2022,8,Cusco,Monumento Arqueologico de Raqchi,4,Abril,2,0,0,0,0,0,3243,322,0,3565,0,0,0,0,0,737,150,50,937,4502,Sitio Arqueológico
20240315,2022,8,Cusco,Monumento Arqueologico de Raqchi,5,Mayo,0,0,0,0,0,0,318,72,0,390,0,0,0,0,0,818,94,32,944,1334,Sitio Arqueológico
20240315,2022,8,Cusco,Monumento Arqueologico de Raqchi,5,Mayo,1,0,0,0,0,0,4084,135,0,4219,0,0,0,0,0,0,0,0,0,4219,Sitio Arqueológico
20240315,2022,8,Cusco,Monumento Arqueologico de Raqchi,5,Mayo,2,0,0,0,0,0,4402,207,0,4609,0,0,0,0,0,818,94,32,944,5553,Sitio Arqueológico
20240315,2022,8,Cusco,Monumento Arqueologico de Raqchi,6,Junio,0,0,0,0,0,0,271,209,0,480,0,0,0,0,0,2368,230,94,2692,3172,Sitio Arqueológico
20240315,2022,8,Cusco,Monumento Arqueologico de Raqchi,6,Junio,1,0,0,0,0,0,4210,316,0,4526,0,0,0,0,0,0,0,0,0,4526,Sitio Arqueológico
20240315,2022,8,Cusco,Monumento Arqueologico de Raqchi,6,Junio,2,0,0,0,0,0,4481,525,0,5006,0,0,0,0,0,2368,230,94,2692,7698,Sitio Arqueológico
20240315,2022,8,Cusco,Monumento Arqueologico de Raqchi,7,Julio,0,0,0,0,0,0,430,403,0,833,0,0,0,0,0,719,157,62,938,1771,Sitio Arqueológico
20240315,2022,8,Cusco,Monumento Arqueologico de Raqchi,7,Julio,1,0,0,0,0,0,5089,160,0,5249,0,0,0,0,0,0,0,0,0,5249,Sitio Arqueológico
20240315,2022,8,Cusco,Monumento Arqueologico de Raqchi,7,Julio,2,0,0,0,0,0,5519,563,0,6082,0,0,0,0,0,719,157,62,938,7020,Sitio Arqueológico
20240315,2022,8,Cusco,Monumento Arqueologico de Raqchi,8,Agosto,0,0,0,0,0,0,448,362,0,810,0,0,0,0,0,827,133,38,998,1808,Sitio Arqueológico
20240315,2022,8,Cusco,Monumento Arqueologico de Raqchi,8,Agosto,1,0,0,0,0,0,7211,254,0,7465,0,0,0,0,0,0,0,0,0,7465,Sitio Arqueológico
20240315,2022,8,Cusco,Monumento Arqueologico de Raqchi,8,Agosto,2,0,0,0,0,0,7659,616,0,8275,0,0,0,0,0,827,133,38,998,9273,Sitio Arqueológico
20240315,2022,8,Cusco,Monumento Arqueologico de Raqchi,9,Setiembre,0,0,0,0,0,0,422,72,0,494,0,0,0,0,0,641,528,75,1244,1738,Sitio Arqueológico
20240315,2022,8,Cusco,Monumento Arqueologico de Raqchi,9,Setiembre,1,0,0,0,0,0,6107,155,0,6262,0,0,0,0,0,0,0,0,0,6262,Sitio Arqueológico
20240315,2022,8,Cusco,Monumento Arqueologico de Raqchi,9,Setiembre,2,0,0,0,0,0,6529,227,0,6756,0,0,0,0,0,641,528,75,1244,8000,Sitio Arqueológico
20240315,2022,8,Cusco,Monumento Arqueologico de Raqchi,10,Octubre,0,0,0,0,0,0,448,97,0,545,0,0,0,0,0,684,118,40,842,1387,Sitio Arqueológico
20240315,2022,8,Cusco,Monumento Arqueologico de Raqchi,10,Octubre,1,0,0,0,0,0,6402,214,0,6616,0,0,0,0,0,0,0,0,0,6616,Sitio Arqueológico
20240315,2022,8,Cusco,Monumento Arqueologico de Raqchi,10,Octubre,2,0,0,0,0,0,6850,311,0,7161,0,0,0,0,0,684,118,40,842,8003,Sitio Arqueológico
20240315,2022,8,Cusco,Monumento Arqueologico de Raqchi,11,Noviembre,0,0,0,0,0,0,225,114,0,339,0,0,0,0,0,496,83,30,609,948,Sitio Arqueológico
20240315,2022,8,Cusco,Monumento Arqueologico de Raqchi,11,Noviembre,1,0,0,0,0,0,3941,146,0,4087,0,0,0,0,0,0,0,0,0,4087,Sitio Arqueológico
20240315,2022,8,Cusco,Monumento Arqueologico de Raqchi,11,Noviembre,2,0,0,0,0,0,4166,260,0,4426,0,0,0,0,0,496,83,30,609,5035,Sitio Arqueológico
20240315,2022,8,Cusco,Monumento Arqueologico de Raqchi,12,Diciembre,0,0,0,0,0,0,52,46,0,98,0,0,0,0,0,379,55,17,451,549,Sitio Arqueológico
20240315,2022,8,Cusco,Monumento Arqueologico de Raqchi,12,Diciembre,1,0,0,0,0,0,98,54,0,152,0,0,0,0,0,0,0,0,0,152,Sitio Arqueológico
20240315,2022,8,Cusco,Monumento Arqueologico de Raqchi,12,Diciembre,2,0,0,0,0,0,150,100,0,250,0,0,0,0,0,379,55,17,451,701,Sitio Arqueológico
20240315,2022,8,Cusco,Monumento Arqueologico de Moray,1,Enero,0,0,0,0,0,1049,13335,3267,585,18236,0,0,0,0,185,1628,520,131,2464,20700,Sitio Arqueológico
20240315,2022,8,Cusco,Monumento Arqueologico de Moray,1,Enero,1,0,0,0,0,866,10052,1453,190,12561,0,0,0,0,0,0,0,0,0,12561,Sitio Arqueológico
20240315,2022,8,Cusco,Monumento Arqueologico de Moray,1,Enero,2,0,0,0,0,1915,23387,4720,775,30797,0,0,0,0,185,1628,520,131,2464,33261,Sitio Arqueológico
20240315,2022,8,Cusco,Monumento Arqueologico de Moray,2,Febrero,0,0,0,0,0,711,11355,2976,379,15421,0,0,0,0,150,1348,349,75,1922,17343,Sitio Arqueológico
20240315,2022,8,Cusco,Monumento Arqueologico de Moray,2,Febrero,1,0,0,0,0,619,8711,1375,137,10842,0,0,0,0,0,0,0,0,0,10842,Sitio Arqueológico
20240315,2022,8,Cusco,Monumento Arqueologico de Moray,2,Febrero,2,0,0,0,0,1330,20066,4351,516,26263,0,0,0,0,150,1348,349,75,1922,28185,Sitio Arqueológico
20240315,2022,8,Cusco,Monumento Arqueologico de Moray,3,Marzo,0,0,0,0,0,1027,13658,3711,483,18879,0,0,0,0,142,1108,371,89,1710,20589,Sitio Arqueológico
20240315,2022,8,Cusco,Monumento Arqueologico de Moray,3,Marzo,1,0,0,0,0,1011,13871,1394,166,16442,0,0,0,0,0,0,0,0,0,16442,Sitio Arqueológico
20240315,2022,8,Cusco,Monumento Arqueologico de Moray,3,Marzo,2,0,0,0,0,2038,27529,5105,649,35321,0,0,0,0,142,1108,371,89,1710,37031,Sitio Arqueológico
20240315,2022,8,Cusco,Monumento Arqueologico de Moray,4,Abril,0,0,0,0,0,995,15522,4018,608,21143,0,0,0,0,134,803,344,75,1356,22499,Sitio Arqueológico
20240315,2022,8,Cusco,Monumento Arqueologico de Moray,4,Abril,1,0,0,0,0,1063,17451,2791,400,21705,0,0,0,0,0,0,0,0,0,21705,Sitio Arqueológico
20240315,2022,8,Cusco,Monumento Arqueologico de Moray,4,Abril,2,0,0,0,0,2058,32973,6809,1008,42848,0,0,0,0,134,803,344,75,1356,44204,Sitio Arqueológico
20240315,2022,8,Cusco,Monumento Arqueologico de Moray,5,Mayo,0,0,0,0,0,968,19010,3918,571,24467,0,0,0,0,91,834,311,77,1313,25780,Sitio Arqueológico
20240315,2022,8,Cusco,Monumento Arqueologico de Moray,5,Mayo,1,0,0,0,0,1128,22136,2846,433,26543,0,0,0,0,0,0,0,0,0,26543,Sitio Arqueológico
20240315,2022,8,Cusco,Monumento Arqueologico de Moray,5,Mayo,2,0,0,0,0,2096,41146,6764,1004,51010,0,0,0,0,91,834,311,77,1313,52323,Sitio Arqueológico
20240315,2022,8,Cusco,Monumento Arqueologico de Moray,6,Junio,0,0,0,0,0,792,17410,2817,358,21377,0,0,0,0,115,1064,194,46,1419,22796,Sitio Arqueológico
20240315,2022,8,Cusco,Monumento Arqueologico de Moray,6,Junio,1,0,0,0,0,933,22057,2568,309,25867,0,0,0,0,0,0,0,0,0,25867,Sitio Arqueológico
20240315,2022,8,Cusco,Monumento Arqueologico de Moray,6,Junio,2,0,0,0,0,1725,39467,5385,667,47244,0,0,0,0,115,1064,194,46,1419,48663,Sitio Arqueológico
20240315,2022,8,Cusco,Monumento Arqueologico de Moray,7,Julio,0,0,0,0,0,1023,18976,3194,523,23716,0,0,0,0,121,1013,305,83,1522,25238,Sitio Arqueológico
20240315,2022,8,Cusco,Monumento Arqueologico de Moray,7,Julio,1,0,0,0,0,1303,23202,2870,522,27897,0,0,0,0,0,0,0,0,0,27897,Sitio Arqueológico
20240315,2022,8,Cusco,Monumento Arqueologico de Moray,7,Julio,2,0,0,0,0,2326,42178,6064,1045,51613,0,0,0,0,121,1013,305,83,1522,53135,Sitio Arqueológico
20240315,2022,8,Cusco,Monumento Arqueologico de Moray,8,Agosto,0,0,0,0,0,996,16253,3386,521,21156,0,0,0,0,49,617,260,28,954,22110,Sitio Arqueológico
20240315,2022,8,Cusco,Monumento Arqueologico de Moray,8,Agosto,1,0,0,0,0,1007,18572,2569,388,22536,0,0,0,0,0,0,0,0,0,22536,Sitio Arqueológico
20240315,2022,8,Cusco,Monumento Arqueologico de Moray,8,Agosto,2,0,0,0,0,2003,34825,5955,909,43692,0,0,0,0,49,617,260,28,954,44646,Sitio Arqueológico
20240315,2022,8,Cusco,Monumento Arqueologico de Moray,9,Setiembre,0,0,0,0,0,821,11657,1783,315,14576,0,0,0,0,57,651,226,190,1124,15700,Sitio Arqueológico
20240315,2022,8,Cusco,Monumento Arqueologico de Moray,9,Setiembre,1,0,0,0,0,1053,15022,1680,276,18031,0,0,0,0,0,0,0,0,0,18031,Sitio Arqueológico
20240315,2022,8,Cusco,Monumento Arqueologico de Moray,9,Setiembre,2,0,0,0,0,1874,26679,3463,591,32607,0,0,0,0,57,651,226,190,1124,33731,Sitio Arqueológico
20240315,2022,8,Cusco,Monumento Arqueologico de Moray,10,Octubre,0,0,0,0,0,166,15273,4362,131,19932,0,0,0,8,43,779,420,40,1290,21222,Sitio Arqueológico
20240315,2022,8,Cusco,Monumento Arqueologico de Moray,10,Octubre,1,0,0,0,0,258,23858,1245,42,25403,0,0,0,0,0,0,0,0,0,25403,Sitio Arqueológico
20240315,2022,8,Cusco,Monumento Arqueologico de Moray,10,Octubre,2,0,0,0,0,424,39131,5607,173,45335,0,0,0,8,43,779,420,40,1290,46625,Sitio Arqueológico
20240315,2022,8,Cusco,Monumento Arqueologico de Moray,11,Noviembre,0,0,0,0,0,0,8223,2095,0,10318,0,0,0,0,57,825,647,45,1574,11892,Sitio Arqueológico
20240315,2022,8,Cusco,Monumento Arqueologico de Moray,11,Noviembre,1,0,0,0,0,0,1218,13431,0,14649,0,0,0,0,0,0,0,0,0,14649,Sitio Arqueológico
20240315,2022,8,Cusco,Monumento Arqueologico de Moray,11,Noviembre,2,0,0,0,0,0,9441,15526,0,24967,0,0,0,0,57,825,647,45,1574,26541,Sitio Arqueológico
20240315,2022,8,Cusco,Monumento Arqueologico de Moray,12,Diciembre,0,0,0,0,0,0,6602,1339,0,7941,0,0,0,0,46,643,312,8,1009,8950,Sitio Arqueológico
20240315,2022,8,Cusco,Monumento Arqueologico de Moray,12,Diciembre,1,0,0,0,0,66,8179,540,0,8785,0,0,0,0,0,0,0,0,0,8785,Sitio Arqueológico
20240315,2022,8,Cusco,Monumento Arqueologico de Moray,12,Diciembre,2,0,0,0,0,66,14781,1879,0,16726,0,0,0,0,46,643,312,8,1009,17735,Sitio Arqueológico
20240315,2022,8,Cusco,Parque Arqueologico Tipon,1,Enero,0,0,0,0,0,0,3679,938,0,4617,0,0,0,0,222,1976,234,82,2514,7131,Sitio Arqueológico
20240315,2022,8,Cusco,Parque Arqueologico Tipon,1,Enero,1,0,0,0,0,0,635,58,0,693,0,0,0,0,0,0,0,0,0,693,Sitio Arqueológico
20240315,2022,8,Cusco,Parque Arqueologico Tipon,1,Enero,2,0,0,0,0,0,4314,996,0,5310,0,0,0,0,222,1976,234,82,2514,7824,Sitio Arqueológico
20240315,2022,8,Cusco,Parque Arqueologico Tipon,2,Febrero,0,0,0,0,0,0,2255,760,0,3015,0,0,0,0,193,1566,158,61,1978,4993,Sitio Arqueológico
20240315,2022,8,Cusco,Parque Arqueologico Tipon,2,Febrero,1,0,0,0,0,0,389,43,0,432,0,0,0,0,0,0,0,0,0,432,Sitio Arqueológico
20240315,2022,8,Cusco,Parque Arqueologico Tipon,2,Febrero,2,0,0,0,0,0,2644,803,0,3447,0,0,0,0,193,1566,158,61,1978,5425,Sitio Arqueológico
20240315,2022,8,Cusco,Parque Arqueologico Tipon,3,Marzo,0,0,0,0,0,0,2056,403,0,2459,0,0,0,0,194,1127,148,180,1649,4108,Sitio Arqueológico
20240315,2022,8,Cusco,Parque Arqueologico Tipon,3,Marzo,1,0,0,0,0,0,609,58,0,667,0,0,0,0,0,0,0,0,0,667,Sitio Arqueológico
20240315,2022,8,Cusco,Parque Arqueologico Tipon,3,Marzo,2,0,0,0,0,0,2665,461,0,3126,0,0,0,0,194,1127,148,180,1649,4775,Sitio Arqueológico
20240315,2022,8,Cusco,Parque Arqueologico Tipon,4,Abril,0,0,0,0,0,0,2094,254,0,2348,0,0,0,0,195,1076,169,58,1498,3846,Sitio Arqueológico
20240315,2022,8,Cusco,Parque Arqueologico Tipon,4,Abril,1,0,0,0,0,0,1422,83,0,1505,0,0,0,0,0,0,0,0,0,1505,Sitio Arqueológico
20240315,2022,8,Cusco,Parque Arqueologico Tipon,4,Abril,2,0,0,0,0,0,3516,337,0,3853,0,0,0,0,195,1076,169,58,1498,5351,Sitio Arqueológico
20240315,2022,8,Cusco,Parque Arqueologico Tipon,5,Mayo,0,0,0,0,0,0,3353,714,0,4067,0,0,0,0,235,1050,182,70,1537,5604,Sitio Arqueológico
20240315,2022,8,Cusco,Parque Arqueologico Tipon,5,Mayo,1,0,0,0,0,0,1538,113,0,1651,0,0,0,0,0,0,0,0,0,1651,Sitio Arqueológico
20240315,2022,8,Cusco,Parque Arqueologico Tipon,5,Mayo,2,0,0,0,0,0,4891,827,0,5718,0,0,0,0,235,1050,182,70,1537,7255,Sitio Arqueológico
20240315,2022,8,Cusco,Parque Arqueologico Tipon,6,Junio,0,0,0,0,0,0,2951,405,0,3356,0,0,0,0,225,842,241,256,1564,4920,Sitio Arqueológico
20240315,2022,8,Cusco,Parque Arqueologico Tipon,6,Junio,1,0,0,0,0,0,1527,138,0,1665,0,0,0,0,0,0,0,0,0,1665,Sitio Arqueológico
20240315,2022,8,Cusco,Parque Arqueologico Tipon,6,Junio,2,0,0,0,0,0,4478,543,0,5021,0,0,0,0,225,842,241,256,1564,6585,Sitio Arqueológico
20240315,2022,8,Cusco,Parque Arqueologico Tipon,7,Julio,0,0,0,0,0,0,5283,1445,0,6728,0,0,0,0,314,994,311,191,1810,8538,Sitio Arqueológico
20240315,2022,8,Cusco,Parque Arqueologico Tipon,7,Julio,1,0,0,0,0,0,2063,331,0,2394,0,0,0,0,0,0,0,0,0,2394,Sitio Arqueológico
20240315,2022,8,Cusco,Parque Arqueologico Tipon,7,Julio,2,0,0,0,0,0,7346,1776,0,9122,0,0,0,0,314,994,311,191,1810,10932,Sitio Arqueológico
20240315,2022,8,Cusco,Parque Arqueologico Tipon,8,Agosto,0,0,0,0,0,0,6246,1382,0,7628,0,0,0,0,24,1078,308,114,1524,9152,Sitio Arqueológico
20240315,2022,8,Cusco,Parque Arqueologico Tipon,8,Agosto,1,0,0,0,0,0,1800,233,0,2033,0,0,0,0,0,0,0,0,0,2033,Sitio Arqueológico
20240315,2022,8,Cusco,Parque Arqueologico Tipon,8,Agosto,2,0,0,0,0,0,8046,1615,0,9661,0,0,0,0,24,1078,308,114,1524,11185,Sitio Arqueológico
20240315,2022,8,Cusco,Parque Arqueologico Tipon,9,Setiembre,0,0,0,0,0,0,3700,695,0,4395,0,0,0,0,210,943,354,2506,4013,8408,Sitio Arqueológico
20240315,2022,8,Cusco,Parque Arqueologico Tipon,9,Setiembre,1,0,0,0,0,0,1608,91,0,1699,0,0,0,0,0,0,0,0,0,1699,Sitio Arqueológico
20240315,2022,8,Cusco,Parque Arqueologico Tipon,9,Setiembre,2,0,0,0,0,0,5308,786,0,6094,0,0,0,0,210,943,354,2506,4013,10107,Sitio Arqueológico
20240315,2022,8,Cusco,Parque Arqueologico Tipon,10,Octubre,0,0,0,0,0,0,4150,1599,0,5749,0,0,0,0,228,797,269,289,1583,7332,Sitio Arqueológico
20240315,2022,8,Cusco,Parque Arqueologico Tipon,10,Octubre,1,0,0,0,0,0,1774,63,0,1837,0,0,0,0,0,0,0,0,0,1837,Sitio Arqueológico
20240315,2022,8,Cusco,Parque Arqueologico Tipon,10,Octubre,2,0,0,0,0,0,5924,1662,0,7586,0,0,0,0,228,797,269,289,1583,9169,Sitio Arqueológico
20240315,2022,8,Cusco,Parque Arqueologico Tipon,11,Noviembre,0,0,0,0,0,0,1990,977,0,2967,0,0,0,0,175,705,202,168,1250,4217,Sitio Arqueológico
20240315,2022,8,Cusco,Parque Arqueologico Tipon,11,Noviembre,1,0,0,0,0,0,990,52,0,1042,0,0,0,0,0,0,0,0,0,1042,Sitio Arqueológico
20240315,2022,8,Cusco,Parque Arqueologico Tipon,11,Noviembre,2,0,0,0,0,0,2980,1029,0,4009,0,0,0,0,175,705,202,168,1250,5259,Sitio Arqueológico
20240315,2022,8,Cusco,Parque Arqueologico Tipon,12,Diciembre,0,0,0,0,0,0,1342,246,0,1588,0,0,0,0,145,638,124,122,1029,2617,Sitio Arqueológico
20240315,2022,8,Cusco,Parque Arqueologico Tipon,12,Diciembre,1,0,0,0,0,0,519,63,0,582,0,0,0,0,0,0,0,0,0,582,Sitio Arqueológico
20240315,2022,8,Cusco,Parque Arqueologico Tipon,12,Diciembre,2,0,0,0,0,0,1861,309,0,2170,0,0,0,0,145,638,124,122,1029,3199,Sitio Arqueológico
20240315,2022,8,Cusco,Monumento Arqueologico de Tarawasi,1,Enero,0,0,0,0,0,0,37,0,0,37,0,0,0,0,0,67,130,32,229,266,Sitio Arqueológico
20240315,2022,8,Cusco,Monumento Arqueologico de Tarawasi,1,Enero,1,0,0,0,0,0,0,0,0,0,0,0,0,0,0,0,0,0,0,0,Sitio Arqueológico
20240315,2022,8,Cusco,Monumento Arqueologico de Tarawasi,1,Enero,2,0,0,0,0,0,37,0,0,37,0,0,0,0,0,67,130,32,229,266,Sitio Arqueológico
20240315,2022,8,Cusco,Monumento Arqueologico de Tarawasi,2,Febrero,0,0,0,0,0,0,20,2,0,22,0,0,0,0,0,65,122,141,328,350,Sitio Arqueológico
20240315,2022,8,Cusco,Monumento Arqueologico de Tarawasi,2,Febrero,1,0,0,0,0,0,0,0,0,0,0,0,0,0,0,0,0,0,0,0,Sitio Arqueológico
20240315,2022,8,Cusco,Monumento Arqueologico de Tarawasi,2,Febrero,2,0,0,0,0,0,20,2,0,22,0,0,0,0,0,65,122,141,328,350,Sitio Arqueológico
20240315,2022,8,Cusco,Monumento Arqueologico de Tarawasi,3,Marzo,0,0,0,0,0,0,38,3,0,41,0,0,0,0,0,67,130,32,229,270,Sitio Arqueológico
20240315,2022,8,Cusco,Monumento Arqueologico de Tarawasi,3,Marzo,1,0,0,0,0,0,0,0,0,0,0,0,0,0,0,0,0,0,0,0,Sitio Arqueológico
20240315,2022,8,Cusco,Monumento Arqueologico de Tarawasi,3,Marzo,2,0,0,0,0,0,38,3,0,41,0,0,0,0,0,67,130,32,229,270,Sitio Arqueológico
20240315,2022,8,Cusco,Monumento Arqueologico de Tarawasi,4,Abril,0,0,0,0,0,0,21,2,0,23,0,0,0,0,0,30,82,60,172,195,Sitio Arqueológico
20240315,2022,8,Cusco,Monumento Arqueologico de Tarawasi,4,Abril,1,0,0,0,0,0,0,0,0,0,0,0,0,0,0,0,0,0,0,0,Sitio Arqueológico
20240315,2022,8,Cusco,Monumento Arqueologico de Tarawasi,4,Abril,2,0,0,0,0,0,21,2,0,23,0,0,0,0,0,30,82,60,172,195,Sitio Arqueológico
20240315,2022,8,Cusco,Monumento Arqueologico de Tarawasi,5,Mayo,0,0,0,0,0,0,39,0,0,39,0,0,273,0,0,109,82,43,507,546,Sitio Arqueológico
20240315,2022,8,Cusco,Monumento Arqueologico de Tarawasi,5,Mayo,1,0,0,0,0,0,0,0,0,0,0,0,0,0,0,0,0,0,0,0,Sitio Arqueológico
20240315,2022,8,Cusco,Monumento Arqueologico de Tarawasi,5,Mayo,2,0,0,0,0,0,39,0,0,39,0,0,273,0,0,109,82,43,507,546,Sitio Arqueológico
20240315,2022,8,Cusco,Monumento Arqueologico de Tarawasi,6,Junio,0,0,0,0,0,0,0,6,40,46,0,0,0,0,0,126,78,54,258,304,Sitio Arqueológico
20240315,2022,8,Cusco,Monumento Arqueologico de Tarawasi,6,Junio,1,0,0,0,0,0,0,0,0,0,0,0,0,0,0,0,0,0,0,0,Sitio Arqueológico
20240315,2022,8,Cusco,Monumento Arqueologico de Tarawasi,6,Junio,2,0,0,0,0,0,0,6,40,46,0,0,0,0,0,126,78,54,258,304,Sitio Arqueológico
20240315,2022,8,Cusco,Monumento Arqueologico de Tarawasi,7,Julio,0,0,0,0,0,0,0,6,64,70,0,0,0,0,0,126,78,54,258,328,Sitio Arqueológico
20240315,2022,8,Cusco,Monumento Arqueologico de Tarawasi,7,Julio,1,0,0,0,0,0,0,0,0,0,0,0,0,0,0,0,0,0,0,0,Sitio Arqueológico
20240315,2022,8,Cusco,Monumento Arqueologico de Tarawasi,7,Julio,2,0,0,0,0,0,0,6,64,70,0,0,0,0,0,126,78,54,258,328,Sitio Arqueológico
20240315,2022,8,Cusco,Monumento Arqueologico de Tarawasi,8,Agosto,0,0,0,0,0,0,64,2,0,66,0,0,0,0,0,120,80,51,251,317,Sitio Arqueológico
20240315,2022,8,Cusco,Monumento Arqueologico de Tarawasi,8,Agosto,1,0,0,0,0,0,0,0,0,0,0,0,0,0,0,0,0,0,0,0,Sitio Arqueológico
20240315,2022,8,Cusco,Monumento Arqueologico de Tarawasi,8,Agosto,2,0,0,0,0,0,64,2,0,66,0,0,0,0,0,120,80,51,251,317,Sitio Arqueológico
20240315,2022,8,Cusco,Monumento Arqueologico de Tarawasi,9,Setiembre,0,0,0,0,0,0,90,0,0,90,0,0,0,0,0,98,84,34,216,306,Sitio Arqueológico
20240315,2022,8,Cusco,Monumento Arqueologico de Tarawasi,9,Setiembre,1,0,0,0,0,0,0,0,0,0,0,0,0,0,0,0,0,0,0,0,Sitio Arqueológico
20240315,2022,8,Cusco,Monumento Arqueologico de Tarawasi,9,Setiembre,2,0,0,0,0,0,90,0,0,90,0,0,0,0,0,98,84,34,216,306,Sitio Arqueológico
20240315,2022,8,Cusco,Monumento Arqueologico de Tarawasi,10,Octubre,0,0,0,0,0,0,0,0,0,0,0,0,0,0,0,120,80,51,251,251,Sitio Arqueológico
20240315,2022,8,Cusco,Monumento Arqueologico de Tarawasi,10,Octubre,1,0,0,0,0,0,88,4,0,92,0,0,0,0,0,0,0,0,0,92,Sitio Arqueológico
20240315,2022,8,Cusco,Monumento Arqueologico de Tarawasi,10,Octubre,2,0,0,0,0,0,88,4,0,92,0,0,0,0,0,120,80,51,251,343,Sitio Arqueológico
20240315,2022,8,Cusco,Monumento Arqueologico de Tarawasi,11,Noviembre,0,0,0,0,0,0,38,2,0,40,0,0,0,0,0,120,80,51,251,291,Sitio Arqueológico
20240315,2022,8,Cusco,Monumento Arqueologico de Tarawasi,11,Noviembre,1,0,0,0,0,0,0,0,0,0,0,0,0,0,0,0,0,0,0,0,Sitio Arqueológico
20240315,2022,8,Cusco,Monumento Arqueologico de Tarawasi,11,Noviembre,2,0,0,0,0,0,38,2,0,40,0,0,0,0,0,120,80,51,251,291,Sitio Arqueológico
20240315,2022,8,Cusco,Monumento Arqueologico de Tarawasi,12,Diciembre,0,0,0,0,0,0,16,2,0,18,0,0,0,0,0,120,80,51,251,269,Sitio Arqueológico
20240315,2022,8,Cusco,Monumento Arqueologico de Tarawasi,12,Diciembre,1,0,0,0,0,0,0,0,0,0,0,0,0,0,0,0,0,0,0,0,Sitio Arqueológico
20240315,2022,8,Cusco,Monumento Arqueologico de Tarawasi,12,Diciembre,2,0,0,0,0,0,16,2,0,18,0,0,0,0,0,120,80,51,251,269,Sitio Arqueológico
20240315,2022,8,Cusco,Parque Arqueologico Nacional de Vilcabamba (Choquequirao),1,Enero,0,0,0,0,0,0,101,86,0,187,0,0,0,0,0,2,3,0,5,192,Sitio Arqueológico
20240315,2022,8,Cusco,Parque Arqueologico Nacional de Vilcabamba (Choquequirao),1,Enero,1,0,0,0,0,0,31,19,0,50,0,0,0,0,0,0,0,0,0,50,Sitio Arqueológico
20240315,2022,8,Cusco,Parque Arqueologico Nacional de Vilcabamba (Choquequirao),1,Enero,2,0,0,0,0,0,132,105,0,237,0,0,0,0,0,2,3,0,5,242,Sitio Arqueológico
20240315,2022,8,Cusco,Parque Arqueologico Nacional de Vilcabamba (Choquequirao),2,Febrero,0,0,0,0,0,0,3,8,0,11,0,0,0,0,0,0,0,0,0,11,Sitio Arqueológico
20240315,2022,8,Cusco,Parque Arqueologico Nacional de Vilcabamba (Choquequirao),2,Febrero,1,0,0,0,0,0,3,2,0,5,0,0,0,0,0,0,0,0,0,5,Sitio Arqueológico
20240315,2022,8,Cusco,Parque Arqueologico Nacional de Vilcabamba (Choquequirao),2,Febrero,2,0,0,0,0,0,6,10,0,16,0,0,0,0,0,0,0,0,0,16,Sitio Arqueológico
20240315,2022,8,Cusco,Parque Arqueologico Nacional de Vilcabamba (Choquequirao),3,Marzo,0,0,0,0,0,0,53,53,0,106,0,0,0,0,0,6,12,0,18,124,Sitio Arqueológico
20240315,2022,8,Cusco,Parque Arqueologico Nacional de Vilcabamba (Choquequirao),3,Marzo,1,0,0,0,0,0,129,23,0,152,0,0,0,0,0,0,0,0,0,152,Sitio Arqueológico
20240315,2022,8,Cusco,Parque Arqueologico Nacional de Vilcabamba (Choquequirao),3,Marzo,2,0,0,0,0,0,182,76,0,258,0,0,0,0,0,6,12,0,18,276,Sitio Arqueológico
20240315,2022,8,Cusco,Parque Arqueologico Nacional de Vilcabamba (Choquequirao),4,Abril,0,0,0,0,0,0,300,144,0,444,0,0,0,0,0,4,13,0,17,461,Sitio Arqueológico
20240315,2022,8,Cusco,Parque Arqueologico Nacional de Vilcabamba (Choquequirao),4,Abril,1,0,0,0,0,0,233,23,0,256,0,0,0,0,0,0,0,0,0,256,Sitio Arqueológico
20240315,2022,8,Cusco,Parque Arqueologico Nacional de Vilcabamba (Choquequirao),4,Abril,2,0,0,0,0,0,533,167,0,700,0,0,0,0,0,4,13,0,17,717,Sitio Arqueológico
20240315,2022,8,Cusco,Parque Arqueologico Nacional de Vilcabamba (Choquequirao),5,Mayo,0,0,0,0,0,0,142,130,0,272,0,0,0,0,0,5,25,0,30,302,Sitio Arqueológico
20240315,2022,8,Cusco,Parque Arqueologico Nacional de Vilcabamba (Choquequirao),5,Mayo,1,0,0,0,0,0,342,62,0,404,0,0,0,0,0,0,0,0,0,404,Sitio Arqueológico
20240315,2022,8,Cusco,Parque Arqueologico Nacional de Vilcabamba (Choquequirao),5,Mayo,2,0,0,0,0,0,484,192,0,676,0,0,0,0,0,5,25,0,30,706,Sitio Arqueológico
20240315,2022,8,Cusco,Parque Arqueologico Nacional de Vilcabamba (Choquequirao),6,Junio,0,0,0,0,0,0,92,39,0,131,0,0,0,0,0,3,3,0,6,137,Sitio Arqueológico
20240315,2022,8,Cusco,Parque Arqueologico Nacional de Vilcabamba (Choquequirao),6,Junio,1,0,0,0,0,0,251,8,0,259,0,0,0,0,0,0,0,0,0,259,Sitio Arqueológico
20240315,2022,8,Cusco,Parque Arqueologico Nacional de Vilcabamba (Choquequirao),6,Junio,2,0,0,0,0,0,343,47,0,390,0,0,0,0,0,3,3,0,6,396,Sitio Arqueológico
20240315,2022,8,Cusco,Parque Arqueologico Nacional de Vilcabamba (Choquequirao),7,Julio,0,0,0,0,0,0,241,342,0,583,0,0,0,0,0,26,16,0,42,625,Sitio Arqueológico
20240315,2022,8,Cusco,Parque Arqueologico Nacional de Vilcabamba (Choquequirao),7,Julio,1,0,0,0,0,0,313,97,0,410,0,0,0,0,0,0,0,0,0,410,Sitio Arqueológico
20240315,2022,8,Cusco,Parque Arqueologico Nacional de Vilcabamba (Choquequirao),7,Julio,2,0,0,0,0,0,554,439,0,993,0,0,0,0,0,26,16,0,42,1035,Sitio Arqueológico
20240315,2022,8,Cusco,Parque Arqueologico Nacional de Vilcabamba (Choquequirao),8,Agosto,0,0,0,0,0,0,26,211,0,237,0,0,0,0,0,23,16,0,39,276,Sitio Arqueológico
20240315,2022,8,Cusco,Parque Arqueologico Nacional de Vilcabamba (Choquequirao),8,Agosto,1,0,0,0,0,0,331,90,0,421,0,0,0,0,0,0,0,0,0,421,Sitio Arqueológico
20240315,2022,8,Cusco,Parque Arqueologico Nacional de Vilcabamba (Choquequirao),8,Agosto,2,0,0,0,0,0,357,301,0,658,0,0,0,0,0,23,16,0,39,697,Sitio Arqueológico
20240315,2022,8,Cusco,Parque Arqueologico Nacional de Vilcabamba (Choquequirao),9,Setiembre,0,0,0,0,0,0,166,143,0,309,0,0,0,0,0,23,76,0,99,408,Sitio Arqueológico
20240315,2022,8,Cusco,Parque Arqueologico Nacional de Vilcabamba (Choquequirao),9,Setiembre,1,0,0,0,0,0,227,59,0,286,0,0,0,0,0,0,0,0,0,286,Sitio Arqueológico
20240315,2022,8,Cusco,Parque Arqueologico Nacional de Vilcabamba (Choquequirao),9,Setiembre,2,0,0,0,0,0,393,202,0,595,0,0,0,0,0,23,76,0,99,694,Sitio Arqueológico
20240315,2022,8,Cusco,Parque Arqueologico Nacional de Vilcabamba (Choquequirao),10,Octubre,0,0,0,0,0,0,122,62,0,184,0,0,0,0,0,76,28,0,104,288,Sitio Arqueológico
20240315,2022,8,Cusco,Parque Arqueologico Nacional de Vilcabamba (Choquequirao),10,Octubre,1,0,0,0,0,0,98,44,0,142,0,0,0,0,0,0,0,0,0,142,Sitio Arqueológico
20240315,2022,8,Cusco,Parque Arqueologico Nacional de Vilcabamba (Choquequirao),10,Octubre,2,0,0,0,0,0,220,106,0,326,0,0,0,0,0,76,28,0,104,430,Sitio Arqueológico
20240315,2022,8,Cusco,Parque Arqueologico Nacional de Vilcabamba (Choquequirao),11,Noviembre,0,0,0,0,0,0,43,35,0,78,0,0,0,0,0,17,34,0,51,129,Sitio Arqueológico
20240315,2022,8,Cusco,Parque Arqueologico Nacional de Vilcabamba (Choquequirao),11,Noviembre,1,0,0,0,0,0,110,52,0,162,0,0,0,0,0,0,0,0,0,162,Sitio Arqueológico
20240315,2022,8,Cusco,Parque Arqueologico Nacional de Vilcabamba (Choquequirao),11,Noviembre,2,0,0,0,0,0,153,87,0,240,0,0,0,0,0,17,34,0,51,291,Sitio Arqueológico
20240315,2022,8,Cusco,Parque Arqueologico Nacional de Vilcabamba (Choquequirao),12,Diciembre,0,0,0,0,0,0,0,0,0,0,0,0,0,0,0,0,0,0,0,0,Sitio Arqueológico
20240315,2022,8,Cusco,Parque Arqueologico Nacional de Vilcabamba (Choquequirao),12,Diciembre,1,0,0,0,0,0,0,0,0,0,0,0,0,0,0,0,0,0,0,0,Sitio Arqueológico
20240315,2022,8,Cusco,Parque Arqueologico Nacional de Vilcabamba (Choquequirao),12,Diciembre,2,0,0,0,0,0,0,0,0,0,0,0,0,0,0,0,0,0,0,0,Sitio Arqueológico
20240315,2022,8,Cusco,Conjunto Arqueologico de Huchuy Qosco,1,Enero,0,0,0,0,0,0,37,0,0,37,0,0,0,0,0,127,173,61,361,398,Sitio Arqueológico
20240315,2022,8,Cusco,Conjunto Arqueologico de Huchuy Qosco,1,Enero,1,0,0,0,0,0,66,0,0,66,0,0,0,0,0,0,0,0,0,66,Sitio Arqueológico
20240315,2022,8,Cusco,Conjunto Arqueologico de Huchuy Qosco,1,Enero,2,0,0,0,0,0,103,0,0,103,0,0,0,0,0,127,173,61,361,464,Sitio Arqueológico
20240315,2022,8,Cusco,Conjunto Arqueologico de Huchuy Qosco,2,Febrero,0,0,0,0,0,0,18,0,0,18,0,0,0,0,0,0,0,0,0,18,Sitio Arqueológico
20240315,2022,8,Cusco,Conjunto Arqueologico de Huchuy Qosco,2,Febrero,1,0,0,0,0,0,43,0,0,43,0,0,0,0,0,0,0,0,0,43,Sitio Arqueológico
20240315,2022,8,Cusco,Conjunto Arqueologico de Huchuy Qosco,2,Febrero,2,0,0,0,0,0,61,0,0,61,0,0,0,0,0,0,0,0,0,61,Sitio Arqueológico
20240315,2022,8,Cusco,Conjunto Arqueologico de Huchuy Qosco,3,Marzo,0,0,0,0,0,0,19,0,0,19,0,0,0,0,0,127,173,61,361,380,Sitio Arqueológico
20240315,2022,8,Cusco,Conjunto Arqueologico de Huchuy Qosco,3,Marzo,1,0,0,0,0,0,102,0,0,102,0,0,0,0,0,0,0,0,0,102,Sitio Arqueológico
20240315,2022,8,Cusco,Conjunto Arqueologico de Huchuy Qosco,3,Marzo,2,0,0,0,0,0,121,0,0,121,0,0,0,0,0,127,173,61,361,482,Sitio Arqueológico
20240315,2022,8,Cusco,Conjunto Arqueologico de Huchuy Qosco,4,Abril,0,0,0,0,0,0,51,0,0,51,0,0,0,0,0,88,214,35,337,388,Sitio Arqueológico
20240315,2022,8,Cusco,Conjunto Arqueologico de Huchuy Qosco,4,Abril,1,0,0,0,0,0,145,0,0,145,0,0,0,0,0,0,0,0,0,145,Sitio Arqueológico
20240315,2022,8,Cusco,Conjunto Arqueologico de Huchuy Qosco,4,Abril,2,0,0,0,0,0,196,0,0,196,0,0,0,0,0,88,214,35,337,533,Sitio Arqueológico
20240315,2022,8,Cusco,Conjunto Arqueologico de Huchuy Qosco,5,Mayo,0,0,0,0,0,0,64,0,0,64,0,0,0,0,0,94,166,32,292,356,Sitio Arqueológico
20240315,2022,8,Cusco,Conjunto Arqueologico de Huchuy Qosco,5,Mayo,1,0,0,0,0,0,144,0,0,144,0,0,0,0,0,0,0,0,0,144,Sitio Arqueológico
20240315,2022,8,Cusco,Conjunto Arqueologico de Huchuy Qosco,5,Mayo,2,0,0,0,0,0,208,0,0,208,0,0,0,0,0,94,166,32,292,500,Sitio Arqueológico
20240315,2022,8,Cusco,Conjunto Arqueologico de Huchuy Qosco,6,Junio,0,0,0,0,0,0,59,0,0,59,0,0,0,0,0,133,105,17,255,314,Sitio Arqueológico
20240315,2022,8,Cusco,Conjunto Arqueologico de Huchuy Qosco,6,Junio,1,0,0,0,0,0,152,0,0,152,0,0,0,0,0,0,0,0,0,152,Sitio Arqueológico
20240315,2022,8,Cusco,Conjunto Arqueologico de Huchuy Qosco,6,Junio,2,0,0,0,0,0,211,0,0,211,0,0,0,0,0,133,105,17,255,466,Sitio Arqueológico
20240315,2022,8,Cusco,Conjunto Arqueologico de Huchuy Qosco,7,Julio,0,0,0,0,0,0,24,0,0,24,0,0,0,0,0,99,206,48,353,377,Sitio Arqueológico
20240315,2022,8,Cusco,Conjunto Arqueologico de Huchuy Qosco,7,Julio,1,0,0,0,0,0,98,0,0,98,0,0,0,0,0,0,0,0,0,98,Sitio Arqueológico
20240315,2022,8,Cusco,Conjunto Arqueologico de Huchuy Qosco,7,Julio,2,0,0,0,0,0,122,0,0,122,0,0,0,0,0,99,206,48,353,475,Sitio Arqueológico
20240315,2022,8,Cusco,Conjunto Arqueologico de Huchuy Qosco,8,Agosto,0,0,0,0,0,0,32,0,0,32,0,0,0,0,0,58,74,20,152,184,Sitio Arqueológico
20240315,2022,8,Cusco,Conjunto Arqueologico de Huchuy Qosco,8,Agosto,1,0,0,0,0,0,361,0,0,361,0,0,0,0,0,0,0,0,0,361,Sitio Arqueológico
20240315,2022,8,Cusco,Conjunto Arqueologico de Huchuy Qosco,8,Agosto,2,0,0,0,0,0,393,0,0,393,0,0,0,0,0,58,74,20,152,545,Sitio Arqueológico
20240315,2022,8,Cusco,Conjunto Arqueologico de Huchuy Qosco,9,Setiembre,0,0,0,0,0,0,35,0,0,35,0,0,0,0,0,61,100,16,177,212,Sitio Arqueológico
20240315,2022,8,Cusco,Conjunto Arqueologico de Huchuy Qosco,9,Setiembre,1,0,0,0,0,0,155,0,0,155,0,0,0,0,0,0,0,0,0,155,Sitio Arqueológico
20240315,2022,8,Cusco,Conjunto Arqueologico de Huchuy Qosco,9,Setiembre,2,0,0,0,0,0,190,0,0,190,0,0,0,0,0,61,100,16,177,367,Sitio Arqueológico
20240315,2022,8,Cusco,Conjunto Arqueologico de Huchuy Qosco,10,Octubre,0,0,0,0,0,0,22,0,0,22,0,0,0,0,0,79,123,14,216,238,Sitio Arqueológico
20240315,2022,8,Cusco,Conjunto Arqueologico de Huchuy Qosco,10,Octubre,1,0,0,0,0,0,203,0,0,203,0,0,0,0,0,0,0,0,0,203,Sitio Arqueológico
20240315,2022,8,Cusco,Conjunto Arqueologico de Huchuy Qosco,10,Octubre,2,0,0,0,0,0,225,0,0,225,0,0,0,0,0,79,123,14,216,441,Sitio Arqueológico
20240315,2022,8,Cusco,Conjunto Arqueologico de Huchuy Qosco,11,Noviembre,0,0,0,0,0,0,29,0,0,29,0,0,0,0,0,40,85,22,147,176,Sitio Arqueológico
20240315,2022,8,Cusco,Conjunto Arqueologico de Huchuy Qosco,11,Noviembre,1,0,0,0,0,0,98,0,0,98,0,0,0,0,0,0,0,0,0,98,Sitio Arqueológico
20240315,2022,8,Cusco,Conjunto Arqueologico de Huchuy Qosco,11,Noviembre,2,0,0,0,0,0,127,0,0,127,0,0,0,0,0,40,85,22,147,274,Sitio Arqueológico
20240315,2022,8,Cusco,Conjunto Arqueologico de Huchuy Qosco,12,Diciembre,0,0,0,0,0,0,14,0,0,14,0,0,0,0,0,57,76,12,145,159,Sitio Arqueológico
20240315,2022,8,Cusco,Conjunto Arqueologico de Huchuy Qosco,12,Diciembre,1,0,0,0,0,0,42,0,0,42,0,0,0,0,0,0,0,0,0,42,Sitio Arqueológico
20240315,2022,8,Cusco,Conjunto Arqueologico de Huchuy Qosco,12,Diciembre,2,0,0,0,0,0,56,0,0,56,0,0,0,0,0,57,76,12,145,201,Sitio Arqueológico
20240315,2022,8,Cusco,Parque Arqueologico Machu Picchu,1,Enero,0,0,0,0,0,0,24933,919,5133,30985,0,0,0,0,0,0,0,0,0,30985,Sitio Arqueológico
20240315,2022,8,Cusco,Parque Arqueologico Machu Picchu,1,Enero,1,0,0,0,0,0,18538,471,1006,20015,0,0,0,0,0,0,0,0,0,20015,Sitio Arqueológico
20240315,2022,8,Cusco,Parque Arqueologico Machu Picchu,1,Enero,2,0,0,0,0,0,43471,1390,6139,51000,0,0,0,0,0,0,0,0,0,51000,Sitio Arqueológico
20240315,2022,8,Cusco,Parque Arqueologico Machu Picchu,2,Febrero,0,0,0,0,0,0,16034,594,4016,20644,0,0,0,0,0,1526,0,0,1526,22170,Sitio Arqueológico
20240315,2022,8,Cusco,Parque Arqueologico Machu Picchu,2,Febrero,1,0,0,0,0,0,15465,389,619,16473,0,0,0,0,0,0,0,0,0,16473,Sitio Arqueológico
20240315,2022,8,Cusco,Parque Arqueologico Machu Picchu,2,Febrero,2,0,0,0,0,0,31499,983,4635,37117,0,0,0,0,0,1526,0,0,1526,38643,Sitio Arqueológico
20240315,2022,8,Cusco,Parque Arqueologico Machu Picchu,3,Marzo,0,0,0,0,0,0,15496,584,2552,18632,0,0,0,0,0,1756,0,0,1756,20388,Sitio Arqueológico
20240315,2022,8,Cusco,Parque Arqueologico Machu Picchu,3,Marzo,1,0,0,0,0,0,32235,708,1404,34347,0,0,0,0,0,0,0,0,0,34347,Sitio Arqueológico
20240315,2022,8,Cusco,Parque Arqueologico Machu Picchu,3,Marzo,2,0,0,0,0,0,47731,1292,3956,52979,0,0,0,0,0,1756,0,0,1756,54735,Sitio Arqueológico
20240315,2022,8,Cusco,Parque Arqueologico Machu Picchu,4,Abril,0,0,0,0,0,0,1510,0,0,1510,0,0,0,0,0,14725,398,1543,16666,18176,Sitio Arqueológico
20240315,2022,8,Cusco,Parque Arqueologico Machu Picchu,4,Abril,1,0,0,0,0,0,51612,784,2430,54826,0,0,0,0,0,0,0,0,0,54826,Sitio Arqueológico
20240315,2022,8,Cusco,Parque Arqueologico Machu Picchu,4,Abril,2,0,0,0,0,0,53122,784,2430,56336,0,0,0,0,0,14725,398,1543,16666,73002,Sitio Arqueológico
20240315,2022,8,Cusco,Parque Arqueologico Machu Picchu,5,Mayo,0,0,0,0,0,0,18634,557,3307,22498,0,0,0,0,0,2042,0,0,2042,24540,Sitio Arqueológico
20240315,2022,8,Cusco,Parque Arqueologico Machu Picchu,5,Mayo,1,0,0,0,0,0,1003,1030,63790,65823,0,0,0,0,0,0,0,0,0,65823,Sitio Arqueológico
20240315,2022,8,Cusco,Parque Arqueologico Machu Picchu,5,Mayo,2,0,0,0,0,0,19637,1587,67097,88321,0,0,0,0,0,2042,0,0,2042,90363,Sitio Arqueológico
20240315,2022,8,Cusco,Parque Arqueologico Machu Picchu,6,Junio,0,0,0,0,0,0,20420,440,2213,23073,0,0,0,0,0,1554,0,0,1554,24627,Sitio Arqueológico
20240315,2022,8,Cusco,Parque Arqueologico Machu Picchu,6,Junio,1,0,0,0,0,0,64909,1609,3904,70422,0,0,0,0,0,0,0,0,0,70422,Sitio Arqueológico
20240315,2022,8,Cusco,Parque Arqueologico Machu Picchu,6,Junio,2,0,0,0,0,0,85329,2049,6117,93495,0,0,0,0,0,1554,0,0,1554,95049,Sitio Arqueológico
20240315,2022,8,Cusco,Parque Arqueologico Machu Picchu,7,Julio,0,0,0,0,0,0,27942,940,5747,34629,0,0,0,0,0,2058,0,0,2058,36687,Sitio Arqueológico
20240315,2022,8,Cusco,Parque Arqueologico Machu Picchu,7,Julio,1,0,0,0,0,0,68031,2098,7118,77247,0,0,0,0,0,0,0,0,0,77247,Sitio Arqueológico
20240315,2022,8,Cusco,Parque Arqueologico Machu Picchu,7,Julio,2,0,0,0,0,0,95973,3038,12865,111876,0,0,0,0,0,2058,0,0,2058,113934,Sitio Arqueológico
20240315,2022,8,Cusco,Parque Arqueologico Machu Picchu,8,Agosto,0,0,0,0,0,0,34282,1667,7219,43168,0,0,0,0,0,1477,0,0,1477,44645,Sitio Arqueológico
20240315,2022,8,Cusco,Parque Arqueologico Machu Picchu,8,Agosto,1,0,0,0,0,0,72520,1860,4680,79060,0,0,0,0,0,0,0,0,0,79060,Sitio Arqueológico
20240315,2022,8,Cusco,Parque Arqueologico Machu Picchu,8,Agosto,2,0,0,0,0,0,106802,3527,11899,122228,0,0,0,0,0,1477,0,0,1477,123705,Sitio Arqueológico
20240315,2022,8,Cusco,Parque Arqueologico Machu Picchu,9,Setiembre,0,0,0,0,0,0,22757,643,3929,27329,0,0,0,0,0,1661,0,0,1661,28990,Sitio Arqueológico
20240315,2022,8,Cusco,Parque Arqueologico Machu Picchu,9,Setiembre,1,0,0,0,0,0,73941,878,1431,76250,0,0,0,0,0,0,0,0,0,76250,Sitio Arqueológico
20240315,2022,8,Cusco,Parque Arqueologico Machu Picchu,9,Setiembre,2,0,0,0,0,0,96698,1521,5360,103579,0,0,0,0,0,1661,0,0,1661,105240,Sitio Arqueológico
20240315,2022,8,Cusco,Parque Arqueologico Machu Picchu,10,Octubre,0,0,0,0,0,0,23328,1153,8998,33479,0,0,0,0,0,2456,0,0,2456,35935,Sitio Arqueológico
20240315,2022,8,Cusco,Parque Arqueologico Machu Picchu,10,Octubre,1,0,0,0,0,0,70489,700,1694,72883,0,0,0,0,0,0,0,0,0,72883,Sitio Arqueológico
20240315,2022,8,Cusco,Parque Arqueologico Machu Picchu,10,Octubre,2,0,0,0,0,0,93817,1853,10692,106362,0,0,0,0,0,2456,0,0,2456,108818,Sitio Arqueológico
20240315,2022,8,Cusco,Parque Arqueologico Machu Picchu,11,Noviembre,0,0,0,0,0,0,16318,489,5342,22149,0,0,0,0,0,2882,0,0,2882,25031,Sitio Arqueológico
20240315,2022,8,Cusco,Parque Arqueologico Machu Picchu,11,Noviembre,1,0,0,0,0,0,60454,665,1736,62855,0,0,0,0,0,0,0,0,0,62855,Sitio Arqueológico
20240315,2022,8,Cusco,Parque Arqueologico Machu Picchu,11,Noviembre,2,0,0,0,0,0,76772,1154,7078,85004,0,0,0,0,0,2882,0,0,2882,87886,Sitio Arqueológico
20240315,2022,8,Cusco,Parque Arqueologico Machu Picchu,12,Diciembre,0,0,0,0,0,0,9612,331,2194,12137,0,0,0,0,0,1093,0,0,1093,13230,Sitio Arqueológico
20240315,2022,8,Cusco,Parque Arqueologico Machu Picchu,12,Diciembre,1,0,0,0,0,0,22006,599,1058,23663,0,0,0,0,0,0,0,0,0,23663,Sitio Arqueológico
20240315,2022,8,Cusco,Parque Arqueologico Machu Picchu,12,Diciembre,2,0,0,0,0,0,31618,930,3252,35800,0,0,0,0,0,1093,0,0,1093,36893,Sitio Arqueológico
20240315,2022,8,Cusco,Santuario Historico de Machu Picchu,1,Enero,0,0,0,0,0,0,2,0,0,2,0,0,0,0,0,354,34,3,391,393,Sitio Arqueológico
20240315,2022,8,Cusco,Santuario Historico de Machu Picchu,1,Enero,1,0,0,0,0,0,20,0,0,20,0,0,0,0,0,205,5,0,210,230,Sitio Arqueológico
20240315,2022,8,Cusco,Santuario Historico de Machu Picchu,1,Enero,2,0,0,0,0,0,22,0,0,22,0,0,0,0,0,559,39,3,601,623,Sitio Arqueológico
20240315,2022,8,Cusco,Santuario Historico de Machu Picchu,2,Febrero,0,0,0,0,0,0,0,0,0,0,0,0,0,0,0,0,0,0,0,0,Sitio Arqueológico
20240315,2022,8,Cusco,Santuario Historico de Machu Picchu,2,Febrero,1,0,0,0,0,0,0,0,0,0,0,0,0,0,0,0,0,0,0,0,Sitio Arqueológico
20240315,2022,8,Cusco,Santuario Historico de Machu Picchu,2,Febrero,2,0,0,0,0,0,0,0,0,0,0,0,0,0,0,0,0,0,0,0,Sitio Arqueológico
20240315,2022,8,Cusco,Santuario Historico de Machu Picchu,3,Marzo,0,0,0,0,0,0,8,0,0,8,0,0,0,0,0,504,15,29,548,556,Sitio Arqueológico
20240315,2022,8,Cusco,Santuario Historico de Machu Picchu,3,Marzo,1,0,0,0,0,0,53,3,0,56,0,0,0,0,0,604,2,0,606,662,Sitio Arqueológico
20240315,2022,8,Cusco,Santuario Historico de Machu Picchu,3,Marzo,2,0,0,0,0,0,61,3,0,64,0,0,0,0,0,1108,17,29,1154,1218,Sitio Arqueológico
20240315,2022,8,Cusco,Santuario Historico de Machu Picchu,4,Abril,0,0,0,0,0,0,15,0,0,15,0,0,0,0,0,472,20,9,501,516,Sitio Arqueológico
20240315,2022,8,Cusco,Santuario Historico de Machu Picchu,4,Abril,1,0,0,0,0,0,95,1,0,96,0,0,0,0,0,846,18,0,864,960,Sitio Arqueológico
20240315,2022,8,Cusco,Santuario Historico de Machu Picchu,4,Abril,2,0,0,0,0,0,110,1,0,111,0,0,0,0,0,1318,38,9,1365,1476,Sitio Arqueológico
20240315,2022,8,Cusco,Santuario Historico de Machu Picchu,5,Mayo,0,0,0,0,0,0,8,0,0,8,0,0,0,0,0,446,37,6,489,497,Sitio Arqueológico
20240315,2022,8,Cusco,Santuario Historico de Machu Picchu,5,Mayo,1,0,0,0,0,0,144,3,0,147,0,0,0,0,0,1091,11,0,1102,1249,Sitio Arqueológico
20240315,2022,8,Cusco,Santuario Historico de Machu Picchu,5,Mayo,2,0,0,0,0,0,152,3,0,155,0,0,0,0,0,1537,48,6,1591,1746,Sitio Arqueológico
20240315,2022,8,Cusco,Santuario Historico de Machu Picchu,6,Junio,0,0,0,0,0,0,14,1,0,15,0,0,0,0,0,477,40,4,521,536,Sitio Arqueológico
20240315,2022,8,Cusco,Santuario Historico de Machu Picchu,6,Junio,1,0,0,0,0,0,151,4,0,155,0,0,0,0,0,1029,18,0,1047,1202,Sitio Arqueológico
20240315,2022,8,Cusco,Santuario Historico de Machu Picchu,6,Junio,2,0,0,0,0,0,165,5,0,170,0,0,0,0,0,1506,58,4,1568,1738,Sitio Arqueológico
20240315,2022,8,Cusco,Santuario Historico de Machu Picchu,7,Julio,0,0,0,0,0,0,22,0,0,22,0,0,0,0,0,501,68,0,569,591,Sitio Arqueológico
20240315,2022,8,Cusco,Santuario Historico de Machu Picchu,7,Julio,1,0,0,0,0,0,179,1,0,180,0,0,0,0,0,1119,34,0,1153,1333,Sitio Arqueológico
20240315,2022,8,Cusco,Santuario Historico de Machu Picchu,7,Julio,2,0,0,0,0,0,201,1,0,202,0,0,0,0,0,1620,102,0,1722,1924,Sitio Arqueológico
20240315,2022,8,Cusco,Santuario Historico de Machu Picchu,8,Agosto,0,0,0,0,0,0,24,1,0,25,0,0,0,0,0,502,76,21,599,624,Sitio Arqueológico
20240315,2022,8,Cusco,Santuario Historico de Machu Picchu,8,Agosto,1,0,0,0,0,0,171,4,0,175,0,0,0,0,0,1143,14,0,1157,1332,Sitio Arqueológico
20240315,2022,8,Cusco,Santuario Historico de Machu Picchu,8,Agosto,2,0,0,0,0,0,195,5,0,200,0,0,0,0,0,1645,90,21,1756,1956,Sitio Arqueológico
20240315,2022,8,Cusco,Santuario Historico de Machu Picchu,9,Setiembre,0,0,0,0,0,0,12,0,0,12,0,0,0,0,0,477,100,4,581,593,Sitio Arqueológico
20240315,2022,8,Cusco,Santuario Historico de Machu Picchu,9,Setiembre,1,0,0,0,0,0,158,1,0,159,0,0,0,0,0,981,9,0,990,1149,Sitio Arqueológico
20240315,2022,8,Cusco,Santuario Historico de Machu Picchu,9,Setiembre,2,0,0,0,0,0,170,1,0,171,0,0,0,0,0,1458,109,4,1571,1742,Sitio Arqueológico
20240315,2022,8,Cusco,Santuario Historico de Machu Picchu,10,Octubre,0,0,0,0,0,0,32,2,0,34,0,0,0,0,0,545,138,0,683,717,Sitio Arqueológico
20240315,2022,8,Cusco,Santuario Historico de Machu Picchu,10,Octubre,1,0,0,0,0,0,138,0,0,138,0,0,0,0,0,993,11,0,1004,1142,Sitio Arqueológico
20240315,2022,8,Cusco,Santuario Historico de Machu Picchu,10,Octubre,2,0,0,0,0,0,170,2,0,172,0,0,0,0,0,1538,149,0,1687,1859,Sitio Arqueológico
20240315,2022,8,Cusco,Santuario Historico de Machu Picchu,11,Noviembre,0,0,0,0,0,0,23,0,0,23,0,0,0,0,0,489,439,1,929,952,Sitio Arqueológico
20240315,2022,8,Cusco,Santuario Historico de Machu Picchu,11,Noviembre,1,0,0,0,0,0,136,4,0,140,0,0,0,0,0,1138,15,0,1153,1293,Sitio Arqueológico
20240315,2022,8,Cusco,Santuario Historico de Machu Picchu,11,Noviembre,2,0,0,0,0,0,159,4,0,163,0,0,0,0,0,1627,454,1,2082,2245,Sitio Arqueológico
20240315,2022,8,Cusco,Santuario Historico de Machu Picchu,12,Diciembre,0,0,0,0,0,0,5,0,0,5,0,0,0,0,0,423,158,1,582,587,Sitio Arqueológico
20240315,2022,8,Cusco,Santuario Historico de Machu Picchu,12,Diciembre,1,0,0,0,0,0,62,0,0,62,0,0,0,0,0,681,22,0,703,765,Sitio Arqueológico
20240315,2022,8,Cusco,Santuario Historico de Machu Picchu,12,Diciembre,2,0,0,0,0,0,67,0,0,67,0,0,0,0,0,1104,180,1,1285,1352,Sitio Arqueológico
20240315,2022,8,Cusco,Parque Arqueologico Macchu Picchu (Ingreso Salkantay-Paucarcancha),1,Enero,0,0,0,0,0,0,0,0,0,0,0,0,0,0,0,0,0,0,0,0,Sitio Arqueológico
20240315,2022,8,Cusco,Parque Arqueologico Macchu Picchu (Ingreso Salkantay-Paucarcancha),1,Enero,1,0,0,0,0,0,5,0,0,5,0,0,0,0,0,0,0,0,0,5,Sitio Arqueológico
20240315,2022,8,Cusco,Parque Arqueologico Macchu Picchu (Ingreso Salkantay-Paucarcancha),1,Enero,2,0,0,0,0,0,5,0,0,5,0,0,0,0,0,0,0,0,0,5,Sitio Arqueológico
20240315,2022,8,Cusco,Parque Arqueologico Macchu Picchu (Ingreso Salkantay-Paucarcancha),2,Febrero,0,0,0,0,0,0,0,0,0,0,0,0,0,0,0,0,0,0,0,0,Sitio Arqueológico
20240315,2022,8,Cusco,Parque Arqueologico Macchu Picchu (Ingreso Salkantay-Paucarcancha),2,Febrero,1,0,0,0,0,0,0,0,0,0,0,0,0,0,0,0,0,0,0,0,Sitio Arqueológico
20240315,2022,8,Cusco,Parque Arqueologico Macchu Picchu (Ingreso Salkantay-Paucarcancha),2,Febrero,2,0,0,0,0,0,0,0,0,0,0,0,0,0,0,0,0,0,0,0,Sitio Arqueológico
20240315,2022,8,Cusco,Parque Arqueologico Macchu Picchu (Ingreso Salkantay-Paucarcancha),3,Marzo,0,0,0,0,0,0,0,0,0,0,0,0,0,0,0,0,0,0,0,0,Sitio Arqueológico
20240315,2022,8,Cusco,Parque Arqueologico Macchu Picchu (Ingreso Salkantay-Paucarcancha),3,Marzo,1,0,0,0,0,0,21,0,0,21,0,0,0,0,0,0,0,0,0,21,Sitio Arqueológico
20240315,2022,8,Cusco,Parque Arqueologico Macchu Picchu (Ingreso Salkantay-Paucarcancha),3,Marzo,2,0,0,0,0,0,21,0,0,21,0,0,0,0,0,0,0,0,0,21,Sitio Arqueológico
20240315,2022,8,Cusco,Parque Arqueologico Macchu Picchu (Ingreso Salkantay-Paucarcancha),4,Abril,0,0,0,0,0,0,0,0,0,0,0,0,0,0,0,0,0,0,0,0,Sitio Arqueológico
20240315,2022,8,Cusco,Parque Arqueologico Macchu Picchu (Ingreso Salkantay-Paucarcancha),4,Abril,1,0,0,0,0,0,55,1,0,56,0,0,0,0,0,0,0,0,0,56,Sitio Arqueológico
20240315,2022,8,Cusco,Parque Arqueologico Macchu Picchu (Ingreso Salkantay-Paucarcancha),4,Abril,2,0,0,0,0,0,55,1,0,56,0,0,0,0,0,0,0,0,0,56,Sitio Arqueológico
20240315,2022,8,Cusco,Parque Arqueologico Macchu Picchu (Ingreso Salkantay-Paucarcancha),5,Mayo,0,0,0,0,0,0,0,0,0,0,0,0,0,0,0,0,0,0,0,0,Sitio Arqueológico
20240315,2022,8,Cusco,Parque Arqueologico Macchu Picchu (Ingreso Salkantay-Paucarcancha),5,Mayo,1,0,0,0,0,0,0,0,119,119,0,0,0,0,0,0,0,0,0,119,Sitio Arqueológico
20240315,2022,8,Cusco,Parque Arqueologico Macchu Picchu (Ingreso Salkantay-Paucarcancha),5,Mayo,2,0,0,0,0,0,0,0,119,119,0,0,0,0,0,0,0,0,0,119,Sitio Arqueológico
20240315,2022,8,Cusco,Parque Arqueologico Macchu Picchu (Ingreso Salkantay-Paucarcancha),6,Junio,0,0,0,0,0,0,0,0,0,0,0,0,0,0,0,0,0,0,0,0,Sitio Arqueológico
20240315,2022,8,Cusco,Parque Arqueologico Macchu Picchu (Ingreso Salkantay-Paucarcancha),6,Junio,1,0,0,0,0,0,41,2,0,43,0,0,0,0,0,0,0,0,0,43,Sitio Arqueológico
20240315,2022,8,Cusco,Parque Arqueologico Macchu Picchu (Ingreso Salkantay-Paucarcancha),6,Junio,2,0,0,0,0,0,41,2,0,43,0,0,0,0,0,0,0,0,0,43,Sitio Arqueológico
20240315,2022,8,Cusco,Parque Arqueologico Macchu Picchu (Ingreso Salkantay-Paucarcancha),7,Julio,0,0,0,0,0,0,0,0,0,0,0,0,0,0,0,0,0,0,0,0,Sitio Arqueológico
20240315,2022,8,Cusco,Parque Arqueologico Macchu Picchu (Ingreso Salkantay-Paucarcancha),7,Julio,1,0,0,0,0,0,67,5,0,72,0,0,0,0,0,0,0,0,0,72,Sitio Arqueológico
20240315,2022,8,Cusco,Parque Arqueologico Macchu Picchu (Ingreso Salkantay-Paucarcancha),7,Julio,2,0,0,0,0,0,67,5,0,72,0,0,0,0,0,0,0,0,0,72,Sitio Arqueológico
20240315,2022,8,Cusco,Parque Arqueologico Macchu Picchu (Ingreso Salkantay-Paucarcancha),8,Agosto,0,0,0,0,0,0,15,0,7,22,0,0,0,0,0,2,1,0,3,25,Sitio Arqueológico
20240315,2022,8,Cusco,Parque Arqueologico Macchu Picchu (Ingreso Salkantay-Paucarcancha),8,Agosto,1,0,0,0,0,0,3172,274,0,3446,0,0,0,0,0,0,0,0,0,3446,Sitio Arqueológico
20240315,2022,8,Cusco,Parque Arqueologico Macchu Picchu (Ingreso Salkantay-Paucarcancha),8,Agosto,2,0,0,0,0,0,3187,274,7,3468,0,0,0,0,0,2,1,0,3,3471,Sitio Arqueológico
20240315,2022,8,Cusco,Parque Arqueologico Macchu Picchu (Ingreso Salkantay-Paucarcancha),9,Setiembre,0,0,0,0,0,0,0,0,0,0,0,0,0,0,0,0,0,0,0,0,Sitio Arqueológico
20240315,2022,8,Cusco,Parque Arqueologico Macchu Picchu (Ingreso Salkantay-Paucarcancha),9,Setiembre,1,0,0,0,0,0,123,0,0,123,0,0,0,0,0,0,0,0,0,123,Sitio Arqueológico
20240315,2022,8,Cusco,Parque Arqueologico Macchu Picchu (Ingreso Salkantay-Paucarcancha),9,Setiembre,2,0,0,0,0,0,123,0,0,123,0,0,0,0,0,0,0,0,0,123,Sitio Arqueológico
20240315,2022,8,Cusco,Parque Arqueologico Macchu Picchu (Ingreso Salkantay-Paucarcancha),10,Octubre,0,0,0,0,0,0,0,0,0,0,0,0,0,0,0,77,0,0,77,77,Sitio Arqueológico
20240315,2022,8,Cusco,Parque Arqueologico Macchu Picchu (Ingreso Salkantay-Paucarcancha),10,Octubre,1,0,0,0,0,0,0,0,0,0,0,0,0,0,0,0,0,0,0,0,Sitio Arqueológico
20240315,2022,8,Cusco,Parque Arqueologico Macchu Picchu (Ingreso Salkantay-Paucarcancha),10,Octubre,2,0,0,0,0,0,0,0,0,0,0,0,0,0,0,77,0,0,77,77,Sitio Arqueológico
20240315,2022,8,Cusco,Parque Arqueologico Macchu Picchu (Ingreso Salkantay-Paucarcancha),11,Noviembre,0,0,0,0,0,0,0,0,0,0,0,0,0,0,0,0,0,0,0,0,Sitio Arqueológico
20240315,2022,8,Cusco,Parque Arqueologico Macchu Picchu (Ingreso Salkantay-Paucarcancha),11,Noviembre,1,0,0,0,0,0,80,0,0,80,0,0,0,0,0,0,0,0,0,80,Sitio Arqueológico
20240315,2022,8,Cusco,Parque Arqueologico Macchu Picchu (Ingreso Salkantay-Paucarcancha),11,Noviembre,2,0,0,0,0,0,80,0,0,80,0,0,0,0,0,0,0,0,0,80,Sitio Arqueológico
20240315,2022,8,Cusco,Parque Arqueologico Macchu Picchu (Ingreso Salkantay-Paucarcancha),12,Diciembre,0,0,0,0,0,0,0,0,0,0,0,0,0,0,0,22,0,0,22,22,Sitio Arqueológico
20240315,2022,8,Cusco,Parque Arqueologico Macchu Picchu (Ingreso Salkantay-Paucarcancha),12,Diciembre,1,0,0,0,0,0,0,0,0,0,0,0,0,0,0,0,0,0,0,0,Sitio Arqueológico
20240315,2022,8,Cusco,Parque Arqueologico Macchu Picchu (Ingreso Salkantay-Paucarcancha),12,Diciembre,2,0,0,0,0,0,0,0,0,0,0,0,0,0,0,22,0,0,22,22,Sitio Arqueológico
20240315,2022,10,Huanuco,Zona Arqueologica Monumental de Garu,1,Enero,0,0,0,0,0,0,0,0,0,0,0,0,0,0,0,0,0,0,0,0,Sitio Arqueológico
20240315,2022,10,Huanuco,Zona Arqueologica Monumental de Garu,1,Enero,1,0,0,0,0,0,0,0,0,0,0,0,0,0,0,0,0,0,0,0,Sitio Arqueológico
20240315,2022,10,Huanuco,Zona Arqueologica Monumental de Garu,1,Enero,2,0,0,0,0,0,0,0,0,0,0,0,0,0,0,0,0,0,0,0,Sitio Arqueológico
20240315,2022,10,Huanuco,Zona Arqueologica Monumental de Garu,2,Febrero,0,0,0,0,0,0,0,0,0,0,0,0,0,0,0,0,0,0,0,0,Sitio Arqueológico
20240315,2022,10,Huanuco,Zona Arqueologica Monumental de Garu,2,Febrero,1,0,0,0,0,0,0,0,0,0,0,0,0,0,0,0,0,0,0,0,Sitio Arqueológico
20240315,2022,10,Huanuco,Zona Arqueologica Monumental de Garu,2,Febrero,2,0,0,0,0,0,0,0,0,0,0,0,0,0,0,0,0,0,0,0,Sitio Arqueológico
20240315,2022,10,Huanuco,Zona Arqueologica Monumental de Garu,3,Marzo,0,0,0,0,0,0,0,0,0,0,0,0,0,0,0,0,0,0,0,0,Sitio Arqueológico
20240315,2022,10,Huanuco,Zona Arqueologica Monumental de Garu,3,Marzo,1,0,0,0,0,0,0,0,0,0,0,0,0,0,0,0,0,0,0,0,Sitio Arqueológico
20240315,2022,10,Huanuco,Zona Arqueologica Monumental de Garu,3,Marzo,2,0,0,0,0,0,0,0,0,0,0,0,0,0,0,0,0,0,0,0,Sitio Arqueológico
20240315,2022,10,Huanuco,Zona Arqueologica Monumental de Garu,4,Abril,0,0,0,0,0,0,0,0,0,0,0,0,0,0,0,0,0,0,0,0,Sitio Arqueológico
20240315,2022,10,Huanuco,Zona Arqueologica Monumental de Garu,4,Abril,1,0,0,0,0,0,0,0,0,0,0,0,0,0,0,0,0,0,0,0,Sitio Arqueológico
20240315,2022,10,Huanuco,Zona Arqueologica Monumental de Garu,4,Abril,2,0,0,0,0,0,0,0,0,0,0,0,0,0,0,0,0,0,0,0,Sitio Arqueológico
20240315,2022,10,Huanuco,Zona Arqueologica Monumental de Garu,5,Mayo,0,0,0,0,0,0,0,0,0,0,0,0,0,0,0,0,0,0,0,0,Sitio Arqueológico
20240315,2022,10,Huanuco,Zona Arqueologica Monumental de Garu,5,Mayo,1,0,0,0,0,0,0,0,0,0,0,0,0,0,0,0,0,0,0,0,Sitio Arqueológico
20240315,2022,10,Huanuco,Zona Arqueologica Monumental de Garu,5,Mayo,2,0,0,0,0,0,0,0,0,0,0,0,0,0,0,0,0,0,0,0,Sitio Arqueológico
20240315,2022,10,Huanuco,Zona Arqueologica Monumental de Garu,6,Junio,0,0,0,0,0,0,0,0,0,0,0,0,0,0,0,0,0,0,0,0,Sitio Arqueológico
20240315,2022,10,Huanuco,Zona Arqueologica Monumental de Garu,6,Junio,1,0,0,0,0,0,0,0,0,0,0,0,0,0,0,0,0,0,0,0,Sitio Arqueológico
20240315,2022,10,Huanuco,Zona Arqueologica Monumental de Garu,6,Junio,2,0,0,0,0,0,0,0,0,0,0,0,0,0,0,0,0,0,0,0,Sitio Arqueológico
20240315,2022,10,Huanuco,Zona Arqueologica Monumental de Garu,7,Julio,0,0,0,0,0,0,0,0,0,0,0,0,0,0,0,0,0,0,0,0,Sitio Arqueológico
20240315,2022,10,Huanuco,Zona Arqueologica Monumental de Garu,7,Julio,1,0,0,0,0,0,0,0,0,0,0,0,0,0,0,0,0,0,0,0,Sitio Arqueológico
20240315,2022,10,Huanuco,Zona Arqueologica Monumental de Garu,7,Julio,2,0,0,0,0,0,0,0,0,0,0,0,0,0,0,0,0,0,0,0,Sitio Arqueológico
20240315,2022,10,Huanuco,Zona Arqueologica Monumental de Garu,8,Agosto,0,0,0,0,0,0,0,0,0,0,0,0,0,0,0,0,0,0,0,0,Sitio Arqueológico
20240315,2022,10,Huanuco,Zona Arqueologica Monumental de Garu,8,Agosto,1,0,0,0,0,0,0,0,0,0,0,0,0,0,0,0,0,0,0,0,Sitio Arqueológico
20240315,2022,10,Huanuco,Zona Arqueologica Monumental de Garu,8,Agosto,2,0,0,0,0,0,0,0,0,0,0,0,0,0,0,0,0,0,0,0,Sitio Arqueológico
20240315,2022,10,Huanuco,Zona Arqueologica Monumental de Garu,9,Setiembre,0,0,0,0,0,0,0,0,0,0,0,0,0,0,0,0,0,0,0,0,Sitio Arqueológico
20240315,2022,10,Huanuco,Zona Arqueologica Monumental de Garu,9,Setiembre,1,0,0,0,0,0,0,0,0,0,0,0,0,0,0,0,0,0,0,0,Sitio Arqueológico
20240315,2022,10,Huanuco,Zona Arqueologica Monumental de Garu,9,Setiembre,2,0,0,0,0,0,0,0,0,0,0,0,0,0,0,0,0,0,0,0,Sitio Arqueológico
20240315,2022,10,Huanuco,Zona Arqueologica Monumental de Garu,10,Octubre,0,0,0,0,0,0,0,0,0,0,0,0,0,0,0,0,0,0,0,0,Sitio Arqueológico
20240315,2022,10,Huanuco,Zona Arqueologica Monumental de Garu,10,Octubre,1,0,0,0,0,0,0,0,0,0,0,0,0,0,0,0,0,0,0,0,Sitio Arqueológico
20240315,2022,10,Huanuco,Zona Arqueologica Monumental de Garu,10,Octubre,2,0,0,0,0,0,0,0,0,0,0,0,0,0,0,0,0,0,0,0,Sitio Arqueológico
20240315,2022,10,Huanuco,Zona Arqueologica Monumental de Garu,11,Noviembre,0,0,0,0,0,0,85,77,158,320,0,0,0,0,0,6,0,0,6,326,Sitio Arqueológico
20240315,2022,10,Huanuco,Zona Arqueologica Monumental de Garu,11,Noviembre,1,0,0,0,0,0,0,0,0,0,0,0,0,0,0,0,0,0,0,0,Sitio Arqueológico
20240315,2022,10,Huanuco,Zona Arqueologica Monumental de Garu,11,Noviembre,2,0,0,0,0,0,85,77,158,320,0,0,0,0,0,6,0,0,6,326,Sitio Arqueológico
20240315,2022,10,Huanuco,Zona Arqueologica Monumental de Garu,12,Diciembre,0,0,0,0,0,0,33,0,0,33,0,0,0,0,0,0,0,0,0,33,Sitio Arqueológico
20240315,2022,10,Huanuco,Zona Arqueologica Monumental de Garu,12,Diciembre,1,0,0,0,0,0,0,0,0,0,0,0,0,0,0,0,0,0,0,0,Sitio Arqueológico
20240315,2022,10,Huanuco,Zona Arqueologica Monumental de Garu,12,Diciembre,2,0,0,0,0,0,33,0,0,33,0,0,0,0,0,0,0,0,0,33,Sitio Arqueológico
20240315,2022,10,Huanuco,Huanucopampa,1,Enero,0,0,0,0,0,0,267,147,84,498,0,0,0,0,0,195,58,51,304,802,Sitio Arqueológico
20240315,2022,10,Huanuco,Huanucopampa,1,Enero,1,0,0,0,0,0,0,0,0,0,0,0,0,0,0,0,0,0,0,0,Sitio Arqueológico
20240315,2022,10,Huanuco,Huanucopampa,1,Enero,2,0,0,0,0,0,267,147,84,498,0,0,0,0,0,195,58,51,304,802,Sitio Arqueológico
20240315,2022,10,Huanuco,Huanucopampa,2,Febrero,0,0,0,0,0,0,215,118,56,389,0,0,0,0,0,78,29,14,121,510,Sitio Arqueológico
20240315,2022,10,Huanuco,Huanucopampa,2,Febrero,1,0,0,0,0,0,0,0,0,0,0,0,0,0,0,0,0,0,0,0,Sitio Arqueológico
20240315,2022,10,Huanuco,Huanucopampa,2,Febrero,2,0,0,0,0,0,215,118,56,389,0,0,0,0,0,78,29,14,121,510,Sitio Arqueológico
20240315,2022,10,Huanuco,Huanucopampa,3,Marzo,0,0,0,0,0,0,144,73,35,252,0,0,0,0,0,29,10,8,47,299,Sitio Arqueológico
20240315,2022,10,Huanuco,Huanucopampa,3,Marzo,1,0,0,0,0,0,3,0,0,3,0,0,0,0,0,0,0,0,0,3,Sitio Arqueológico
20240315,2022,10,Huanuco,Huanucopampa,3,Marzo,2,0,0,0,0,0,147,73,35,255,0,0,0,0,0,29,10,8,47,302,Sitio Arqueológico
20240315,2022,10,Huanuco,Huanucopampa,4,Abril,0,0,0,0,0,0,448,181,114,743,0,0,0,0,0,29,8,7,44,787,Sitio Arqueológico
20240315,2022,10,Huanuco,Huanucopampa,4,Abril,1,0,0,0,0,0,0,0,0,0,0,0,0,0,0,0,0,0,0,0,Sitio Arqueológico
20240315,2022,10,Huanuco,Huanucopampa,4,Abril,2,0,0,0,0,0,448,181,114,743,0,0,0,0,0,29,8,7,44,787,Sitio Arqueológico
20240315,2022,10,Huanuco,Huanucopampa,5,Mayo,0,0,0,0,0,0,492,197,87,776,0,0,0,0,0,84,38,24,146,922,Sitio Arqueológico
20240315,2022,10,Huanuco,Huanucopampa,5,Mayo,1,0,0,0,0,0,0,0,0,0,0,0,0,0,0,0,0,0,0,0,Sitio Arqueológico
20240315,2022,10,Huanuco,Huanucopampa,5,Mayo,2,0,0,0,0,0,492,197,87,776,0,0,0,0,0,84,38,24,146,922,Sitio Arqueológico
20240315,2022,10,Huanuco,Huanucopampa,6,Junio,0,0,0,0,0,0,344,221,157,722,0,0,0,0,0,46,18,10,74,796,Sitio Arqueológico
20240315,2022,10,Huanuco,Huanucopampa,6,Junio,1,0,0,0,0,0,8,0,0,8,0,0,0,0,0,0,0,0,0,8,Sitio Arqueológico
20240315,2022,10,Huanuco,Huanucopampa,6,Junio,2,0,0,0,0,0,352,221,157,730,0,0,0,0,0,46,18,10,74,804,Sitio Arqueológico
20240315,2022,10,Huanuco,Huanucopampa,7,Julio,0,0,0,0,0,0,1139,522,320,1981,0,0,0,0,0,65,23,18,106,2087,Sitio Arqueológico
20240315,2022,10,Huanuco,Huanucopampa,7,Julio,1,0,0,0,0,0,12,0,0,12,0,0,0,0,0,0,0,0,0,12,Sitio Arqueológico
20240315,2022,10,Huanuco,Huanucopampa,7,Julio,2,0,0,0,0,0,1151,522,320,1993,0,0,0,0,0,65,23,18,106,2099,Sitio Arqueológico
20240315,2022,10,Huanuco,Huanucopampa,8,Agosto,0,0,0,0,0,0,645,334,167,1146,0,0,0,0,0,82,28,13,123,1269,Sitio Arqueológico
20240315,2022,10,Huanuco,Huanucopampa,8,Agosto,1,0,0,0,0,0,14,0,0,14,0,0,0,0,0,0,0,0,0,14,Sitio Arqueológico
20240315,2022,10,Huanuco,Huanucopampa,8,Agosto,2,0,0,0,0,0,659,334,167,1160,0,0,0,0,0,82,28,13,123,1283,Sitio Arqueológico
20240315,2022,10,Huanuco,Huanucopampa,9,Setiembre,0,0,0,0,0,0,402,389,855,1646,0,0,0,0,0,68,23,18,109,1755,Sitio Arqueológico
20240315,2022,10,Huanuco,Huanucopampa,9,Setiembre,1,0,0,0,0,0,0,0,0,0,0,0,0,0,0,0,0,0,0,0,Sitio Arqueológico
20240315,2022,10,Huanuco,Huanucopampa,9,Setiembre,2,0,0,0,0,0,402,389,855,1646,0,0,0,0,0,68,23,18,109,1755,Sitio Arqueológico
20240315,2022,10,Huanuco,Huanucopampa,10,Octubre,0,0,0,0,0,0,440,362,293,1095,0,0,0,0,0,18,7,4,29,1124,Sitio Arqueológico
20240315,2022,10,Huanuco,Huanucopampa,10,Octubre,1,0,0,0,0,0,7,0,0,7,0,0,0,0,0,0,0,0,0,7,Sitio Arqueológico
20240315,2022,10,Huanuco,Huanucopampa,10,Octubre,2,0,0,0,0,0,447,362,293,1102,0,0,0,0,0,18,7,4,29,1131,Sitio Arqueológico
20240315,2022,10,Huanuco,Huanucopampa,11,Noviembre,0,0,0,0,0,0,345,444,352,1141,0,0,0,0,0,48,30,12,90,1231,Sitio Arqueológico
20240315,2022,10,Huanuco,Huanucopampa,11,Noviembre,1,0,0,0,0,0,3,0,0,3,0,0,0,0,0,0,0,0,0,3,Sitio Arqueológico
20240315,2022,10,Huanuco,Huanucopampa,11,Noviembre,2,0,0,0,0,0,348,444,352,1144,0,0,0,0,0,48,30,12,90,1234,Sitio Arqueológico
20240315,2022,10,Huanuco,Huanucopampa,12,Diciembre,0,0,0,0,0,0,415,180,179,774,0,0,0,0,0,38,17,12,67,841,Sitio Arqueológico
20240315,2022,10,Huanuco,Huanucopampa,12,Diciembre,1,0,0,0,0,0,4,0,0,4,0,0,0,0,0,0,0,0,0,4,Sitio Arqueológico
20240315,2022,10,Huanuco,Huanucopampa,12,Diciembre,2,0,0,0,0,0,419,180,179,778,0,0,0,0,0,38,17,12,67,845,Sitio Arqueológico
20240315,2022,11,Ica,Sitio Arqueologico Pampas de Huayuri,1,Enero,0,0,0,0,0,0,38,5,0,43,0,0,0,0,0,0,0,0,0,43,Sitio Arqueológico
20240315,2022,11,Ica,Sitio Arqueologico Pampas de Huayuri,1,Enero,1,0,0,0,0,0,0,0,0,0,0,0,0,0,0,0,0,0,0,0,Sitio Arqueológico
20240315,2022,11,Ica,Sitio Arqueologico Pampas de Huayuri,1,Enero,2,0,0,0,0,0,38,5,0,43,0,0,0,0,0,0,0,0,0,43,Sitio Arqueológico
20240315,2022,11,Ica,Sitio Arqueologico Pampas de Huayuri,2,Febrero,0,0,0,0,0,0,31,3,0,34,0,0,0,0,0,0,0,0,0,34,Sitio Arqueológico
20240315,2022,11,Ica,Sitio Arqueologico Pampas de Huayuri,2,Febrero,1,0,0,0,0,0,0,0,0,0,0,0,0,0,0,0,0,0,0,0,Sitio Arqueológico
20240315,2022,11,Ica,Sitio Arqueologico Pampas de Huayuri,2,Febrero,2,0,0,0,0,0,31,3,0,34,0,0,0,0,0,0,0,0,0,34,Sitio Arqueológico
20240315,2022,11,Ica,Sitio Arqueologico Pampas de Huayuri,3,Marzo,0,0,0,0,0,0,8,0,0,8,0,0,0,0,0,0,0,0,0,8,Sitio Arqueológico
20240315,2022,11,Ica,Sitio Arqueologico Pampas de Huayuri,3,Marzo,1,0,0,0,0,0,0,0,0,0,0,0,0,0,0,0,0,0,0,0,Sitio Arqueológico
20240315,2022,11,Ica,Sitio Arqueologico Pampas de Huayuri,3,Marzo,2,0,0,0,0,0,8,0,0,8,0,0,0,0,0,0,0,0,0,8,Sitio Arqueológico
20240315,2022,11,Ica,Sitio Arqueologico Pampas de Huayuri,4,Abril,0,0,0,0,0,0,30,15,1,46,0,0,0,0,0,0,0,0,0,46,Sitio Arqueológico
20240315,2022,11,Ica,Sitio Arqueologico Pampas de Huayuri,4,Abril,1,0,0,0,0,0,0,0,0,0,0,0,0,0,0,0,0,0,0,0,Sitio Arqueológico
20240315,2022,11,Ica,Sitio Arqueologico Pampas de Huayuri,4,Abril,2,0,0,0,0,0,30,15,1,46,0,0,0,0,0,0,0,0,0,46,Sitio Arqueológico
20240315,2022,11,Ica,Sitio Arqueologico Pampas de Huayuri,5,Mayo,0,0,0,0,0,0,46,3,2,51,0,0,0,0,0,0,0,0,0,51,Sitio Arqueológico
20240315,2022,11,Ica,Sitio Arqueologico Pampas de Huayuri,5,Mayo,1,0,0,0,0,0,0,0,0,0,0,0,0,0,0,0,0,0,0,0,Sitio Arqueológico
20240315,2022,11,Ica,Sitio Arqueologico Pampas de Huayuri,5,Mayo,2,0,0,0,0,0,46,3,2,51,0,0,0,0,0,0,0,0,0,51,Sitio Arqueológico
20240315,2022,11,Ica,Sitio Arqueologico Pampas de Huayuri,6,Junio,0,0,0,0,0,0,13,3,0,16,0,0,0,0,0,0,0,0,0,16,Sitio Arqueológico
20240315,2022,11,Ica,Sitio Arqueologico Pampas de Huayuri,6,Junio,1,0,0,0,0,0,0,0,0,0,0,0,0,0,0,0,0,0,0,0,Sitio Arqueológico
20240315,2022,11,Ica,Sitio Arqueologico Pampas de Huayuri,6,Junio,2,0,0,0,0,0,13,3,0,16,0,0,0,0,0,0,0,0,0,16,Sitio Arqueológico
20240315,2022,11,Ica,Sitio Arqueologico Pampas de Huayuri,7,Julio,0,0,0,0,0,0,76,24,10,110,0,0,0,0,0,10,0,0,10,120,Sitio Arqueológico
20240315,2022,11,Ica,Sitio Arqueologico Pampas de Huayuri,7,Julio,1,0,0,0,0,0,0,0,0,0,0,0,0,0,0,0,0,0,0,0,Sitio Arqueológico
20240315,2022,11,Ica,Sitio Arqueologico Pampas de Huayuri,7,Julio,2,0,0,0,0,0,76,24,10,110,0,0,0,0,0,10,0,0,10,120,Sitio Arqueológico
20240315,2022,11,Ica,Sitio Arqueologico Pampas de Huayuri,8,Agosto,0,0,0,0,0,0,25,3,3,31,0,0,0,0,0,10,0,0,10,41,Sitio Arqueológico
20240315,2022,11,Ica,Sitio Arqueologico Pampas de Huayuri,8,Agosto,1,0,0,0,0,0,0,0,0,0,0,0,0,0,0,0,0,0,0,0,Sitio Arqueológico
20240315,2022,11,Ica,Sitio Arqueologico Pampas de Huayuri,8,Agosto,2,0,0,0,0,0,25,3,3,31,0,0,0,0,0,10,0,0,10,41,Sitio Arqueológico
20240315,2022,11,Ica,Sitio Arqueologico Pampas de Huayuri,9,Setiembre,0,0,0,0,0,0,18,0,4,22,0,0,0,0,0,8,2,1,11,33,Sitio Arqueológico
20240315,2022,11,Ica,Sitio Arqueologico Pampas de Huayuri,9,Setiembre,1,0,0,0,0,0,0,0,0,0,0,0,0,0,0,0,0,0,0,0,Sitio Arqueológico
20240315,2022,11,Ica,Sitio Arqueologico Pampas de Huayuri,9,Setiembre,2,0,0,0,0,0,18,0,4,22,0,0,0,0,0,8,2,1,11,33,Sitio Arqueológico
20240315,2022,11,Ica,Sitio Arqueologico Pampas de Huayuri,10,Octubre,0,0,0,0,0,0,16,11,12,39,0,0,0,0,0,8,2,2,12,51,Sitio Arqueológico
20240315,2022,11,Ica,Sitio Arqueologico Pampas de Huayuri,10,Octubre,1,0,0,0,0,0,0,0,0,0,0,0,0,0,0,0,0,0,0,0,Sitio Arqueológico
20240315,2022,11,Ica,Sitio Arqueologico Pampas de Huayuri,10,Octubre,2,0,0,0,0,0,16,11,12,39,0,0,0,0,0,8,2,2,12,51,Sitio Arqueológico
20240315,2022,11,Ica,Sitio Arqueologico Pampas de Huayuri,11,Noviembre,0,0,0,0,0,0,24,0,2,26,0,0,0,0,0,0,0,0,0,26,Sitio Arqueológico
20240315,2022,11,Ica,Sitio Arqueologico Pampas de Huayuri,11,Noviembre,1,0,0,0,0,0,8,2,2,12,0,0,0,0,0,0,0,0,0,12,Sitio Arqueológico
20240315,2022,11,Ica,Sitio Arqueologico Pampas de Huayuri,11,Noviembre,2,0,0,0,0,0,32,2,4,38,0,0,0,0,0,0,0,0,0,38,Sitio Arqueológico
20240315,2022,11,Ica,Sitio Arqueologico Pampas de Huayuri,12,Diciembre,0,0,0,0,0,0,0,0,0,0,0,0,0,0,0,0,0,0,0,0,Sitio Arqueológico
20240315,2022,11,Ica,Sitio Arqueologico Pampas de Huayuri,12,Diciembre,1,0,0,0,0,0,0,0,0,0,0,0,0,0,0,0,0,0,0,0,Sitio Arqueológico
20240315,2022,11,Ica,Sitio Arqueologico Pampas de Huayuri,12,Diciembre,2,0,0,0,0,0,0,0,0,0,0,0,0,0,0,0,0,0,0,0,Sitio Arqueológico
20240315,2022,11,Ica,Monumento Arqueologico de Palpa (Lineas y Geoglifos de Sacramento),1,Enero,0,0,0,0,0,0,0,0,0,0,0,0,0,0,0,0,0,0,0,0,Sitio Arqueológico
20240315,2022,11,Ica,Monumento Arqueologico de Palpa (Lineas y Geoglifos de Sacramento),1,Enero,1,0,0,0,0,0,0,0,0,0,0,0,0,0,0,0,0,0,0,0,Sitio Arqueológico
20240315,2022,11,Ica,Monumento Arqueologico de Palpa (Lineas y Geoglifos de Sacramento),1,Enero,2,0,0,0,0,0,0,0,0,0,0,0,0,0,0,0,0,0,0,0,Sitio Arqueológico
20240315,2022,11,Ica,Monumento Arqueologico de Palpa (Lineas y Geoglifos de Sacramento),2,Febrero,0,0,0,0,0,0,0,0,0,0,0,0,0,0,0,0,0,0,0,0,Sitio Arqueológico
20240315,2022,11,Ica,Monumento Arqueologico de Palpa (Lineas y Geoglifos de Sacramento),2,Febrero,1,0,0,0,0,0,0,0,0,0,0,0,0,0,0,0,0,0,0,0,Sitio Arqueológico
20240315,2022,11,Ica,Monumento Arqueologico de Palpa (Lineas y Geoglifos de Sacramento),2,Febrero,2,0,0,0,0,0,0,0,0,0,0,0,0,0,0,0,0,0,0,0,Sitio Arqueológico
20240315,2022,11,Ica,Monumento Arqueologico de Palpa (Lineas y Geoglifos de Sacramento),3,Marzo,0,0,0,0,0,0,15,0,2,17,0,0,0,0,0,0,0,0,0,17,Sitio Arqueológico
20240315,2022,11,Ica,Monumento Arqueologico de Palpa (Lineas y Geoglifos de Sacramento),3,Marzo,1,0,0,0,0,0,0,0,0,0,0,0,0,0,0,0,0,0,0,0,Sitio Arqueológico
20240315,2022,11,Ica,Monumento Arqueologico de Palpa (Lineas y Geoglifos de Sacramento),3,Marzo,2,0,0,0,0,0,15,0,2,17,0,0,0,0,0,0,0,0,0,17,Sitio Arqueológico
20240315,2022,11,Ica,Monumento Arqueologico de Palpa (Lineas y Geoglifos de Sacramento),4,Abril,0,0,0,0,0,0,38,0,3,41,0,0,0,0,0,0,0,0,0,41,Sitio Arqueológico
20240315,2022,11,Ica,Monumento Arqueologico de Palpa (Lineas y Geoglifos de Sacramento),4,Abril,1,0,0,0,0,0,0,0,0,0,0,0,0,0,0,0,0,0,0,0,Sitio Arqueológico
20240315,2022,11,Ica,Monumento Arqueologico de Palpa (Lineas y Geoglifos de Sacramento),4,Abril,2,0,0,0,0,0,38,0,3,41,0,0,0,0,0,0,0,0,0,41,Sitio Arqueológico
20240315,2022,11,Ica,Monumento Arqueologico de Palpa (Lineas y Geoglifos de Sacramento),5,Mayo,0,0,0,0,0,0,32,10,4,46,0,0,0,0,0,0,0,0,0,46,Sitio Arqueológico
20240315,2022,11,Ica,Monumento Arqueologico de Palpa (Lineas y Geoglifos de Sacramento),5,Mayo,1,0,0,0,0,0,0,0,0,0,0,0,0,0,0,0,0,0,0,0,Sitio Arqueológico
20240315,2022,11,Ica,Monumento Arqueologico de Palpa (Lineas y Geoglifos de Sacramento),5,Mayo,2,0,0,0,0,0,32,10,4,46,0,0,0,0,0,0,0,0,0,46,Sitio Arqueológico
20240315,2022,11,Ica,Monumento Arqueologico de Palpa (Lineas y Geoglifos de Sacramento),6,Junio,0,0,0,0,0,0,18,6,1,25,0,0,0,0,0,0,0,0,0,25,Sitio Arqueológico
20240315,2022,11,Ica,Monumento Arqueologico de Palpa (Lineas y Geoglifos de Sacramento),6,Junio,1,0,0,0,0,0,0,0,0,0,0,0,0,0,0,0,0,0,0,0,Sitio Arqueológico
20240315,2022,11,Ica,Monumento Arqueologico de Palpa (Lineas y Geoglifos de Sacramento),6,Junio,2,0,0,0,0,0,18,6,1,25,0,0,0,0,0,0,0,0,0,25,Sitio Arqueológico
20240315,2022,11,Ica,Monumento Arqueologico de Palpa (Lineas y Geoglifos de Sacramento),7,Julio,0,0,0,0,0,0,105,7,22,134,0,0,0,0,0,12,0,0,12,146,Sitio Arqueológico
20240315,2022,11,Ica,Monumento Arqueologico de Palpa (Lineas y Geoglifos de Sacramento),7,Julio,1,0,0,0,0,0,0,0,0,0,0,0,0,0,0,0,0,0,0,0,Sitio Arqueológico
20240315,2022,11,Ica,Monumento Arqueologico de Palpa (Lineas y Geoglifos de Sacramento),7,Julio,2,0,0,0,0,0,105,7,22,134,0,0,0,0,0,12,0,0,12,146,Sitio Arqueológico
20240315,2022,11,Ica,Monumento Arqueologico de Palpa (Lineas y Geoglifos de Sacramento),8,Agosto,0,0,0,0,0,0,105,7,22,134,0,0,0,0,0,12,0,0,12,146,Sitio Arqueológico
20240315,2022,11,Ica,Monumento Arqueologico de Palpa (Lineas y Geoglifos de Sacramento),8,Agosto,1,0,0,0,0,0,0,0,0,0,0,0,0,0,0,0,0,0,0,0,Sitio Arqueológico
20240315,2022,11,Ica,Monumento Arqueologico de Palpa (Lineas y Geoglifos de Sacramento),8,Agosto,2,0,0,0,0,0,105,7,22,134,0,0,0,0,0,12,0,0,12,146,Sitio Arqueológico
20240315,2022,11,Ica,Monumento Arqueologico de Palpa (Lineas y Geoglifos de Sacramento),9,Setiembre,0,0,0,0,0,0,23,3,29,55,0,0,0,0,0,5,1,2,8,63,Sitio Arqueológico
20240315,2022,11,Ica,Monumento Arqueologico de Palpa (Lineas y Geoglifos de Sacramento),9,Setiembre,1,0,0,0,0,0,0,0,0,0,0,0,0,0,0,0,0,0,0,0,Sitio Arqueológico
20240315,2022,11,Ica,Monumento Arqueologico de Palpa (Lineas y Geoglifos de Sacramento),9,Setiembre,2,0,0,0,0,0,23,3,29,55,0,0,0,0,0,5,1,2,8,63,Sitio Arqueológico
20240315,2022,11,Ica,Monumento Arqueologico de Palpa (Lineas y Geoglifos de Sacramento),10,Octubre,0,0,0,0,0,0,29,0,7,36,0,0,0,0,0,8,2,2,12,48,Sitio Arqueológico
20240315,2022,11,Ica,Monumento Arqueologico de Palpa (Lineas y Geoglifos de Sacramento),10,Octubre,1,0,0,0,0,0,0,0,0,0,0,0,0,0,0,0,0,0,0,0,Sitio Arqueológico
20240315,2022,11,Ica,Monumento Arqueologico de Palpa (Lineas y Geoglifos de Sacramento),10,Octubre,2,0,0,0,0,0,29,0,7,36,0,0,0,0,0,8,2,2,12,48,Sitio Arqueológico
20240315,2022,11,Ica,Monumento Arqueologico de Palpa (Lineas y Geoglifos de Sacramento),11,Noviembre,0,0,0,0,0,0,13,9,9,31,0,0,0,0,0,0,0,0,0,31,Sitio Arqueológico
20240315,2022,11,Ica,Monumento Arqueologico de Palpa (Lineas y Geoglifos de Sacramento),11,Noviembre,1,0,0,0,0,0,5,2,2,9,0,0,0,0,0,0,0,0,0,9,Sitio Arqueológico
20240315,2022,11,Ica,Monumento Arqueologico de Palpa (Lineas y Geoglifos de Sacramento),11,Noviembre,2,0,0,0,0,0,18,11,11,40,0,0,0,0,0,0,0,0,0,40,Sitio Arqueológico
20240315,2022,11,Ica,Monumento Arqueologico de Palpa (Lineas y Geoglifos de Sacramento),12,Diciembre,0,0,0,0,0,0,0,0,0,0,0,0,0,0,0,0,0,0,0,0,Sitio Arqueológico
20240315,2022,11,Ica,Monumento Arqueologico de Palpa (Lineas y Geoglifos de Sacramento),12,Diciembre,1,0,0,0,0,0,0,0,0,0,0,0,0,0,0,0,0,0,0,0,Sitio Arqueológico
20240315,2022,11,Ica,Monumento Arqueologico de Palpa (Lineas y Geoglifos de Sacramento),12,Diciembre,2,0,0,0,0,0,0,0,0,0,0,0,0,0,0,0,0,0,0,0,Sitio Arqueológico
20240315,2022,11,Ica,Sitio Arqueologico Centinela,1,Enero,0,0,0,0,0,0,0,0,0,0,0,0,0,0,0,0,0,0,0,0,Sitio Arqueológico
20240315,2022,11,Ica,Sitio Arqueologico Centinela,1,Enero,1,0,0,0,0,0,0,0,0,0,0,0,0,0,0,0,0,0,0,0,Sitio Arqueológico
20240315,2022,11,Ica,Sitio Arqueologico Centinela,1,Enero,2,0,0,0,0,0,0,0,0,0,0,0,0,0,0,0,0,0,0,0,Sitio Arqueológico
20240315,2022,11,Ica,Sitio Arqueologico Centinela,2,Febrero,0,0,0,0,0,0,0,0,0,0,0,0,0,0,0,0,0,0,0,0,Sitio Arqueológico
20240315,2022,11,Ica,Sitio Arqueologico Centinela,2,Febrero,1,0,0,0,0,0,0,0,0,0,0,0,0,0,0,0,0,0,0,0,Sitio Arqueológico
20240315,2022,11,Ica,Sitio Arqueologico Centinela,2,Febrero,2,0,0,0,0,0,0,0,0,0,0,0,0,0,0,0,0,0,0,0,Sitio Arqueológico
20240315,2022,11,Ica,Sitio Arqueologico Centinela,3,Marzo,0,0,0,0,0,0,0,0,0,0,0,0,0,0,0,0,0,0,0,0,Sitio Arqueológico
20240315,2022,11,Ica,Sitio Arqueologico Centinela,3,Marzo,1,0,0,0,0,0,0,0,0,0,0,0,0,0,0,0,0,0,0,0,Sitio Arqueológico
20240315,2022,11,Ica,Sitio Arqueologico Centinela,3,Marzo,2,0,0,0,0,0,0,0,0,0,0,0,0,0,0,0,0,0,0,0,Sitio Arqueológico
20240315,2022,11,Ica,Sitio Arqueologico Centinela,4,Abril,0,0,0,0,0,0,0,0,0,0,0,0,0,0,0,0,0,0,0,0,Sitio Arqueológico
20240315,2022,11,Ica,Sitio Arqueologico Centinela,4,Abril,1,0,0,0,0,0,0,0,0,0,0,0,0,0,0,0,0,0,0,0,Sitio Arqueológico
20240315,2022,11,Ica,Sitio Arqueologico Centinela,4,Abril,2,0,0,0,0,0,0,0,0,0,0,0,0,0,0,0,0,0,0,0,Sitio Arqueológico
20240315,2022,11,Ica,Sitio Arqueologico Centinela,5,Mayo,0,0,0,0,0,0,0,0,0,0,0,0,0,0,0,0,0,0,0,0,Sitio Arqueológico
20240315,2022,11,Ica,Sitio Arqueologico Centinela,5,Mayo,1,0,0,0,0,0,0,0,0,0,0,0,0,0,0,0,0,0,0,0,Sitio Arqueológico
20240315,2022,11,Ica,Sitio Arqueologico Centinela,5,Mayo,2,0,0,0,0,0,0,0,0,0,0,0,0,0,0,0,0,0,0,0,Sitio Arqueológico
20240315,2022,11,Ica,Sitio Arqueologico Centinela,6,Junio,0,0,0,0,0,0,0,0,0,0,0,0,0,0,0,0,0,0,0,0,Sitio Arqueológico
20240315,2022,11,Ica,Sitio Arqueologico Centinela,6,Junio,1,0,0,0,0,0,0,0,0,0,0,0,0,0,0,0,0,0,0,0,Sitio Arqueológico
20240315,2022,11,Ica,Sitio Arqueologico Centinela,6,Junio,2,0,0,0,0,0,0,0,0,0,0,0,0,0,0,0,0,0,0,0,Sitio Arqueológico
20240315,2022,11,Ica,Sitio Arqueologico Centinela,7,Julio,0,0,0,0,0,0,0,0,0,0,0,0,0,0,0,0,0,0,0,0,Sitio Arqueológico
20240315,2022,11,Ica,Sitio Arqueologico Centinela,7,Julio,1,0,0,0,0,0,0,0,0,0,0,0,0,0,0,0,0,0,0,0,Sitio Arqueológico
20240315,2022,11,Ica,Sitio Arqueologico Centinela,7,Julio,2,0,0,0,0,0,0,0,0,0,0,0,0,0,0,0,0,0,0,0,Sitio Arqueológico
20240315,2022,11,Ica,Sitio Arqueologico Centinela,8,Agosto,0,0,0,0,0,0,0,0,0,0,0,0,0,0,0,0,0,0,0,0,Sitio Arqueológico
20240315,2022,11,Ica,Sitio Arqueologico Centinela,8,Agosto,1,0,0,0,0,0,0,0,0,0,0,0,0,0,0,0,0,0,0,0,Sitio Arqueológico
20240315,2022,11,Ica,Sitio Arqueologico Centinela,8,Agosto,2,0,0,0,0,0,0,0,0,0,0,0,0,0,0,0,0,0,0,0,Sitio Arqueológico
20240315,2022,11,Ica,Sitio Arqueologico Centinela,9,Setiembre,0,0,0,0,0,0,0,0,0,0,0,0,0,0,0,0,0,0,0,0,Sitio Arqueológico
20240315,2022,11,Ica,Sitio Arqueologico Centinela,9,Setiembre,1,0,0,0,0,0,0,0,0,0,0,0,0,0,0,0,0,0,0,0,Sitio Arqueológico
20240315,2022,11,Ica,Sitio Arqueologico Centinela,9,Setiembre,2,0,0,0,0,0,0,0,0,0,0,0,0,0,0,0,0,0,0,0,Sitio Arqueológico
20240315,2022,11,Ica,Sitio Arqueologico Centinela,10,Octubre,0,0,0,0,0,0,0,0,0,0,0,0,0,0,0,0,0,0,0,0,Sitio Arqueológico
20240315,2022,11,Ica,Sitio Arqueologico Centinela,10,Octubre,1,0,0,0,0,0,0,0,0,0,0,0,0,0,0,0,0,0,0,0,Sitio Arqueológico
20240315,2022,11,Ica,Sitio Arqueologico Centinela,10,Octubre,2,0,0,0,0,0,0,0,0,0,0,0,0,0,0,0,0,0,0,0,Sitio Arqueológico
20240315,2022,11,Ica,Sitio Arqueologico Centinela,11,Noviembre,0,0,0,0,0,0,0,0,0,0,0,0,0,0,0,0,0,0,0,0,Sitio Arqueológico
20240315,2022,11,Ica,Sitio Arqueologico Centinela,11,Noviembre,1,0,0,0,0,0,0,0,0,0,0,0,0,0,0,0,0,0,0,0,Sitio Arqueológico
20240315,2022,11,Ica,Sitio Arqueologico Centinela,11,Noviembre,2,0,0,0,0,0,0,0,0,0,0,0,0,0,0,0,0,0,0,0,Sitio Arqueológico
20240315,2022,11,Ica,Sitio Arqueologico Centinela,12,Diciembre,0,0,0,0,0,0,0,0,0,0,0,0,0,0,0,0,0,0,0,0,Sitio Arqueológico
20240315,2022,11,Ica,Sitio Arqueologico Centinela,12,Diciembre,1,0,0,0,0,0,0,0,0,0,0,0,0,0,0,0,0,0,0,0,Sitio Arqueológico
20240315,2022,11,Ica,Sitio Arqueologico Centinela,12,Diciembre,2,0,0,0,0,0,0,0,0,0,0,0,0,0,0,0,0,0,0,0,Sitio Arqueológico
20240315,2022,11,Ica,Reserva Arqueologica Lineas y Geoglifos de Nazca,1,Enero,0,0,0,0,0,0,2888,1497,2278,6663,0,0,0,0,0,0,0,0,0,6663,Sitio Arqueológico
20240315,2022,11,Ica,Reserva Arqueologica Lineas y Geoglifos de Nazca,1,Enero,1,0,0,0,0,0,2112,258,926,3296,0,0,0,0,0,0,0,0,0,3296,Sitio Arqueológico
20240315,2022,11,Ica,Reserva Arqueologica Lineas y Geoglifos de Nazca,1,Enero,2,0,0,0,0,0,5000,1755,3204,9959,0,0,0,0,0,0,0,0,0,9959,Sitio Arqueológico
20240315,2022,11,Ica,Reserva Arqueologica Lineas y Geoglifos de Nazca,2,Febrero,0,0,0,0,0,0,2186,1209,1720,5115,0,0,0,0,0,0,0,0,0,5115,Sitio Arqueológico
20240315,2022,11,Ica,Reserva Arqueologica Lineas y Geoglifos de Nazca,2,Febrero,1,0,0,0,0,0,2213,503,965,3681,0,0,0,0,0,0,0,0,0,3681,Sitio Arqueológico
20240315,2022,11,Ica,Reserva Arqueologica Lineas y Geoglifos de Nazca,2,Febrero,2,0,0,0,0,0,4399,1712,2685,8796,0,0,0,0,0,0,0,0,0,8796,Sitio Arqueológico
20240315,2022,11,Ica,Reserva Arqueologica Lineas y Geoglifos de Nazca,3,Marzo,0,0,0,0,0,0,2048,453,513,3014,0,0,0,0,0,120,0,0,120,3134,Sitio Arqueológico
20240315,2022,11,Ica,Reserva Arqueologica Lineas y Geoglifos de Nazca,3,Marzo,1,0,0,0,0,0,1169,476,614,2259,0,0,0,0,0,0,0,0,0,2259,Sitio Arqueológico
20240315,2022,11,Ica,Reserva Arqueologica Lineas y Geoglifos de Nazca,3,Marzo,2,0,0,0,0,0,3217,929,1127,5273,0,0,0,0,0,120,0,0,120,5393,Sitio Arqueológico
20240315,2022,11,Ica,Reserva Arqueologica Lineas y Geoglifos de Nazca,4,Abril,0,0,0,0,0,0,1782,302,430,2514,0,0,0,0,0,95,20,15,130,2644,Sitio Arqueológico
20240315,2022,11,Ica,Reserva Arqueologica Lineas y Geoglifos de Nazca,4,Abril,1,0,0,0,0,0,2144,347,512,3003,0,0,0,0,0,0,0,0,0,3003,Sitio Arqueológico
20240315,2022,11,Ica,Reserva Arqueologica Lineas y Geoglifos de Nazca,4,Abril,2,0,0,0,0,0,3926,649,942,5517,0,0,0,0,0,95,20,15,130,5647,Sitio Arqueológico
20240315,2022,11,Ica,Reserva Arqueologica Lineas y Geoglifos de Nazca,5,Mayo,0,0,0,0,0,0,2015,381,498,2894,0,0,0,0,0,160,30,25,215,3109,Sitio Arqueológico
20240315,2022,11,Ica,Reserva Arqueologica Lineas y Geoglifos de Nazca,5,Mayo,1,0,0,0,0,0,2376,77,137,2590,0,0,0,0,0,0,0,0,0,2590,Sitio Arqueológico
20240315,2022,11,Ica,Reserva Arqueologica Lineas y Geoglifos de Nazca,5,Mayo,2,0,0,0,0,0,4391,458,635,5484,0,0,0,0,0,160,30,25,215,5699,Sitio Arqueológico
20240315,2022,11,Ica,Reserva Arqueologica Lineas y Geoglifos de Nazca,6,Junio,0,0,0,0,0,0,1306,466,555,2327,0,0,0,0,0,180,15,30,225,2552,Sitio Arqueológico
20240315,2022,11,Ica,Reserva Arqueologica Lineas y Geoglifos de Nazca,6,Junio,1,0,0,0,0,0,1793,3,0,1796,0,0,0,0,0,0,0,0,0,1796,Sitio Arqueológico
20240315,2022,11,Ica,Reserva Arqueologica Lineas y Geoglifos de Nazca,6,Junio,2,0,0,0,0,0,3099,469,555,4123,0,0,0,0,0,180,15,30,225,4348,Sitio Arqueológico
20240315,2022,11,Ica,Reserva Arqueologica Lineas y Geoglifos de Nazca,7,Julio,0,0,0,0,0,0,2067,365,1214,3646,0,0,0,0,0,120,10,15,145,3791,Sitio Arqueológico
20240315,2022,11,Ica,Reserva Arqueologica Lineas y Geoglifos de Nazca,7,Julio,1,0,0,0,0,0,3731,25,1157,4913,0,0,0,0,0,0,0,0,0,4913,Sitio Arqueológico
20240315,2022,11,Ica,Reserva Arqueologica Lineas y Geoglifos de Nazca,7,Julio,2,0,0,0,0,0,5798,390,2371,8559,0,0,0,0,0,120,10,15,145,8704,Sitio Arqueológico
20240315,2022,11,Ica,Reserva Arqueologica Lineas y Geoglifos de Nazca,8,Agosto,0,0,0,0,0,0,1879,49,1762,3690,0,0,0,0,30,140,52,0,222,3912,Sitio Arqueológico
20240315,2022,11,Ica,Reserva Arqueologica Lineas y Geoglifos de Nazca,8,Agosto,1,0,0,0,0,0,3497,15,1283,4795,0,0,0,0,0,0,0,0,0,4795,Sitio Arqueológico
20240315,2022,11,Ica,Reserva Arqueologica Lineas y Geoglifos de Nazca,8,Agosto,2,0,0,0,0,0,5376,64,3045,8485,0,0,0,0,30,140,52,0,222,8707,Sitio Arqueológico
20240315,2022,11,Ica,Reserva Arqueologica Lineas y Geoglifos de Nazca,9,Setiembre,0,0,0,0,0,0,1047,532,571,2150,0,0,0,0,0,120,15,2,137,2287,Sitio Arqueológico
20240315,2022,11,Ica,Reserva Arqueologica Lineas y Geoglifos de Nazca,9,Setiembre,1,0,0,0,0,0,2421,275,257,2953,0,0,0,0,0,0,0,0,0,2953,Sitio Arqueológico
20240315,2022,11,Ica,Reserva Arqueologica Lineas y Geoglifos de Nazca,9,Setiembre,2,0,0,0,0,0,3468,807,828,5103,0,0,0,0,0,120,15,2,137,5240,Sitio Arqueológico
20240315,2022,11,Ica,Reserva Arqueologica Lineas y Geoglifos de Nazca,10,Octubre,0,0,0,0,0,0,16,11,12,39,0,0,0,0,0,8,2,2,12,51,Sitio Arqueológico
20240315,2022,11,Ica,Reserva Arqueologica Lineas y Geoglifos de Nazca,10,Octubre,1,0,0,0,0,0,0,0,0,0,0,0,0,0,0,0,0,0,0,0,Sitio Arqueológico
20240315,2022,11,Ica,Reserva Arqueologica Lineas y Geoglifos de Nazca,10,Octubre,2,0,0,0,0,0,16,11,12,39,0,0,0,0,0,8,2,2,12,51,Sitio Arqueológico
20240315,2022,11,Ica,Reserva Arqueologica Lineas y Geoglifos de Nazca,11,Noviembre,0,0,0,0,0,0,1183,116,1082,2381,0,0,0,0,10,85,50,3,148,2529,Sitio Arqueológico
20240315,2022,11,Ica,Reserva Arqueologica Lineas y Geoglifos de Nazca,11,Noviembre,1,0,0,0,0,0,2224,125,996,3345,0,0,0,0,0,0,0,0,0,3345,Sitio Arqueológico
20240315,2022,11,Ica,Reserva Arqueologica Lineas y Geoglifos de Nazca,11,Noviembre,2,0,0,0,0,0,3407,241,2078,5726,0,0,0,0,10,85,50,3,148,5874,Sitio Arqueológico
20240315,2022,11,Ica,Reserva Arqueologica Lineas y Geoglifos de Nazca,12,Diciembre,0,0,0,0,0,0,1093,0,598,1691,0,0,0,0,0,92,4,4,100,1791,Sitio Arqueológico
20240315,2022,11,Ica,Reserva Arqueologica Lineas y Geoglifos de Nazca,12,Diciembre,1,0,0,0,0,0,986,0,419,1405,0,0,0,0,0,0,0,0,0,1405,Sitio Arqueológico
20240315,2022,11,Ica,Reserva Arqueologica Lineas y Geoglifos de Nazca,12,Diciembre,2,0,0,0,0,0,2079,0,1017,3096,0,0,0,0,0,92,4,4,100,3196,Sitio Arqueológico
20240315,2022,13,La Libertad,Complejo Arqueologico Chan Chan (Palacio Nik-An),1,Enero,0,0,0,0,0,0,3431,1318,1431,6180,0,0,0,0,0,1026,49,149,1224,7404,Sitio Arqueológico
20240315,2022,13,La Libertad,Complejo Arqueologico Chan Chan (Palacio Nik-An),1,Enero,1,0,0,0,0,0,488,137,1,626,0,0,0,0,0,0,0,0,0,626,Sitio Arqueológico
20240315,2022,13,La Libertad,Complejo Arqueologico Chan Chan (Palacio Nik-An),1,Enero,2,0,0,0,0,0,3919,1455,1432,6806,0,0,0,0,0,1026,49,149,1224,8030,Sitio Arqueológico
20240315,2022,13,La Libertad,Complejo Arqueologico Chan Chan (Palacio Nik-An),2,Febrero,0,0,0,0,0,0,3580,1655,1955,7190,0,0,0,0,0,1015,122,148,1285,8475,Sitio Arqueológico
20240315,2022,13,La Libertad,Complejo Arqueologico Chan Chan (Palacio Nik-An),2,Febrero,1,0,0,0,0,0,790,259,0,1049,0,0,0,0,0,0,0,0,0,1049,Sitio Arqueológico
20240315,2022,13,La Libertad,Complejo Arqueologico Chan Chan (Palacio Nik-An),2,Febrero,2,0,0,0,0,0,4370,1914,1955,8239,0,0,0,0,0,1015,122,148,1285,9524,Sitio Arqueológico
20240315,2022,13,La Libertad,Complejo Arqueologico Chan Chan (Palacio Nik-An),3,Marzo,0,0,0,0,0,0,2110,660,682,3452,0,0,0,0,0,1262,235,329,1826,5278,Sitio Arqueológico
20240315,2022,13,La Libertad,Complejo Arqueologico Chan Chan (Palacio Nik-An),3,Marzo,1,0,0,0,0,0,512,201,0,713,0,0,0,0,0,0,0,0,0,713,Sitio Arqueológico
20240315,2022,13,La Libertad,Complejo Arqueologico Chan Chan (Palacio Nik-An),3,Marzo,2,0,0,0,0,0,2622,861,682,4165,0,0,0,0,0,1262,235,329,1826,5991,Sitio Arqueológico
20240315,2022,13,La Libertad,Complejo Arqueologico Chan Chan (Palacio Nik-An),4,Abril,0,0,0,0,0,0,3316,742,771,4829,0,0,0,0,0,478,40,94,612,5441,Sitio Arqueológico
20240315,2022,13,La Libertad,Complejo Arqueologico Chan Chan (Palacio Nik-An),4,Abril,1,0,0,0,0,0,378,155,0,533,0,0,0,0,0,0,0,0,0,533,Sitio Arqueológico
20240315,2022,13,La Libertad,Complejo Arqueologico Chan Chan (Palacio Nik-An),4,Abril,2,0,0,0,0,0,3694,897,771,5362,0,0,0,0,0,478,40,94,612,5974,Sitio Arqueológico
20240315,2022,13,La Libertad,Complejo Arqueologico Chan Chan (Palacio Nik-An),5,Mayo,0,0,0,0,0,0,2254,718,765,3737,0,0,0,0,0,390,125,84,599,4336,Sitio Arqueológico
20240315,2022,13,La Libertad,Complejo Arqueologico Chan Chan (Palacio Nik-An),5,Mayo,1,0,0,0,0,0,324,238,19,581,0,0,0,0,0,0,0,0,0,581,Sitio Arqueológico
20240315,2022,13,La Libertad,Complejo Arqueologico Chan Chan (Palacio Nik-An),5,Mayo,2,0,0,0,0,0,2578,956,784,4318,0,0,0,0,0,390,125,84,599,4917,Sitio Arqueológico
20240315,2022,13,La Libertad,Complejo Arqueologico Chan Chan (Palacio Nik-An),6,Junio,0,0,0,0,0,0,2213,618,411,3242,0,0,0,0,0,716,327,310,1353,4595,Sitio Arqueológico
20240315,2022,13,La Libertad,Complejo Arqueologico Chan Chan (Palacio Nik-An),6,Junio,1,0,0,0,0,0,320,170,4,494,0,0,0,0,0,0,0,0,0,494,Sitio Arqueológico
20240315,2022,13,La Libertad,Complejo Arqueologico Chan Chan (Palacio Nik-An),6,Junio,2,0,0,0,0,0,2533,788,415,3736,0,0,0,0,0,716,327,310,1353,5089,Sitio Arqueológico
20240315,2022,13,La Libertad,Complejo Arqueologico Chan Chan (Palacio Nik-An),7,Julio,0,0,0,0,0,0,6386,1644,2878,10908,0,0,0,0,0,811,441,545,1797,12705,Sitio Arqueológico
20240315,2022,13,La Libertad,Complejo Arqueologico Chan Chan (Palacio Nik-An),7,Julio,1,0,0,0,0,0,505,240,0,745,0,0,0,0,0,0,0,0,0,745,Sitio Arqueológico
20240315,2022,13,La Libertad,Complejo Arqueologico Chan Chan (Palacio Nik-An),7,Julio,2,0,0,0,0,0,6891,1884,2878,11653,0,0,0,0,0,811,441,545,1797,13450,Sitio Arqueológico
20240315,2022,13,La Libertad,Complejo Arqueologico Chan Chan (Palacio Nik-An),8,Agosto,0,0,0,0,0,0,5624,1906,2351,9881,0,0,0,0,0,1444,259,484,2187,12068,Sitio Arqueológico
20240315,2022,13,La Libertad,Complejo Arqueologico Chan Chan (Palacio Nik-An),8,Agosto,1,0,0,0,0,0,453,189,0,642,0,0,0,0,0,0,0,0,0,642,Sitio Arqueológico
20240315,2022,13,La Libertad,Complejo Arqueologico Chan Chan (Palacio Nik-An),8,Agosto,2,0,0,0,0,0,6077,2095,2351,10523,0,0,0,0,0,1444,259,484,2187,12710,Sitio Arqueológico
20240315,2022,13,La Libertad,Complejo Arqueologico Chan Chan (Palacio Nik-An),9,Setiembre,0,0,0,0,0,0,3251,860,1488,5599,0,0,0,0,0,1370,292,431,2093,7692,Sitio Arqueológico
20240315,2022,13,La Libertad,Complejo Arqueologico Chan Chan (Palacio Nik-An),9,Setiembre,1,0,0,0,0,0,269,170,8,447,0,0,0,0,0,0,0,0,0,447,Sitio Arqueológico
20240315,2022,13,La Libertad,Complejo Arqueologico Chan Chan (Palacio Nik-An),9,Setiembre,2,0,0,0,0,0,3520,1030,1496,6046,0,0,0,0,0,1370,292,431,2093,8139,Sitio Arqueológico
20240315,2022,13,La Libertad,Complejo Arqueologico Chan Chan (Palacio Nik-An),10,Octubre,0,0,0,0,0,0,4572,1238,3510,9320,0,0,0,0,0,536,225,185,946,10266,Sitio Arqueológico
20240315,2022,13,La Libertad,Complejo Arqueologico Chan Chan (Palacio Nik-An),10,Octubre,1,0,0,0,0,0,459,312,38,809,0,0,0,0,0,0,0,0,0,809,Sitio Arqueológico
20240315,2022,13,La Libertad,Complejo Arqueologico Chan Chan (Palacio Nik-An),10,Octubre,2,0,0,0,0,0,5031,1550,3548,10129,0,0,0,0,0,536,225,185,946,11075,Sitio Arqueológico
20240315,2022,13,La Libertad,Complejo Arqueologico Chan Chan (Palacio Nik-An),11,Noviembre,0,0,0,0,0,0,2886,1200,2534,6620,0,0,0,0,0,1245,425,583,2253,8873,Sitio Arqueológico
20240315,2022,13,La Libertad,Complejo Arqueologico Chan Chan (Palacio Nik-An),11,Noviembre,1,0,0,0,0,0,802,308,24,1134,0,0,0,0,0,0,0,0,0,1134,Sitio Arqueológico
20240315,2022,13,La Libertad,Complejo Arqueologico Chan Chan (Palacio Nik-An),11,Noviembre,2,0,0,0,0,0,3688,1508,2558,7754,0,0,0,0,0,1245,425,583,2253,10007,Sitio Arqueológico
20240315,2022,13,La Libertad,Complejo Arqueologico Chan Chan (Palacio Nik-An),12,Diciembre,0,0,0,0,0,0,2414,551,951,3916,0,0,0,0,0,953,356,493,1802,5718,Sitio Arqueológico
20240315,2022,13,La Libertad,Complejo Arqueologico Chan Chan (Palacio Nik-An),12,Diciembre,1,0,0,0,0,0,442,158,3,603,0,0,0,0,0,0,0,0,0,603,Sitio Arqueológico
20240315,2022,13,La Libertad,Complejo Arqueologico Chan Chan (Palacio Nik-An),12,Diciembre,2,0,0,0,0,0,2856,709,954,4519,0,0,0,0,0,953,356,493,1802,6321,Sitio Arqueológico
20240315,2022,13,La Libertad,Zona Arqueologica Monumental Huaca del Sol y de La Luna,1,Enero,0,0,0,0,0,0,4233,1876,1159,7268,0,0,0,0,0,512,9,40,561,7829,Sitio Arqueológico
20240315,2022,13,La Libertad,Zona Arqueologica Monumental Huaca del Sol y de La Luna,1,Enero,1,0,0,0,0,0,420,140,41,601,0,0,0,0,0,0,0,0,0,601,Sitio Arqueológico
20240315,2022,13,La Libertad,Zona Arqueologica Monumental Huaca del Sol y de La Luna,1,Enero,2,0,0,0,0,0,4653,2016,1200,7869,0,0,0,0,0,512,9,40,561,8430,Sitio Arqueológico
20240315,2022,13,La Libertad,Zona Arqueologica Monumental Huaca del Sol y de La Luna,2,Febrero,0,0,0,0,0,0,4684,2298,1392,8374,0,0,0,0,0,456,40,89,585,8959,Sitio Arqueológico
20240315,2022,13,La Libertad,Zona Arqueologica Monumental Huaca del Sol y de La Luna,2,Febrero,1,0,0,0,0,0,420,131,31,582,0,0,0,0,0,0,0,0,0,582,Sitio Arqueológico
20240315,2022,13,La Libertad,Zona Arqueologica Monumental Huaca del Sol y de La Luna,2,Febrero,2,0,0,0,0,0,5104,2429,1423,8956,0,0,0,0,0,456,40,89,585,9541,Sitio Arqueológico
20240315,2022,13,La Libertad,Zona Arqueologica Monumental Huaca del Sol y de La Luna,3,Marzo,0,0,0,0,0,0,2898,1469,576,4943,0,0,0,0,0,515,45,102,662,5605,Sitio Arqueológico
20240315,2022,13,La Libertad,Zona Arqueologica Monumental Huaca del Sol y de La Luna,3,Marzo,1,0,0,0,0,0,489,99,17,605,0,0,0,0,0,0,0,0,0,605,Sitio Arqueológico
20240315,2022,13,La Libertad,Zona Arqueologica Monumental Huaca del Sol y de La Luna,3,Marzo,2,0,0,0,0,0,3387,1568,593,5548,0,0,0,0,0,515,45,102,662,6210,Sitio Arqueológico
20240315,2022,13,La Libertad,Zona Arqueologica Monumental Huaca del Sol y de La Luna,4,Abril,0,0,0,0,0,0,3255,1186,595,5036,0,0,0,0,0,242,29,44,315,5351,Sitio Arqueológico
20240315,2022,13,La Libertad,Zona Arqueologica Monumental Huaca del Sol y de La Luna,4,Abril,1,0,0,0,0,0,582,108,18,708,0,0,0,0,0,0,0,0,0,708,Sitio Arqueológico
20240315,2022,13,La Libertad,Zona Arqueologica Monumental Huaca del Sol y de La Luna,4,Abril,2,0,0,0,0,0,3837,1294,613,5744,0,0,0,0,0,242,29,44,315,6059,Sitio Arqueológico
20240315,2022,13,La Libertad,Zona Arqueologica Monumental Huaca del Sol y de La Luna,5,Mayo,0,0,0,0,0,0,2230,1171,641,4042,0,0,0,0,0,376,10,38,424,4466,Sitio Arqueológico
20240315,2022,13,La Libertad,Zona Arqueologica Monumental Huaca del Sol y de La Luna,5,Mayo,1,0,0,0,0,0,653,208,14,875,0,0,0,0,0,0,0,0,0,875,Sitio Arqueológico
20240315,2022,13,La Libertad,Zona Arqueologica Monumental Huaca del Sol y de La Luna,5,Mayo,2,0,0,0,0,0,2883,1379,655,4917,0,0,0,0,0,376,10,38,424,5341,Sitio Arqueológico
20240315,2022,13,La Libertad,Zona Arqueologica Monumental Huaca del Sol y de La Luna,6,Junio,0,0,0,0,0,0,1912,760,815,3487,0,0,0,0,0,429,12,72,513,4000,Sitio Arqueológico
20240315,2022,13,La Libertad,Zona Arqueologica Monumental Huaca del Sol y de La Luna,6,Junio,1,0,0,0,0,0,601,183,32,816,0,0,0,0,0,0,0,0,0,816,Sitio Arqueológico
20240315,2022,13,La Libertad,Zona Arqueologica Monumental Huaca del Sol y de La Luna,6,Junio,2,0,0,0,0,0,2513,943,847,4303,0,0,0,0,0,429,12,72,513,4816,Sitio Arqueológico
20240315,2022,13,La Libertad,Zona Arqueologica Monumental Huaca del Sol y de La Luna,7,Julio,0,0,0,0,0,0,5934,2419,3420,11773,0,0,0,0,0,535,53,369,957,12730,Sitio Arqueológico
20240315,2022,13,La Libertad,Zona Arqueologica Monumental Huaca del Sol y de La Luna,7,Julio,1,0,0,0,0,0,877,360,88,1325,0,0,0,0,0,0,0,0,0,1325,Sitio Arqueológico
20240315,2022,13,La Libertad,Zona Arqueologica Monumental Huaca del Sol y de La Luna,7,Julio,2,0,0,0,0,0,6811,2779,3508,13098,0,0,0,0,0,535,53,369,957,14055,Sitio Arqueológico
20240315,2022,13,La Libertad,Zona Arqueologica Monumental Huaca del Sol y de La Luna,8,Agosto,0,0,0,0,0,0,4875,2241,2858,9974,0,0,0,0,0,581,60,202,843,10817,Sitio Arqueológico
20240315,2022,13,La Libertad,Zona Arqueologica Monumental Huaca del Sol y de La Luna,8,Agosto,1,0,0,0,0,0,924,304,113,1341,0,0,0,0,0,0,0,0,0,1341,Sitio Arqueológico
20240315,2022,13,La Libertad,Zona Arqueologica Monumental Huaca del Sol y de La Luna,8,Agosto,2,0,0,0,0,0,5799,2545,2971,11315,0,0,0,0,0,581,60,202,843,12158,Sitio Arqueológico
20240315,2022,13,La Libertad,Zona Arqueologica Monumental Huaca del Sol y de La Luna,9,Setiembre,0,0,0,0,0,0,3258,1288,3152,7698,0,0,0,0,0,398,31,230,659,8357,Sitio Arqueológico
20240315,2022,13,La Libertad,Zona Arqueologica Monumental Huaca del Sol y de La Luna,9,Setiembre,1,0,0,0,0,0,777,229,19,1025,0,0,0,0,0,0,0,0,0,1025,Sitio Arqueológico
20240315,2022,13,La Libertad,Zona Arqueologica Monumental Huaca del Sol y de La Luna,9,Setiembre,2,0,0,0,0,0,4035,1517,3171,8723,0,0,0,0,0,398,31,230,659,9382,Sitio Arqueológico
20240315,2022,13,La Libertad,Zona Arqueologica Monumental Huaca del Sol y de La Luna,10,Octubre,0,0,0,0,0,0,4549,1979,5011,11539,0,0,0,0,0,120,2,38,160,11699,Sitio Arqueológico
20240315,2022,13,La Libertad,Zona Arqueologica Monumental Huaca del Sol y de La Luna,10,Octubre,1,0,0,0,0,0,990,282,45,1317,0,0,0,0,0,0,0,0,0,1317,Sitio Arqueológico
20240315,2022,13,La Libertad,Zona Arqueologica Monumental Huaca del Sol y de La Luna,10,Octubre,2,0,0,0,0,0,5539,2261,5056,12856,0,0,0,0,0,120,2,38,160,13016,Sitio Arqueológico
20240315,2022,13,La Libertad,Zona Arqueologica Monumental Huaca del Sol y de La Luna,11,Noviembre,0,0,0,0,0,0,2683,1485,3177,7345,0,0,0,0,0,497,10,213,720,8065,Sitio Arqueológico
20240315,2022,13,La Libertad,Zona Arqueologica Monumental Huaca del Sol y de La Luna,11,Noviembre,1,0,0,0,0,0,990,253,29,1272,0,0,0,0,0,0,0,0,0,1272,Sitio Arqueológico
20240315,2022,13,La Libertad,Zona Arqueologica Monumental Huaca del Sol y de La Luna,11,Noviembre,2,0,0,0,0,0,3673,1738,3206,8617,0,0,0,0,0,497,10,213,720,9337,Sitio Arqueológico
20240315,2022,13,La Libertad,Zona Arqueologica Monumental Huaca del Sol y de La Luna,12,Diciembre,0,0,0,0,0,0,2039,698,877,3614,0,0,0,0,0,251,14,168,433,4047,Sitio Arqueológico
20240315,2022,13,La Libertad,Zona Arqueologica Monumental Huaca del Sol y de La Luna,12,Diciembre,1,0,0,0,0,0,921,161,54,1136,0,0,0,0,0,0,0,0,0,1136,Sitio Arqueológico
20240315,2022,13,La Libertad,Zona Arqueologica Monumental Huaca del Sol y de La Luna,12,Diciembre,2,0,0,0,0,0,2960,859,931,4750,0,0,0,0,0,251,14,168,433,5183,Sitio Arqueológico
20240315,2022,13,La Libertad,Zona Arqueologica Monumental El Brujo,1,Enero,0,0,0,0,0,0,1062,557,474,2093,0,0,0,0,0,236,110,74,420,2513,Sitio Arqueológico
20240315,2022,13,La Libertad,Zona Arqueologica Monumental El Brujo,1,Enero,1,0,0,0,0,0,102,19,8,129,0,0,0,0,0,0,0,0,0,129,Sitio Arqueológico
20240315,2022,13,La Libertad,Zona Arqueologica Monumental El Brujo,1,Enero,2,0,0,0,0,0,1164,576,482,2222,0,0,0,0,0,236,110,74,420,2642,Sitio Arqueológico
20240315,2022,13,La Libertad,Zona Arqueologica Monumental El Brujo,2,Febrero,0,0,0,0,0,0,1168,666,478,2312,0,0,0,0,0,135,57,68,260,2572,Sitio Arqueológico
20240315,2022,13,La Libertad,Zona Arqueologica Monumental El Brujo,2,Febrero,1,0,0,0,0,0,82,27,3,112,0,0,0,0,0,0,0,0,0,112,Sitio Arqueológico
20240315,2022,13,La Libertad,Zona Arqueologica Monumental El Brujo,2,Febrero,2,0,0,0,0,0,1250,693,481,2424,0,0,0,0,0,135,57,68,260,2684,Sitio Arqueológico
20240315,2022,13,La Libertad,Zona Arqueologica Monumental El Brujo,3,Marzo,0,0,0,0,0,0,746,440,223,1409,0,0,0,0,0,138,50,44,232,1641,Sitio Arqueológico
20240315,2022,13,La Libertad,Zona Arqueologica Monumental El Brujo,3,Marzo,1,0,0,0,0,0,115,34,3,152,0,0,0,0,0,0,0,0,0,152,Sitio Arqueológico
20240315,2022,13,La Libertad,Zona Arqueologica Monumental El Brujo,3,Marzo,2,0,0,0,0,0,861,474,226,1561,0,0,0,0,0,138,50,44,232,1793,Sitio Arqueológico
20240315,2022,13,La Libertad,Zona Arqueologica Monumental El Brujo,4,Abril,0,0,0,0,0,0,799,420,233,1452,0,0,0,0,0,126,45,28,199,1651,Sitio Arqueológico
20240315,2022,13,La Libertad,Zona Arqueologica Monumental El Brujo,4,Abril,1,0,0,0,0,0,141,26,5,172,0,0,0,0,0,0,0,0,0,172,Sitio Arqueológico
20240315,2022,13,La Libertad,Zona Arqueologica Monumental El Brujo,4,Abril,2,0,0,0,0,0,940,446,238,1624,0,0,0,0,0,126,45,28,199,1823,Sitio Arqueológico
20240315,2022,13,La Libertad,Zona Arqueologica Monumental El Brujo,5,Mayo,0,0,0,0,0,0,662,315,204,1181,0,0,0,0,0,102,65,36,203,1384,Sitio Arqueológico
20240315,2022,13,La Libertad,Zona Arqueologica Monumental El Brujo,5,Mayo,1,0,0,0,0,0,240,28,2,270,0,0,0,0,0,0,0,0,0,270,Sitio Arqueológico
20240315,2022,13,La Libertad,Zona Arqueologica Monumental El Brujo,5,Mayo,2,0,0,0,0,0,902,343,206,1451,0,0,0,0,0,102,65,36,203,1654,Sitio Arqueológico
20240315,2022,13,La Libertad,Zona Arqueologica Monumental El Brujo,6,Junio,0,0,0,0,0,0,497,292,120,909,0,0,0,0,0,194,64,47,305,1214,Sitio Arqueológico
20240315,2022,13,La Libertad,Zona Arqueologica Monumental El Brujo,6,Junio,1,0,0,0,0,0,144,37,6,187,0,0,0,0,0,0,0,0,0,187,Sitio Arqueológico
20240315,2022,13,La Libertad,Zona Arqueologica Monumental El Brujo,6,Junio,2,0,0,0,0,0,641,329,126,1096,0,0,0,0,0,194,64,47,305,1401,Sitio Arqueológico
20240315,2022,13,La Libertad,Zona Arqueologica Monumental El Brujo,7,Julio,0,0,0,0,0,0,1932,787,1388,4107,0,0,0,0,0,110,66,94,270,4377,Sitio Arqueológico
20240315,2022,13,La Libertad,Zona Arqueologica Monumental El Brujo,7,Julio,1,0,0,0,0,0,270,113,7,390,0,0,0,0,0,0,0,0,0,390,Sitio Arqueológico
20240315,2022,13,La Libertad,Zona Arqueologica Monumental El Brujo,7,Julio,2,0,0,0,0,0,2202,900,1395,4497,0,0,0,0,0,110,66,94,270,4767,Sitio Arqueológico
20240315,2022,13,La Libertad,Zona Arqueologica Monumental El Brujo,8,Agosto,0,0,0,0,0,0,1507,699,682,2888,0,0,0,0,0,183,105,311,599,3487,Sitio Arqueológico
20240315,2022,13,La Libertad,Zona Arqueologica Monumental El Brujo,8,Agosto,1,0,0,0,0,0,290,78,10,378,0,0,0,0,0,0,0,0,0,378,Sitio Arqueológico
20240315,2022,13,La Libertad,Zona Arqueologica Monumental El Brujo,8,Agosto,2,0,0,0,0,0,1797,777,692,3266,0,0,0,0,0,183,105,311,599,3865,Sitio Arqueológico
20240315,2022,13,La Libertad,Zona Arqueologica Monumental El Brujo,9,Setiembre,0,0,0,0,0,0,884,392,792,2068,0,0,0,0,0,159,127,415,701,2769,Sitio Arqueológico
20240315,2022,13,La Libertad,Zona Arqueologica Monumental El Brujo,9,Setiembre,1,0,0,0,0,0,230,61,1,292,0,0,0,0,0,0,0,0,0,292,Sitio Arqueológico
20240315,2022,13,La Libertad,Zona Arqueologica Monumental El Brujo,9,Setiembre,2,0,0,0,0,0,1114,453,793,2360,0,0,0,0,0,159,127,415,701,3061,Sitio Arqueológico
20240315,2022,13,La Libertad,Zona Arqueologica Monumental El Brujo,10,Octubre,0,0,0,0,0,0,1264,591,821,2676,0,0,0,0,0,128,18,46,192,2868,Sitio Arqueológico
20240315,2022,13,La Libertad,Zona Arqueologica Monumental El Brujo,10,Octubre,1,0,0,0,0,0,293,65,4,362,0,0,0,0,0,0,0,0,0,362,Sitio Arqueológico
20240315,2022,13,La Libertad,Zona Arqueologica Monumental El Brujo,10,Octubre,2,0,0,0,0,0,1557,656,825,3038,0,0,0,0,0,128,18,46,192,3230,Sitio Arqueológico
20240315,2022,13,La Libertad,Zona Arqueologica Monumental El Brujo,11,Noviembre,0,0,0,0,0,0,995,479,1264,2738,0,0,0,0,0,275,130,207,612,3350,Sitio Arqueológico
20240315,2022,13,La Libertad,Zona Arqueologica Monumental El Brujo,11,Noviembre,1,0,0,0,0,0,245,57,1,303,0,0,0,0,0,11,0,0,11,314,Sitio Arqueológico
20240315,2022,13,La Libertad,Zona Arqueologica Monumental El Brujo,11,Noviembre,2,0,0,0,0,0,1240,536,1265,3041,0,0,0,0,0,286,130,207,623,3664,Sitio Arqueológico
20240315,2022,13,La Libertad,Zona Arqueologica Monumental El Brujo,12,Diciembre,0,0,0,0,0,0,482,247,357,1086,0,0,0,0,0,185,28,2,215,1301,Sitio Arqueológico
20240315,2022,13,La Libertad,Zona Arqueologica Monumental El Brujo,12,Diciembre,1,0,0,0,0,0,116,78,38,232,0,0,0,0,0,0,0,0,0,232,Sitio Arqueológico
20240315,2022,13,La Libertad,Zona Arqueologica Monumental El Brujo,12,Diciembre,2,0,0,0,0,0,598,325,395,1318,0,0,0,0,0,185,28,2,215,1533,Sitio Arqueológico
20240315,2022,13,La Libertad,Sitio Arqueologico Huaca Arco Iris (Huaca El Dragon),1,Enero,0,0,0,0,0,0,0,0,0,0,0,0,0,0,0,0,0,0,0,0,Sitio Arqueológico
20240315,2022,13,La Libertad,Sitio Arqueologico Huaca Arco Iris (Huaca El Dragon),1,Enero,1,0,0,0,0,0,0,0,0,0,0,0,0,0,0,0,0,0,0,0,Sitio Arqueológico
20240315,2022,13,La Libertad,Sitio Arqueologico Huaca Arco Iris (Huaca El Dragon),1,Enero,2,0,0,0,0,0,0,0,0,0,0,0,0,0,0,0,0,0,0,0,Sitio Arqueológico
20240315,2022,13,La Libertad,Sitio Arqueologico Huaca Arco Iris (Huaca El Dragon),2,Febrero,0,0,0,0,0,0,0,0,0,0,0,0,0,0,0,0,0,0,0,0,Sitio Arqueológico
20240315,2022,13,La Libertad,Sitio Arqueologico Huaca Arco Iris (Huaca El Dragon),2,Febrero,1,0,0,0,0,0,0,0,0,0,0,0,0,0,0,0,0,0,0,0,Sitio Arqueológico
20240315,2022,13,La Libertad,Sitio Arqueologico Huaca Arco Iris (Huaca El Dragon),2,Febrero,2,0,0,0,0,0,0,0,0,0,0,0,0,0,0,0,0,0,0,0,Sitio Arqueológico
20240315,2022,13,La Libertad,Sitio Arqueologico Huaca Arco Iris (Huaca El Dragon),3,Marzo,0,0,0,0,0,0,0,0,0,0,0,0,0,0,0,0,0,0,0,0,Sitio Arqueológico
20240315,2022,13,La Libertad,Sitio Arqueologico Huaca Arco Iris (Huaca El Dragon),3,Marzo,1,0,0,0,0,0,0,0,0,0,0,0,0,0,0,0,0,0,0,0,Sitio Arqueológico
20240315,2022,13,La Libertad,Sitio Arqueologico Huaca Arco Iris (Huaca El Dragon),3,Marzo,2,0,0,0,0,0,0,0,0,0,0,0,0,0,0,0,0,0,0,0,Sitio Arqueológico
20240315,2022,13,La Libertad,Sitio Arqueologico Huaca Arco Iris (Huaca El Dragon),4,Abril,0,0,0,0,0,0,0,0,0,0,0,0,0,0,0,0,0,0,0,0,Sitio Arqueológico
20240315,2022,13,La Libertad,Sitio Arqueologico Huaca Arco Iris (Huaca El Dragon),4,Abril,1,0,0,0,0,0,0,0,0,0,0,0,0,0,0,0,0,0,0,0,Sitio Arqueológico
20240315,2022,13,La Libertad,Sitio Arqueologico Huaca Arco Iris (Huaca El Dragon),4,Abril,2,0,0,0,0,0,0,0,0,0,0,0,0,0,0,0,0,0,0,0,Sitio Arqueológico
20240315,2022,13,La Libertad,Sitio Arqueologico Huaca Arco Iris (Huaca El Dragon),5,Mayo,0,0,0,0,0,0,0,0,0,0,0,0,0,0,0,0,0,0,0,0,Sitio Arqueológico
20240315,2022,13,La Libertad,Sitio Arqueologico Huaca Arco Iris (Huaca El Dragon),5,Mayo,1,0,0,0,0,0,0,0,0,0,0,0,0,0,0,0,0,0,0,0,Sitio Arqueológico
20240315,2022,13,La Libertad,Sitio Arqueologico Huaca Arco Iris (Huaca El Dragon),5,Mayo,2,0,0,0,0,0,0,0,0,0,0,0,0,0,0,0,0,0,0,0,Sitio Arqueológico
20240315,2022,13,La Libertad,Sitio Arqueologico Huaca Arco Iris (Huaca El Dragon),6,Junio,0,0,0,0,0,0,0,0,0,0,0,0,0,0,0,0,0,0,0,0,Sitio Arqueológico
20240315,2022,13,La Libertad,Sitio Arqueologico Huaca Arco Iris (Huaca El Dragon),6,Junio,1,0,0,0,0,0,0,0,0,0,0,0,0,0,0,0,0,0,0,0,Sitio Arqueológico
20240315,2022,13,La Libertad,Sitio Arqueologico Huaca Arco Iris (Huaca El Dragon),6,Junio,2,0,0,0,0,0,0,0,0,0,0,0,0,0,0,0,0,0,0,0,Sitio Arqueológico
20240315,2022,13,La Libertad,Sitio Arqueologico Huaca Arco Iris (Huaca El Dragon),7,Julio,0,0,0,0,0,0,0,0,0,0,0,0,0,0,0,0,0,0,0,0,Sitio Arqueológico
20240315,2022,13,La Libertad,Sitio Arqueologico Huaca Arco Iris (Huaca El Dragon),7,Julio,1,0,0,0,0,0,0,0,0,0,0,0,0,0,0,0,0,0,0,0,Sitio Arqueológico
20240315,2022,13,La Libertad,Sitio Arqueologico Huaca Arco Iris (Huaca El Dragon),7,Julio,2,0,0,0,0,0,0,0,0,0,0,0,0,0,0,0,0,0,0,0,Sitio Arqueológico
20240315,2022,13,La Libertad,Sitio Arqueologico Huaca Arco Iris (Huaca El Dragon),8,Agosto,0,0,0,0,0,0,0,0,0,0,0,0,0,0,0,0,0,0,0,0,Sitio Arqueológico
20240315,2022,13,La Libertad,Sitio Arqueologico Huaca Arco Iris (Huaca El Dragon),8,Agosto,1,0,0,0,0,0,0,0,0,0,0,0,0,0,0,0,0,0,0,0,Sitio Arqueológico
20240315,2022,13,La Libertad,Sitio Arqueologico Huaca Arco Iris (Huaca El Dragon),8,Agosto,2,0,0,0,0,0,0,0,0,0,0,0,0,0,0,0,0,0,0,0,Sitio Arqueológico
20240315,2022,13,La Libertad,Sitio Arqueologico Huaca Arco Iris (Huaca El Dragon),9,Setiembre,0,0,0,0,0,0,0,0,0,0,0,0,0,0,0,0,0,0,0,0,Sitio Arqueológico
20240315,2022,13,La Libertad,Sitio Arqueologico Huaca Arco Iris (Huaca El Dragon),9,Setiembre,1,0,0,0,0,0,0,0,0,0,0,0,0,0,0,0,0,0,0,0,Sitio Arqueológico
20240315,2022,13,La Libertad,Sitio Arqueologico Huaca Arco Iris (Huaca El Dragon),9,Setiembre,2,0,0,0,0,0,0,0,0,0,0,0,0,0,0,0,0,0,0,0,Sitio Arqueológico
20240315,2022,13,La Libertad,Sitio Arqueologico Huaca Arco Iris (Huaca El Dragon),10,Octubre,0,0,0,0,0,0,0,0,0,0,0,0,0,0,0,0,0,0,0,0,Sitio Arqueológico
20240315,2022,13,La Libertad,Sitio Arqueologico Huaca Arco Iris (Huaca El Dragon),10,Octubre,1,0,0,0,0,0,0,0,0,0,0,0,0,0,0,0,0,0,0,0,Sitio Arqueológico
20240315,2022,13,La Libertad,Sitio Arqueologico Huaca Arco Iris (Huaca El Dragon),10,Octubre,2,0,0,0,0,0,0,0,0,0,0,0,0,0,0,0,0,0,0,0,Sitio Arqueológico
20240315,2022,13,La Libertad,Sitio Arqueologico Huaca Arco Iris (Huaca El Dragon),11,Noviembre,0,0,0,0,0,0,0,0,0,0,0,0,0,0,0,0,0,0,0,0,Sitio Arqueológico
20240315,2022,13,La Libertad,Sitio Arqueologico Huaca Arco Iris (Huaca El Dragon),11,Noviembre,1,0,0,0,0,0,0,0,0,0,0,0,0,0,0,0,0,0,0,0,Sitio Arqueológico
20240315,2022,13,La Libertad,Sitio Arqueologico Huaca Arco Iris (Huaca El Dragon),11,Noviembre,2,0,0,0,0,0,0,0,0,0,0,0,0,0,0,0,0,0,0,0,Sitio Arqueológico
20240315,2022,13,La Libertad,Sitio Arqueologico Huaca Arco Iris (Huaca El Dragon),12,Diciembre,0,0,0,0,0,0,0,0,0,0,0,0,0,0,0,0,0,0,0,0,Sitio Arqueológico
20240315,2022,13,La Libertad,Sitio Arqueologico Huaca Arco Iris (Huaca El Dragon),12,Diciembre,1,0,0,0,0,0,0,0,0,0,0,0,0,0,0,0,0,0,0,0,Sitio Arqueológico
20240315,2022,13,La Libertad,Sitio Arqueologico Huaca Arco Iris (Huaca El Dragon),12,Diciembre,2,0,0,0,0,0,0,0,0,0,0,0,0,0,0,0,0,0,0,0,Sitio Arqueológico
20240315,2022,14,Lambayeque,Sitio Arqueologico Cerro Ventarron,1,Enero,0,0,0,0,0,0,0,0,0,0,0,0,0,0,0,0,0,0,0,0,Sitio Arqueológico
20240315,2022,14,Lambayeque,Sitio Arqueologico Cerro Ventarron,1,Enero,1,0,0,0,0,0,0,0,0,0,0,0,0,0,0,0,0,0,0,0,Sitio Arqueológico
20240315,2022,14,Lambayeque,Sitio Arqueologico Cerro Ventarron,1,Enero,2,0,0,0,0,0,0,0,0,0,0,0,0,0,0,0,0,0,0,0,Sitio Arqueológico
20240315,2022,14,Lambayeque,Sitio Arqueologico Cerro Ventarron,2,Febrero,0,0,0,0,0,0,66,10,11,87,0,0,0,0,0,3,0,0,3,90,Sitio Arqueológico
20240315,2022,14,Lambayeque,Sitio Arqueologico Cerro Ventarron,2,Febrero,1,0,0,0,0,0,0,0,0,0,0,0,0,0,0,0,0,0,0,0,Sitio Arqueológico
20240315,2022,14,Lambayeque,Sitio Arqueologico Cerro Ventarron,2,Febrero,2,0,0,0,0,0,66,10,11,87,0,0,0,0,0,3,0,0,3,90,Sitio Arqueológico
20240315,2022,14,Lambayeque,Sitio Arqueologico Cerro Ventarron,3,Marzo,0,0,0,0,0,0,27,4,7,38,0,0,0,0,0,3,2,6,11,49,Sitio Arqueológico
20240315,2022,14,Lambayeque,Sitio Arqueologico Cerro Ventarron,3,Marzo,1,0,0,0,0,0,0,0,0,0,0,0,0,0,0,0,0,0,0,0,Sitio Arqueológico
20240315,2022,14,Lambayeque,Sitio Arqueologico Cerro Ventarron,3,Marzo,2,0,0,0,0,0,27,4,7,38,0,0,0,0,0,3,2,6,11,49,Sitio Arqueológico
20240315,2022,14,Lambayeque,Sitio Arqueologico Cerro Ventarron,4,Abril,0,0,0,0,0,0,24,27,1,52,0,0,0,0,0,0,0,0,0,52,Sitio Arqueológico
20240315,2022,14,Lambayeque,Sitio Arqueologico Cerro Ventarron,4,Abril,1,0,0,0,0,0,23,2,4,29,0,0,0,0,0,0,0,0,0,29,Sitio Arqueológico
20240315,2022,14,Lambayeque,Sitio Arqueologico Cerro Ventarron,4,Abril,2,0,0,0,0,0,47,29,5,81,0,0,0,0,0,0,0,0,0,81,Sitio Arqueológico
20240315,2022,14,Lambayeque,Sitio Arqueologico Cerro Ventarron,5,Mayo,0,0,0,0,0,0,18,6,7,31,0,0,0,0,0,0,0,0,0,31,Sitio Arqueológico
20240315,2022,14,Lambayeque,Sitio Arqueologico Cerro Ventarron,5,Mayo,1,0,0,0,0,0,0,0,0,0,0,0,0,0,0,0,0,0,0,0,Sitio Arqueológico
20240315,2022,14,Lambayeque,Sitio Arqueologico Cerro Ventarron,5,Mayo,2,0,0,0,0,0,18,6,7,31,0,0,0,0,0,0,0,0,0,31,Sitio Arqueológico
20240315,2022,14,Lambayeque,Sitio Arqueologico Cerro Ventarron,6,Junio,0,0,0,0,0,0,27,17,170,214,0,0,0,0,0,0,0,0,0,214,Sitio Arqueológico
20240315,2022,14,Lambayeque,Sitio Arqueologico Cerro Ventarron,6,Junio,1,0,0,0,0,0,1,0,0,1,0,0,0,0,0,0,0,0,0,1,Sitio Arqueológico
20240315,2022,14,Lambayeque,Sitio Arqueologico Cerro Ventarron,6,Junio,2,0,0,0,0,0,28,17,170,215,0,0,0,0,0,0,0,0,0,215,Sitio Arqueológico
20240315,2022,14,Lambayeque,Sitio Arqueologico Cerro Ventarron,7,Julio,0,0,0,0,0,0,65,35,40,140,0,0,0,0,0,0,0,0,0,140,Sitio Arqueológico
20240315,2022,14,Lambayeque,Sitio Arqueologico Cerro Ventarron,7,Julio,1,0,0,0,0,0,12,0,0,12,0,0,0,0,0,0,0,0,0,12,Sitio Arqueológico
20240315,2022,14,Lambayeque,Sitio Arqueologico Cerro Ventarron,7,Julio,2,0,0,0,0,0,77,35,40,152,0,0,0,0,0,0,0,0,0,152,Sitio Arqueológico
20240315,2022,14,Lambayeque,Sitio Arqueologico Cerro Ventarron,8,Agosto,0,0,0,0,0,0,31,32,14,77,0,0,0,0,0,0,0,0,0,77,Sitio Arqueológico
20240315,2022,14,Lambayeque,Sitio Arqueologico Cerro Ventarron,8,Agosto,1,0,0,0,0,0,55,0,0,55,0,0,0,0,0,0,0,0,0,55,Sitio Arqueológico
20240315,2022,14,Lambayeque,Sitio Arqueologico Cerro Ventarron,8,Agosto,2,0,0,0,0,0,86,32,14,132,0,0,0,0,0,0,0,0,0,132,Sitio Arqueológico
20240315,2022,14,Lambayeque,Sitio Arqueologico Cerro Ventarron,9,Setiembre,0,0,0,0,0,0,35,16,6,57,0,0,0,0,0,0,0,0,0,57,Sitio Arqueológico
20240315,2022,14,Lambayeque,Sitio Arqueologico Cerro Ventarron,9,Setiembre,1,0,0,0,0,0,13,0,0,13,0,0,0,0,0,0,0,0,0,13,Sitio Arqueológico
20240315,2022,14,Lambayeque,Sitio Arqueologico Cerro Ventarron,9,Setiembre,2,0,0,0,0,0,48,16,6,70,0,0,0,0,0,0,0,0,0,70,Sitio Arqueológico
20240315,2022,14,Lambayeque,Sitio Arqueologico Cerro Ventarron,10,Octubre,0,0,0,0,0,0,14,0,1,15,0,0,0,0,0,1,0,5,6,21,Sitio Arqueológico
20240315,2022,14,Lambayeque,Sitio Arqueologico Cerro Ventarron,10,Octubre,1,0,0,0,0,0,23,0,0,23,0,0,0,0,0,0,0,0,0,23,Sitio Arqueológico
20240315,2022,14,Lambayeque,Sitio Arqueologico Cerro Ventarron,10,Octubre,2,0,0,0,0,0,37,0,1,38,0,0,0,0,0,1,0,5,6,44,Sitio Arqueológico
20240315,2022,14,Lambayeque,Sitio Arqueologico Cerro Ventarron,11,Noviembre,0,0,0,0,0,0,20,11,8,39,0,0,0,0,0,0,0,0,0,39,Sitio Arqueológico
20240315,2022,14,Lambayeque,Sitio Arqueologico Cerro Ventarron,11,Noviembre,1,0,0,0,0,0,7,0,0,7,0,0,0,0,0,0,0,0,0,7,Sitio Arqueológico
20240315,2022,14,Lambayeque,Sitio Arqueologico Cerro Ventarron,11,Noviembre,2,0,0,0,0,0,27,11,8,46,0,0,0,0,0,0,0,0,0,46,Sitio Arqueológico
20240315,2022,14,Lambayeque,Sitio Arqueologico Cerro Ventarron,12,Diciembre,0,0,0,0,0,0,4,20,0,24,0,0,0,0,0,0,0,0,0,24,Sitio Arqueológico
20240315,2022,14,Lambayeque,Sitio Arqueologico Cerro Ventarron,12,Diciembre,1,0,0,0,0,0,1,0,0,1,0,0,0,0,0,0,0,0,0,1,Sitio Arqueológico
20240315,2022,14,Lambayeque,Sitio Arqueologico Cerro Ventarron,12,Diciembre,2,0,0,0,0,0,5,20,0,25,0,0,0,0,0,0,0,0,0,25,Sitio Arqueológico
20240315,2022,15,Lima,Sitio Arqueologico Caral,1,Enero,0,0,0,0,0,0,1425,258,629,2312,0,0,0,0,0,421,0,0,421,2733,Sitio Arqueológico
20240315,2022,15,Lima,Sitio Arqueologico Caral,1,Enero,1,0,0,0,0,0,82,5,12,99,0,0,0,0,0,0,0,0,0,99,Sitio Arqueológico
20240315,2022,15,Lima,Sitio Arqueologico Caral,1,Enero,2,0,0,0,0,0,1507,263,641,2411,0,0,0,0,0,421,0,0,421,2832,Sitio Arqueológico
20240315,2022,15,Lima,Sitio Arqueologico Caral,2,Febrero,0,0,0,0,0,0,1132,316,669,2117,0,0,0,0,0,389,0,0,389,2506,Sitio Arqueológico
20240315,2022,15,Lima,Sitio Arqueologico Caral,2,Febrero,1,0,0,0,0,0,81,8,13,102,0,0,0,0,0,0,0,0,0,102,Sitio Arqueológico
20240315,2022,15,Lima,Sitio Arqueologico Caral,2,Febrero,2,0,0,0,0,0,1213,324,682,2219,0,0,0,0,0,389,0,0,389,2608,Sitio Arqueológico
20240315,2022,15,Lima,Sitio Arqueologico Caral,3,Marzo,0,0,0,0,0,0,623,128,317,1068,0,0,0,0,0,224,0,0,224,1292,Sitio Arqueológico
20240315,2022,15,Lima,Sitio Arqueologico Caral,3,Marzo,1,0,0,0,0,0,64,6,3,73,0,0,0,0,0,0,0,0,0,73,Sitio Arqueológico
20240315,2022,15,Lima,Sitio Arqueologico Caral,3,Marzo,2,0,0,0,0,0,687,134,320,1141,0,0,0,0,0,224,0,0,224,1365,Sitio Arqueológico
20240315,2022,15,Lima,Sitio Arqueologico Caral,4,Abril,0,0,0,0,0,0,1886,376,856,3118,0,0,0,0,0,183,0,0,183,3301,Sitio Arqueológico
20240315,2022,15,Lima,Sitio Arqueologico Caral,4,Abril,1,0,0,0,0,0,164,13,12,189,0,0,0,0,0,0,0,0,0,189,Sitio Arqueológico
20240315,2022,15,Lima,Sitio Arqueologico Caral,4,Abril,2,0,0,0,0,0,2050,389,868,3307,0,0,0,0,0,183,0,0,183,3490,Sitio Arqueológico
20240315,2022,15,Lima,Sitio Arqueologico Caral,5,Mayo,0,0,0,0,0,0,974,151,713,1838,0,0,0,0,0,409,0,0,409,2247,Sitio Arqueológico
20240315,2022,15,Lima,Sitio Arqueologico Caral,5,Mayo,1,0,0,0,0,0,63,11,27,101,0,0,0,0,0,0,0,0,0,101,Sitio Arqueológico
20240315,2022,15,Lima,Sitio Arqueologico Caral,5,Mayo,2,0,0,0,0,0,1037,162,740,1939,0,0,0,0,0,409,0,0,409,2348,Sitio Arqueológico
20240315,2022,15,Lima,Sitio Arqueologico Caral,6,Junio,0,0,0,0,0,0,862,309,860,2031,0,0,0,0,0,467,0,0,467,2498,Sitio Arqueológico
20240315,2022,15,Lima,Sitio Arqueologico Caral,6,Junio,1,0,0,0,0,0,117,10,28,155,0,0,0,0,0,0,0,0,0,155,Sitio Arqueológico
20240315,2022,15,Lima,Sitio Arqueologico Caral,6,Junio,2,0,0,0,0,0,979,319,888,2186,0,0,0,0,0,467,0,0,467,2653,Sitio Arqueológico
20240315,2022,15,Lima,Sitio Arqueologico Caral,7,Julio,0,0,0,0,0,0,2416,735,2474,5625,0,0,0,0,0,910,0,0,910,6535,Sitio Arqueológico
20240315,2022,15,Lima,Sitio Arqueologico Caral,7,Julio,1,0,0,0,0,0,152,64,88,304,0,0,0,0,0,0,0,0,0,304,Sitio Arqueológico
20240315,2022,15,Lima,Sitio Arqueologico Caral,7,Julio,2,0,0,0,0,0,2568,799,2562,5929,0,0,0,0,0,910,0,0,910,6839,Sitio Arqueológico
20240315,2022,15,Lima,Sitio Arqueologico Caral,8,Agosto,0,0,0,0,0,0,1669,540,1186,3395,0,0,0,0,0,1159,0,0,1159,4554,Sitio Arqueológico
20240315,2022,15,Lima,Sitio Arqueologico Caral,8,Agosto,1,0,0,0,0,0,72,15,23,110,0,0,0,0,0,0,0,0,0,110,Sitio Arqueológico
20240315,2022,15,Lima,Sitio Arqueologico Caral,8,Agosto,2,0,0,0,0,0,1741,555,1209,3505,0,0,0,0,0,1159,0,0,1159,4664,Sitio Arqueológico
20240315,2022,15,Lima,Sitio Arqueologico Caral,9,Setiembre,0,0,0,0,0,0,891,793,2614,4298,0,0,0,0,0,88,0,1162,1250,5548,Sitio Arqueológico
20240315,2022,15,Lima,Sitio Arqueologico Caral,9,Setiembre,1,0,0,0,0,0,119,1,26,146,0,0,0,0,0,0,0,0,0,146,Sitio Arqueológico
20240315,2022,15,Lima,Sitio Arqueologico Caral,9,Setiembre,2,0,0,0,0,0,1010,794,2640,4444,0,0,0,0,0,88,0,1162,1250,5694,Sitio Arqueológico
20240315,2022,15,Lima,Sitio Arqueologico Caral,10,Octubre,0,0,0,0,0,0,1296,406,1315,3017,0,0,0,0,0,1277,394,0,1671,4688,Sitio Arqueológico
20240315,2022,15,Lima,Sitio Arqueologico Caral,10,Octubre,1,0,0,0,0,0,83,16,56,155,0,0,0,0,0,0,0,0,0,155,Sitio Arqueológico
20240315,2022,15,Lima,Sitio Arqueologico Caral,10,Octubre,2,0,0,0,0,0,1379,422,1371,3172,0,0,0,0,0,1277,394,0,1671,4843,Sitio Arqueológico
20240315,2022,15,Lima,Sitio Arqueologico Caral,11,Noviembre,0,0,0,0,0,0,932,333,1951,3216,0,0,0,0,0,32,615,0,647,3863,Sitio Arqueológico
20240315,2022,15,Lima,Sitio Arqueologico Caral,11,Noviembre,1,0,0,0,0,0,79,5,24,108,0,0,0,0,0,0,0,0,0,108,Sitio Arqueológico
20240315,2022,15,Lima,Sitio Arqueologico Caral,11,Noviembre,2,0,0,0,0,0,1011,338,1975,3324,0,0,0,0,0,32,615,0,647,3971,Sitio Arqueológico
20240315,2022,15,Lima,Sitio Arqueologico Caral,12,Diciembre,0,0,0,0,0,0,820,253,415,1488,0,0,0,0,0,200,10,0,210,1698,Sitio Arqueológico
20240315,2022,15,Lima,Sitio Arqueologico Caral,12,Diciembre,1,0,0,0,0,0,80,8,20,108,0,0,0,0,0,0,0,0,0,108,Sitio Arqueológico
20240315,2022,15,Lima,Sitio Arqueologico Caral,12,Diciembre,2,0,0,0,0,0,900,261,435,1596,0,0,0,0,0,200,10,0,210,1806,Sitio Arqueológico
20240315,2022,15,Lima,Zona Arqueologica de Huaycan de Cieneguilla,1,Enero,0,0,0,0,0,0,0,0,0,0,0,0,0,0,0,0,0,0,0,0,Sitio Arqueológico
20240315,2022,15,Lima,Zona Arqueologica de Huaycan de Cieneguilla,1,Enero,1,0,0,0,0,0,0,0,0,0,0,0,0,0,0,0,0,0,0,0,Sitio Arqueológico
20240315,2022,15,Lima,Zona Arqueologica de Huaycan de Cieneguilla,1,Enero,2,0,0,0,0,0,0,0,0,0,0,0,0,0,0,0,0,0,0,0,Sitio Arqueológico
20240315,2022,15,Lima,Zona Arqueologica de Huaycan de Cieneguilla,2,Febrero,0,0,0,0,0,3,104,36,12,155,0,0,0,0,0,4,0,0,4,159,Sitio Arqueológico
20240315,2022,15,Lima,Zona Arqueologica de Huaycan de Cieneguilla,2,Febrero,1,0,0,0,0,0,10,0,2,12,0,0,0,0,0,0,0,0,0,12,Sitio Arqueológico
20240315,2022,15,Lima,Zona Arqueologica de Huaycan de Cieneguilla,2,Febrero,2,0,0,0,0,3,114,36,14,167,0,0,0,0,0,4,0,0,4,171,Sitio Arqueológico
20240315,2022,15,Lima,Zona Arqueologica de Huaycan de Cieneguilla,3,Marzo,0,0,0,0,0,15,69,5,8,97,0,0,0,0,0,5,2,2,9,106,Sitio Arqueológico
20240315,2022,15,Lima,Zona Arqueologica de Huaycan de Cieneguilla,3,Marzo,1,0,0,0,0,0,8,0,0,8,0,0,0,0,0,0,0,0,0,8,Sitio Arqueológico
20240315,2022,15,Lima,Zona Arqueologica de Huaycan de Cieneguilla,3,Marzo,2,0,0,0,0,15,77,5,8,105,0,0,0,0,0,5,2,2,9,114,Sitio Arqueológico
20240315,2022,15,Lima,Zona Arqueologica de Huaycan de Cieneguilla,4,Abril,0,0,0,0,0,30,216,55,49,350,0,0,0,0,0,10,0,5,15,365,Sitio Arqueológico
20240315,2022,15,Lima,Zona Arqueologica de Huaycan de Cieneguilla,4,Abril,1,0,0,0,0,0,0,0,0,0,0,0,0,0,0,0,0,0,0,0,Sitio Arqueológico
20240315,2022,15,Lima,Zona Arqueologica de Huaycan de Cieneguilla,4,Abril,2,0,0,0,0,30,216,55,49,350,0,0,0,0,0,10,0,5,15,365,Sitio Arqueológico
20240315,2022,15,Lima,Zona Arqueologica de Huaycan de Cieneguilla,5,Mayo,0,0,0,0,0,95,271,8,21,395,0,0,0,0,10,95,0,11,116,511,Sitio Arqueológico
20240315,2022,15,Lima,Zona Arqueologica de Huaycan de Cieneguilla,5,Mayo,1,0,0,0,0,0,4,0,0,4,0,0,0,0,0,0,0,0,0,4,Sitio Arqueológico
20240315,2022,15,Lima,Zona Arqueologica de Huaycan de Cieneguilla,5,Mayo,2,0,0,0,0,95,275,8,21,399,0,0,0,0,10,95,0,11,116,515,Sitio Arqueológico
20240315,2022,15,Lima,Zona Arqueologica de Huaycan de Cieneguilla,6,Junio,0,0,0,0,0,82,241,17,30,370,0,0,0,0,10,311,11,111,443,813,Sitio Arqueológico
20240315,2022,15,Lima,Zona Arqueologica de Huaycan de Cieneguilla,6,Junio,1,0,0,0,0,0,0,0,0,0,0,0,0,0,0,0,0,0,0,0,Sitio Arqueológico
20240315,2022,15,Lima,Zona Arqueologica de Huaycan de Cieneguilla,6,Junio,2,0,0,0,0,82,241,17,30,370,0,0,0,0,10,311,11,111,443,813,Sitio Arqueológico
20240315,2022,15,Lima,Zona Arqueologica de Huaycan de Cieneguilla,7,Julio,0,0,0,0,0,130,1120,127,255,1632,0,0,0,0,8,141,5,48,202,1834,Sitio Arqueológico
20240315,2022,15,Lima,Zona Arqueologica de Huaycan de Cieneguilla,7,Julio,1,0,0,0,0,0,4,0,0,4,0,0,0,0,0,0,0,0,0,4,Sitio Arqueológico
20240315,2022,15,Lima,Zona Arqueologica de Huaycan de Cieneguilla,7,Julio,2,0,0,0,0,130,1124,127,255,1636,0,0,0,0,8,141,5,48,202,1838,Sitio Arqueológico
20240315,2022,15,Lima,Zona Arqueologica de Huaycan de Cieneguilla,8,Agosto,0,0,0,0,0,37,242,23,197,499,0,0,0,0,10,125,9,111,255,754,Sitio Arqueológico
20240315,2022,15,Lima,Zona Arqueologica de Huaycan de Cieneguilla,8,Agosto,1,0,0,0,0,0,0,0,0,0,0,0,0,0,0,0,0,0,0,0,Sitio Arqueológico
20240315,2022,15,Lima,Zona Arqueologica de Huaycan de Cieneguilla,8,Agosto,2,0,0,0,0,37,242,23,197,499,0,0,0,0,10,125,9,111,255,754,Sitio Arqueológico
20240315,2022,15,Lima,Zona Arqueologica de Huaycan de Cieneguilla,9,Setiembre,0,0,0,0,0,58,309,14,60,441,0,0,0,0,2,183,0,194,379,820,Sitio Arqueológico
20240315,2022,15,Lima,Zona Arqueologica de Huaycan de Cieneguilla,9,Setiembre,1,0,0,0,0,0,7,0,0,7,0,0,0,0,0,0,0,0,0,7,Sitio Arqueológico
20240315,2022,15,Lima,Zona Arqueologica de Huaycan de Cieneguilla,9,Setiembre,2,0,0,0,0,58,316,14,60,448,0,0,0,0,2,183,0,194,379,827,Sitio Arqueológico
20240315,2022,15,Lima,Zona Arqueologica de Huaycan de Cieneguilla,10,Octubre,0,0,0,0,0,120,445,88,285,938,0,0,0,0,0,37,0,22,59,997,Sitio Arqueológico
20240315,2022,15,Lima,Zona Arqueologica de Huaycan de Cieneguilla,10,Octubre,1,0,0,0,0,0,6,0,0,6,0,0,0,0,0,0,0,0,0,6,Sitio Arqueológico
20240315,2022,15,Lima,Zona Arqueologica de Huaycan de Cieneguilla,10,Octubre,2,0,0,0,0,120,451,88,285,944,0,0,0,0,0,37,0,22,59,1003,Sitio Arqueológico
20240315,2022,15,Lima,Zona Arqueologica de Huaycan de Cieneguilla,11,Noviembre,0,0,0,0,0,106,323,108,117,654,0,0,0,0,0,31,9,9,49,703,Sitio Arqueológico
20240315,2022,15,Lima,Zona Arqueologica de Huaycan de Cieneguilla,11,Noviembre,1,0,0,0,0,0,64,0,0,64,0,0,0,0,0,0,0,0,0,64,Sitio Arqueológico
20240315,2022,15,Lima,Zona Arqueologica de Huaycan de Cieneguilla,11,Noviembre,2,0,0,0,0,106,387,108,117,718,0,0,0,0,0,31,9,9,49,767,Sitio Arqueológico
20240315,2022,15,Lima,Zona Arqueologica de Huaycan de Cieneguilla,12,Diciembre,0,0,0,0,0,50,227,51,56,384,0,0,0,0,0,29,0,0,29,413,Sitio Arqueológico
20240315,2022,15,Lima,Zona Arqueologica de Huaycan de Cieneguilla,12,Diciembre,1,0,0,0,0,0,2,0,0,2,0,0,0,0,0,0,0,0,0,2,Sitio Arqueológico
20240315,2022,15,Lima,Zona Arqueologica de Huaycan de Cieneguilla,12,Diciembre,2,0,0,0,0,50,229,51,56,386,0,0,0,0,0,29,0,0,29,415,Sitio Arqueológico
20240315,2022,15,Lima,Complejo Arqueologico Mateo Salado,1,Enero,0,0,0,0,0,8,48,2,15,73,0,0,0,0,0,3,0,0,3,76,Sitio Arqueológico
20240315,2022,15,Lima,Complejo Arqueologico Mateo Salado,1,Enero,1,0,0,0,0,4,19,0,1,24,0,0,0,0,0,0,0,0,0,24,Sitio Arqueológico
20240315,2022,15,Lima,Complejo Arqueologico Mateo Salado,1,Enero,2,0,0,0,0,12,67,2,16,97,0,0,0,0,0,3,0,0,3,100,Sitio Arqueológico
20240315,2022,15,Lima,Complejo Arqueologico Mateo Salado,2,Febrero,0,0,0,0,0,11,32,1,14,58,0,0,0,0,13,34,17,9,73,131,Sitio Arqueológico
20240315,2022,15,Lima,Complejo Arqueologico Mateo Salado,2,Febrero,1,0,0,0,0,3,20,0,0,23,0,0,0,0,0,0,0,0,0,23,Sitio Arqueológico
20240315,2022,15,Lima,Complejo Arqueologico Mateo Salado,2,Febrero,2,0,0,0,0,14,52,1,14,81,0,0,0,0,13,34,17,9,73,154,Sitio Arqueológico
20240315,2022,15,Lima,Complejo Arqueologico Mateo Salado,3,Marzo,0,0,0,0,0,9,45,0,13,67,0,0,0,0,1,37,0,11,49,116,Sitio Arqueológico
20240315,2022,15,Lima,Complejo Arqueologico Mateo Salado,3,Marzo,1,0,0,0,0,2,18,0,2,22,0,0,0,0,0,0,0,0,0,22,Sitio Arqueológico
20240315,2022,15,Lima,Complejo Arqueologico Mateo Salado,3,Marzo,2,0,0,0,0,11,63,0,15,89,0,0,0,0,1,37,0,11,49,138,Sitio Arqueológico
20240315,2022,15,Lima,Complejo Arqueologico Mateo Salado,4,Abril,0,0,0,0,0,5,35,20,11,71,0,0,0,0,2,29,0,6,37,108,Sitio Arqueológico
20240315,2022,15,Lima,Complejo Arqueologico Mateo Salado,4,Abril,1,0,0,0,0,2,25,0,5,32,0,0,0,0,0,0,0,0,0,32,Sitio Arqueológico
20240315,2022,15,Lima,Complejo Arqueologico Mateo Salado,4,Abril,2,0,0,0,0,7,60,20,16,103,0,0,0,0,2,29,0,6,37,140,Sitio Arqueológico
20240315,2022,15,Lima,Complejo Arqueologico Mateo Salado,5,Mayo,0,0,0,0,0,6,38,33,13,90,0,0,0,0,7,15,0,1,23,113,Sitio Arqueológico
20240315,2022,15,Lima,Complejo Arqueologico Mateo Salado,5,Mayo,1,0,0,0,0,10,35,0,2,47,0,0,0,0,0,0,0,0,0,47,Sitio Arqueológico
20240315,2022,15,Lima,Complejo Arqueologico Mateo Salado,5,Mayo,2,0,0,0,0,16,73,33,15,137,0,0,0,0,7,15,0,1,23,160,Sitio Arqueológico
20240315,2022,15,Lima,Complejo Arqueologico Mateo Salado,6,Junio,0,0,0,0,0,10,44,13,59,126,0,0,0,0,2,17,11,7,37,163,Sitio Arqueológico
20240315,2022,15,Lima,Complejo Arqueologico Mateo Salado,6,Junio,1,0,0,0,0,0,28,0,0,28,0,0,0,0,0,0,0,0,0,28,Sitio Arqueológico
20240315,2022,15,Lima,Complejo Arqueologico Mateo Salado,6,Junio,2,0,0,0,0,10,72,13,59,154,0,0,0,0,2,17,11,7,37,191,Sitio Arqueológico
20240315,2022,15,Lima,Complejo Arqueologico Mateo Salado,7,Julio,0,0,0,0,0,14,58,16,97,185,0,0,0,0,6,33,0,17,56,241,Sitio Arqueológico
20240315,2022,15,Lima,Complejo Arqueologico Mateo Salado,7,Julio,1,0,0,0,0,4,25,0,1,30,0,0,0,0,0,0,0,0,0,30,Sitio Arqueológico
20240315,2022,15,Lima,Complejo Arqueologico Mateo Salado,7,Julio,2,0,0,0,0,18,83,16,98,215,0,0,0,0,6,33,0,17,56,271,Sitio Arqueológico
20240315,2022,15,Lima,Complejo Arqueologico Mateo Salado,8,Agosto,0,0,0,0,0,13,34,53,123,223,0,0,0,0,8,59,0,25,92,315,Sitio Arqueológico
20240315,2022,15,Lima,Complejo Arqueologico Mateo Salado,8,Agosto,1,0,0,0,0,6,20,0,0,26,0,0,0,0,0,0,0,0,0,26,Sitio Arqueológico
20240315,2022,15,Lima,Complejo Arqueologico Mateo Salado,8,Agosto,2,0,0,0,0,19,54,53,123,249,0,0,0,0,8,59,0,25,92,341,Sitio Arqueológico
20240315,2022,15,Lima,Complejo Arqueologico Mateo Salado,9,Setiembre,0,0,0,0,0,35,63,43,199,340,0,0,0,0,8,26,0,16,50,390,Sitio Arqueológico
20240315,2022,15,Lima,Complejo Arqueologico Mateo Salado,9,Setiembre,1,0,0,0,0,3,30,0,0,33,0,0,0,0,0,0,0,0,0,33,Sitio Arqueológico
20240315,2022,15,Lima,Complejo Arqueologico Mateo Salado,9,Setiembre,2,0,0,0,0,38,93,43,199,373,0,0,0,0,8,26,0,16,50,423,Sitio Arqueológico
20240315,2022,15,Lima,Complejo Arqueologico Mateo Salado,10,Octubre,0,1,0,0,0,18,37,19,127,202,0,0,0,0,0,3,0,0,3,205,Sitio Arqueológico
20240315,2022,15,Lima,Complejo Arqueologico Mateo Salado,10,Octubre,1,0,0,0,0,1,13,0,1,15,0,0,0,0,0,0,0,0,0,15,Sitio Arqueológico
20240315,2022,15,Lima,Complejo Arqueologico Mateo Salado,10,Octubre,2,1,0,0,0,19,50,19,128,217,0,0,0,0,0,3,0,0,3,220,Sitio Arqueológico
20240315,2022,15,Lima,Complejo Arqueologico Mateo Salado,11,Noviembre,0,0,0,0,0,26,40,17,232,315,0,0,0,0,0,30,0,6,36,351,Sitio Arqueológico
20240315,2022,15,Lima,Complejo Arqueologico Mateo Salado,11,Noviembre,1,0,0,0,0,1,53,1,0,55,0,0,0,0,0,0,0,0,0,55,Sitio Arqueológico
20240315,2022,15,Lima,Complejo Arqueologico Mateo Salado,11,Noviembre,2,0,0,0,0,27,93,18,232,370,0,0,0,0,0,30,0,6,36,406,Sitio Arqueológico
20240315,2022,15,Lima,Complejo Arqueologico Mateo Salado,12,Diciembre,0,0,0,0,0,13,17,7,76,113,0,0,0,0,1,25,0,2,28,141,Sitio Arqueológico
20240315,2022,15,Lima,Complejo Arqueologico Mateo Salado,12,Diciembre,1,0,0,0,0,0,302,0,4,306,0,0,0,0,0,0,0,0,0,306,Sitio Arqueológico
20240315,2022,15,Lima,Complejo Arqueologico Mateo Salado,12,Diciembre,2,0,0,0,0,13,319,7,80,419,0,0,0,0,1,25,0,2,28,447,Sitio Arqueológico
20240315,2022,18,Moquegua,Sitio Arqueologico de Cerro Baul,1,Enero,0,0,0,0,0,0,0,0,0,0,0,0,0,0,0,0,0,0,0,0,Sitio Arqueológico
20240315,2022,18,Moquegua,Sitio Arqueologico de Cerro Baul,1,Enero,1,0,0,0,0,0,0,0,0,0,0,0,0,0,0,0,0,0,0,0,Sitio Arqueológico
20240315,2022,18,Moquegua,Sitio Arqueologico de Cerro Baul,1,Enero,2,0,0,0,0,0,0,0,0,0,0,0,0,0,0,0,0,0,0,0,Sitio Arqueológico
20240315,2022,18,Moquegua,Sitio Arqueologico de Cerro Baul,2,Febrero,0,0,0,0,0,0,0,0,0,0,0,0,0,0,0,0,0,0,0,0,Sitio Arqueológico
20240315,2022,18,Moquegua,Sitio Arqueologico de Cerro Baul,2,Febrero,1,0,0,0,0,0,0,0,0,0,0,0,0,0,0,0,0,0,0,0,Sitio Arqueológico
20240315,2022,18,Moquegua,Sitio Arqueologico de Cerro Baul,2,Febrero,2,0,0,0,0,0,0,0,0,0,0,0,0,0,0,0,0,0,0,0,Sitio Arqueológico
20240315,2022,18,Moquegua,Sitio Arqueologico de Cerro Baul,3,Marzo,0,0,0,0,0,0,0,0,0,0,0,0,0,0,0,0,0,0,0,0,Sitio Arqueológico
20240315,2022,18,Moquegua,Sitio Arqueologico de Cerro Baul,3,Marzo,1,0,0,0,0,0,0,0,0,0,0,0,0,0,0,0,0,0,0,0,Sitio Arqueológico
20240315,2022,18,Moquegua,Sitio Arqueologico de Cerro Baul,3,Marzo,2,0,0,0,0,0,0,0,0,0,0,0,0,0,0,0,0,0,0,0,Sitio Arqueológico
20240315,2022,18,Moquegua,Sitio Arqueologico de Cerro Baul,4,Abril,0,0,0,0,0,0,0,0,0,0,0,0,0,0,0,0,0,0,0,0,Sitio Arqueológico
20240315,2022,18,Moquegua,Sitio Arqueologico de Cerro Baul,4,Abril,1,0,0,0,0,0,0,0,0,0,0,0,0,0,0,0,0,0,0,0,Sitio Arqueológico
20240315,2022,18,Moquegua,Sitio Arqueologico de Cerro Baul,4,Abril,2,0,0,0,0,0,0,0,0,0,0,0,0,0,0,0,0,0,0,0,Sitio Arqueológico
20240315,2022,18,Moquegua,Sitio Arqueologico de Cerro Baul,5,Mayo,0,0,0,0,0,0,0,0,0,0,0,0,0,0,0,0,0,0,0,0,Sitio Arqueológico
20240315,2022,18,Moquegua,Sitio Arqueologico de Cerro Baul,5,Mayo,1,0,0,0,0,0,0,0,0,0,0,0,0,0,0,0,0,0,0,0,Sitio Arqueológico
20240315,2022,18,Moquegua,Sitio Arqueologico de Cerro Baul,5,Mayo,2,0,0,0,0,0,0,0,0,0,0,0,0,0,0,0,0,0,0,0,Sitio Arqueológico
20240315,2022,18,Moquegua,Sitio Arqueologico de Cerro Baul,6,Junio,0,0,0,0,0,0,0,0,0,0,0,0,0,0,0,0,0,0,0,0,Sitio Arqueológico
20240315,2022,18,Moquegua,Sitio Arqueologico de Cerro Baul,6,Junio,1,0,0,0,0,0,0,0,0,0,0,0,0,0,0,0,0,0,0,0,Sitio Arqueológico
20240315,2022,18,Moquegua,Sitio Arqueologico de Cerro Baul,6,Junio,2,0,0,0,0,0,0,0,0,0,0,0,0,0,0,0,0,0,0,0,Sitio Arqueológico
20240315,2022,18,Moquegua,Sitio Arqueologico de Cerro Baul,7,Julio,0,0,0,0,0,0,0,0,0,0,0,0,0,0,0,0,0,0,0,0,Sitio Arqueológico
20240315,2022,18,Moquegua,Sitio Arqueologico de Cerro Baul,7,Julio,1,0,0,0,0,0,0,0,0,0,0,0,0,0,0,0,0,0,0,0,Sitio Arqueológico
20240315,2022,18,Moquegua,Sitio Arqueologico de Cerro Baul,7,Julio,2,0,0,0,0,0,0,0,0,0,0,0,0,0,0,0,0,0,0,0,Sitio Arqueológico
20240315,2022,18,Moquegua,Sitio Arqueologico de Cerro Baul,8,Agosto,0,0,0,0,0,0,0,0,0,0,0,0,0,0,0,0,0,0,0,0,Sitio Arqueológico
20240315,2022,18,Moquegua,Sitio Arqueologico de Cerro Baul,8,Agosto,1,0,0,0,0,0,0,0,0,0,0,0,0,0,0,0,0,0,0,0,Sitio Arqueológico
20240315,2022,18,Moquegua,Sitio Arqueologico de Cerro Baul,8,Agosto,2,0,0,0,0,0,0,0,0,0,0,0,0,0,0,0,0,0,0,0,Sitio Arqueológico
20240315,2022,18,Moquegua,Sitio Arqueologico de Cerro Baul,9,Setiembre,0,0,0,0,0,0,0,0,0,0,0,0,0,0,0,0,0,0,0,0,Sitio Arqueológico
20240315,2022,18,Moquegua,Sitio Arqueologico de Cerro Baul,9,Setiembre,1,0,0,0,0,0,0,0,0,0,0,0,0,0,0,0,0,0,0,0,Sitio Arqueológico
20240315,2022,18,Moquegua,Sitio Arqueologico de Cerro Baul,9,Setiembre,2,0,0,0,0,0,0,0,0,0,0,0,0,0,0,0,0,0,0,0,Sitio Arqueológico
20240315,2022,18,Moquegua,Sitio Arqueologico de Cerro Baul,10,Octubre,0,0,0,0,0,0,0,0,0,0,0,0,0,0,0,0,0,0,0,0,Sitio Arqueológico
20240315,2022,18,Moquegua,Sitio Arqueologico de Cerro Baul,10,Octubre,1,0,0,0,0,0,0,0,0,0,0,0,0,0,0,0,0,0,0,0,Sitio Arqueológico
20240315,2022,18,Moquegua,Sitio Arqueologico de Cerro Baul,10,Octubre,2,0,0,0,0,0,0,0,0,0,0,0,0,0,0,0,0,0,0,0,Sitio Arqueológico
20240315,2022,18,Moquegua,Sitio Arqueologico de Cerro Baul,11,Noviembre,0,0,0,0,0,0,0,0,0,0,0,0,0,0,0,0,0,0,0,0,Sitio Arqueológico
20240315,2022,18,Moquegua,Sitio Arqueologico de Cerro Baul,11,Noviembre,1,0,0,0,0,0,0,0,0,0,0,0,0,0,0,0,0,0,0,0,Sitio Arqueológico
20240315,2022,18,Moquegua,Sitio Arqueologico de Cerro Baul,11,Noviembre,2,0,0,0,0,0,0,0,0,0,0,0,0,0,0,0,0,0,0,0,Sitio Arqueológico
20240315,2022,18,Moquegua,Sitio Arqueologico de Cerro Baul,12,Diciembre,0,0,0,0,0,0,0,0,0,0,0,0,0,0,0,0,0,0,0,0,Sitio Arqueológico
20240315,2022,18,Moquegua,Sitio Arqueologico de Cerro Baul,12,Diciembre,1,0,0,0,0,0,0,0,0,0,0,0,0,0,0,0,0,0,0,0,Sitio Arqueológico
20240315,2022,18,Moquegua,Sitio Arqueologico de Cerro Baul,12,Diciembre,2,0,0,0,0,0,0,0,0,0,0,0,0,0,0,0,0,0,0,0,Sitio Arqueológico
20240315,2022,21,Puno,Monumento Arqueologico de Cutimbo,1,Enero,0,0,0,0,0,0,0,0,0,0,0,0,0,0,0,0,0,0,0,0,Sitio Arqueológico
20240315,2022,21,Puno,Monumento Arqueologico de Cutimbo,1,Enero,1,0,0,0,0,0,0,0,0,0,0,0,0,0,0,0,0,0,0,0,Sitio Arqueológico
20240315,2022,21,Puno,Monumento Arqueologico de Cutimbo,1,Enero,2,0,0,0,0,0,0,0,0,0,0,0,0,0,0,0,0,0,0,0,Sitio Arqueológico
20240315,2022,21,Puno,Monumento Arqueologico de Cutimbo,2,Febrero,0,0,0,0,0,0,0,0,0,0,0,0,0,0,0,0,0,0,0,0,Sitio Arqueológico
20240315,2022,21,Puno,Monumento Arqueologico de Cutimbo,2,Febrero,1,0,0,0,0,0,0,0,0,0,0,0,0,0,0,0,0,0,0,0,Sitio Arqueológico
20240315,2022,21,Puno,Monumento Arqueologico de Cutimbo,2,Febrero,2,0,0,0,0,0,0,0,0,0,0,0,0,0,0,0,0,0,0,0,Sitio Arqueológico
20240315,2022,21,Puno,Monumento Arqueologico de Cutimbo,3,Marzo,0,0,0,0,0,0,0,0,0,0,0,0,0,0,0,0,0,0,0,0,Sitio Arqueológico
20240315,2022,21,Puno,Monumento Arqueologico de Cutimbo,3,Marzo,1,0,0,0,0,0,0,0,0,0,0,0,0,0,0,0,0,0,0,0,Sitio Arqueológico
20240315,2022,21,Puno,Monumento Arqueologico de Cutimbo,3,Marzo,2,0,0,0,0,0,0,0,0,0,0,0,0,0,0,0,0,0,0,0,Sitio Arqueológico
20240315,2022,21,Puno,Monumento Arqueologico de Cutimbo,4,Abril,0,0,0,0,0,0,0,0,0,0,0,0,0,0,0,0,0,0,0,0,Sitio Arqueológico
20240315,2022,21,Puno,Monumento Arqueologico de Cutimbo,4,Abril,1,0,0,0,0,0,0,0,0,0,0,0,0,0,0,0,0,0,0,0,Sitio Arqueológico
20240315,2022,21,Puno,Monumento Arqueologico de Cutimbo,4,Abril,2,0,0,0,0,0,0,0,0,0,0,0,0,0,0,0,0,0,0,0,Sitio Arqueológico
20240315,2022,21,Puno,Monumento Arqueologico de Cutimbo,5,Mayo,0,0,0,0,0,0,0,0,0,0,0,0,0,0,0,0,0,0,0,0,Sitio Arqueológico
20240315,2022,21,Puno,Monumento Arqueologico de Cutimbo,5,Mayo,1,0,0,0,0,0,0,0,0,0,0,0,0,0,0,0,0,0,0,0,Sitio Arqueológico
20240315,2022,21,Puno,Monumento Arqueologico de Cutimbo,5,Mayo,2,0,0,0,0,0,0,0,0,0,0,0,0,0,0,0,0,0,0,0,Sitio Arqueológico
20240315,2022,21,Puno,Monumento Arqueologico de Cutimbo,6,Junio,0,0,0,0,0,0,0,0,0,0,0,0,0,0,0,0,0,0,0,0,Sitio Arqueológico
20240315,2022,21,Puno,Monumento Arqueologico de Cutimbo,6,Junio,1,0,0,0,0,0,0,0,0,0,0,0,0,0,0,0,0,0,0,0,Sitio Arqueológico
20240315,2022,21,Puno,Monumento Arqueologico de Cutimbo,6,Junio,2,0,0,0,0,0,0,0,0,0,0,0,0,0,0,0,0,0,0,0,Sitio Arqueológico
20240315,2022,21,Puno,Monumento Arqueologico de Cutimbo,7,Julio,0,0,0,0,0,0,0,0,0,0,0,0,0,0,0,0,0,0,0,0,Sitio Arqueológico
20240315,2022,21,Puno,Monumento Arqueologico de Cutimbo,7,Julio,1,0,0,0,0,0,0,0,0,0,0,0,0,0,0,0,0,0,0,0,Sitio Arqueológico
20240315,2022,21,Puno,Monumento Arqueologico de Cutimbo,7,Julio,2,0,0,0,0,0,0,0,0,0,0,0,0,0,0,0,0,0,0,0,Sitio Arqueológico
20240315,2022,21,Puno,Monumento Arqueologico de Cutimbo,8,Agosto,0,0,0,0,0,0,0,0,0,0,0,0,0,0,0,0,0,0,0,0,Sitio Arqueológico
20240315,2022,21,Puno,Monumento Arqueologico de Cutimbo,8,Agosto,1,0,0,0,0,0,0,0,0,0,0,0,0,0,0,0,0,0,0,0,Sitio Arqueológico
20240315,2022,21,Puno,Monumento Arqueologico de Cutimbo,8,Agosto,2,0,0,0,0,0,0,0,0,0,0,0,0,0,0,0,0,0,0,0,Sitio Arqueológico
20240315,2022,21,Puno,Monumento Arqueologico de Cutimbo,9,Setiembre,0,0,0,0,0,0,0,0,0,0,0,0,0,0,0,0,0,0,0,0,Sitio Arqueológico
20240315,2022,21,Puno,Monumento Arqueologico de Cutimbo,9,Setiembre,1,0,0,0,0,0,0,0,0,0,0,0,0,0,0,0,0,0,0,0,Sitio Arqueológico
20240315,2022,21,Puno,Monumento Arqueologico de Cutimbo,9,Setiembre,2,0,0,0,0,0,0,0,0,0,0,0,0,0,0,0,0,0,0,0,Sitio Arqueológico
20240315,2022,21,Puno,Monumento Arqueologico de Cutimbo,10,Octubre,0,0,0,0,0,0,0,0,0,0,0,0,0,0,0,0,0,0,0,0,Sitio Arqueológico
20240315,2022,21,Puno,Monumento Arqueologico de Cutimbo,10,Octubre,1,0,0,0,0,0,0,0,0,0,0,0,0,0,0,0,0,0,0,0,Sitio Arqueológico
20240315,2022,21,Puno,Monumento Arqueologico de Cutimbo,10,Octubre,2,0,0,0,0,0,0,0,0,0,0,0,0,0,0,0,0,0,0,0,Sitio Arqueológico
20240315,2022,21,Puno,Monumento Arqueologico de Cutimbo,11,Noviembre,0,0,0,0,0,0,0,0,0,0,0,0,0,0,0,0,0,0,0,0,Sitio Arqueológico
20240315,2022,21,Puno,Monumento Arqueologico de Cutimbo,11,Noviembre,1,0,0,0,0,0,0,0,0,0,0,0,0,0,0,0,0,0,0,0,Sitio Arqueológico
20240315,2022,21,Puno,Monumento Arqueologico de Cutimbo,11,Noviembre,2,0,0,0,0,0,0,0,0,0,0,0,0,0,0,0,0,0,0,0,Sitio Arqueológico
20240315,2022,21,Puno,Monumento Arqueologico de Cutimbo,12,Diciembre,0,0,0,0,0,0,0,0,0,0,0,0,0,0,0,0,0,0,0,0,Sitio Arqueológico
20240315,2022,21,Puno,Monumento Arqueologico de Cutimbo,12,Diciembre,1,0,0,0,0,0,0,0,0,0,0,0,0,0,0,0,0,0,0,0,Sitio Arqueológico
20240315,2022,21,Puno,Monumento Arqueologico de Cutimbo,12,Diciembre,2,0,0,0,0,0,0,0,0,0,0,0,0,0,0,0,0,0,0,0,Sitio Arqueológico
20240315,2022,21,Puno,Sitio Arqueologico de Sillustani,1,Enero,0,8,0,0,0,0,1953,521,501,2983,0,0,0,0,0,588,145,92,825,3808,Sitio Arqueológico
20240315,2022,21,Puno,Sitio Arqueologico de Sillustani,1,Enero,1,0,0,0,0,0,2193,148,73,2414,0,0,0,0,0,0,0,0,0,2414,Sitio Arqueológico
20240315,2022,21,Puno,Sitio Arqueologico de Sillustani,1,Enero,2,8,0,0,0,0,4146,669,574,5397,0,0,0,0,0,588,145,92,825,6222,Sitio Arqueológico
20240315,2022,21,Puno,Sitio Arqueologico de Sillustani,2,Febrero,0,6,0,0,0,0,2054,581,439,3080,0,0,0,0,0,784,162,98,1044,4124,Sitio Arqueológico
20240315,2022,21,Puno,Sitio Arqueologico de Sillustani,2,Febrero,1,0,0,0,0,0,1932,140,66,2138,0,0,0,0,0,0,0,0,0,2138,Sitio Arqueológico
20240315,2022,21,Puno,Sitio Arqueologico de Sillustani,2,Febrero,2,6,0,0,0,0,3986,721,505,5218,0,0,0,0,0,784,162,98,1044,6262,Sitio Arqueológico
20240315,2022,21,Puno,Sitio Arqueologico de Sillustani,3,Marzo,0,11,0,0,0,0,1529,397,178,2115,0,0,0,0,0,354,81,103,538,2653,Sitio Arqueológico
20240315,2022,21,Puno,Sitio Arqueologico de Sillustani,3,Marzo,1,0,0,0,0,0,1270,44,12,1326,0,0,0,0,0,0,0,0,0,1326,Sitio Arqueológico
20240315,2022,21,Puno,Sitio Arqueologico de Sillustani,3,Marzo,2,11,0,0,0,0,2799,441,190,3441,0,0,0,0,0,354,81,103,538,3979,Sitio Arqueológico
20240315,2022,21,Puno,Sitio Arqueologico de Sillustani,4,Abril,0,0,0,0,0,0,2068,458,249,2775,0,0,0,0,0,432,81,103,616,3391,Sitio Arqueológico
20240315,2022,21,Puno,Sitio Arqueologico de Sillustani,4,Abril,1,0,0,0,0,0,1991,102,19,2112,0,0,0,0,0,0,0,0,0,2112,Sitio Arqueológico
20240315,2022,21,Puno,Sitio Arqueologico de Sillustani,4,Abril,2,0,0,0,0,0,4059,560,268,4887,0,0,0,0,0,432,81,103,616,5503,Sitio Arqueológico
20240315,2022,21,Puno,Sitio Arqueologico de Sillustani,5,Mayo,0,5,0,0,0,0,1732,357,212,2306,0,0,0,0,0,277,78,45,400,2706,Sitio Arqueológico
20240315,2022,21,Puno,Sitio Arqueologico de Sillustani,5,Mayo,1,0,0,0,0,0,1529,81,4,1614,0,0,0,0,0,0,0,0,0,1614,Sitio Arqueológico
20240315,2022,21,Puno,Sitio Arqueologico de Sillustani,5,Mayo,2,5,0,0,0,0,3261,438,216,3920,0,0,0,0,0,277,78,45,400,4320,Sitio Arqueológico
20240315,2022,21,Puno,Sitio Arqueologico de Sillustani,6,Junio,0,3,0,0,0,0,1153,352,154,1662,0,0,0,0,0,256,70,71,397,2059,Sitio Arqueológico
20240315,2022,21,Puno,Sitio Arqueologico de Sillustani,6,Junio,1,0,0,0,0,0,1831,47,0,1878,0,0,0,0,0,0,0,0,0,1878,Sitio Arqueológico
20240315,2022,21,Puno,Sitio Arqueologico de Sillustani,6,Junio,2,3,0,0,0,0,2984,399,154,3540,0,0,0,0,0,256,70,71,397,3937,Sitio Arqueológico
20240315,2022,21,Puno,Sitio Arqueologico de Sillustani,7,Julio,0,0,0,0,0,0,3015,789,555,4359,0,0,0,0,0,293,128,60,481,4840,Sitio Arqueológico
20240315,2022,21,Puno,Sitio Arqueologico de Sillustani,7,Julio,1,0,0,0,0,0,2061,132,17,2210,0,0,0,0,0,0,0,0,0,2210,Sitio Arqueológico
20240315,2022,21,Puno,Sitio Arqueologico de Sillustani,7,Julio,2,0,0,0,0,0,5076,921,572,6569,0,0,0,0,0,293,128,60,481,7050,Sitio Arqueológico
20240315,2022,21,Puno,Sitio Arqueologico de Sillustani,8,Agosto,0,0,0,0,0,0,3047,623,771,4441,0,0,0,0,0,351,75,93,519,4960,Sitio Arqueológico
20240315,2022,21,Puno,Sitio Arqueologico de Sillustani,8,Agosto,1,0,0,0,0,0,3011,87,18,3116,0,0,0,0,0,0,0,0,0,3116,Sitio Arqueológico
20240315,2022,21,Puno,Sitio Arqueologico de Sillustani,8,Agosto,2,0,0,0,0,0,6058,710,789,7557,0,0,0,0,0,351,75,93,519,8076,Sitio Arqueológico
20240315,2022,21,Puno,Sitio Arqueologico de Sillustani,9,Setiembre,0,0,0,0,0,0,1381,584,517,2482,0,0,0,0,0,343,95,101,539,3021,Sitio Arqueológico
20240315,2022,21,Puno,Sitio Arqueologico de Sillustani,9,Setiembre,1,0,0,0,0,0,2058,0,39,2097,0,0,0,0,0,0,0,0,0,2097,Sitio Arqueológico
20240315,2022,21,Puno,Sitio Arqueologico de Sillustani,9,Setiembre,2,0,0,0,0,0,3439,584,556,4579,0,0,0,0,0,343,95,101,539,5118,Sitio Arqueológico
20240315,2022,21,Puno,Sitio Arqueologico de Sillustani,10,Octubre,0,0,0,0,0,0,1802,756,641,3199,0,0,0,0,0,59,13,19,91,3290,Sitio Arqueológico
20240315,2022,21,Puno,Sitio Arqueologico de Sillustani,10,Octubre,1,0,0,0,0,0,2601,14,1,2616,0,0,0,0,0,0,0,0,0,2616,Sitio Arqueológico
20240315,2022,21,Puno,Sitio Arqueologico de Sillustani,10,Octubre,2,0,0,0,0,0,4403,770,642,5815,0,0,0,0,0,59,13,19,91,5906,Sitio Arqueológico
20240315,2022,21,Puno,Sitio Arqueologico de Sillustani,11,Noviembre,0,0,0,0,0,0,1276,733,869,2878,0,0,0,0,0,147,98,74,319,3197,Sitio Arqueológico
20240315,2022,21,Puno,Sitio Arqueologico de Sillustani,11,Noviembre,1,0,0,0,0,0,1921,0,0,1921,0,0,0,0,0,0,0,0,0,1921,Sitio Arqueológico
20240315,2022,21,Puno,Sitio Arqueologico de Sillustani,11,Noviembre,2,0,0,0,0,0,3197,733,869,4799,0,0,0,0,0,147,98,74,319,5118,Sitio Arqueológico
20240315,2022,21,Puno,Sitio Arqueologico de Sillustani,12,Diciembre,0,1,0,0,0,0,994,491,464,1950,0,0,0,0,0,131,50,44,225,2175,Sitio Arqueológico
20240315,2022,21,Puno,Sitio Arqueologico de Sillustani,12,Diciembre,1,0,0,0,0,0,589,0,0,589,0,0,0,0,0,0,0,0,0,589,Sitio Arqueológico
20240315,2022,21,Puno,Sitio Arqueologico de Sillustani,12,Diciembre,2,1,0,0,0,0,1583,491,464,2539,0,0,0,0,0,131,50,44,225,2764,Sitio Arqueológico
20240315,2022,24,Tumbes,Zona Arqueologica Monumental Cabeza de Vaca,1,Enero,0,0,0,0,0,15,118,5,25,163,0,0,0,0,1,13,3,0,17,180,Sitio Arqueológico
20240315,2022,24,Tumbes,Zona Arqueologica Monumental Cabeza de Vaca,1,Enero,1,0,0,0,0,0,0,0,0,0,0,0,0,0,0,0,0,0,0,0,Sitio Arqueológico
20240315,2022,24,Tumbes,Zona Arqueologica Monumental Cabeza de Vaca,1,Enero,2,0,0,0,0,15,118,5,25,163,0,0,0,0,1,13,3,0,17,180,Sitio Arqueológico
20240315,2022,24,Tumbes,Zona Arqueologica Monumental Cabeza de Vaca,2,Febrero,0,0,0,0,0,6,61,0,15,82,0,0,0,0,13,55,0,6,74,156,Sitio Arqueológico
20240315,2022,24,Tumbes,Zona Arqueologica Monumental Cabeza de Vaca,2,Febrero,1,0,0,0,0,0,38,0,0,38,0,0,0,0,0,0,0,0,0,38,Sitio Arqueológico
20240315,2022,24,Tumbes,Zona Arqueologica Monumental Cabeza de Vaca,2,Febrero,2,0,0,0,0,6,99,0,15,120,0,0,0,0,13,55,0,6,74,194,Sitio Arqueológico
20240315,2022,24,Tumbes,Zona Arqueologica Monumental Cabeza de Vaca,3,Marzo,0,0,0,0,0,4,41,0,4,49,0,0,0,0,0,18,2,0,20,69,Sitio Arqueológico
20240315,2022,24,Tumbes,Zona Arqueologica Monumental Cabeza de Vaca,3,Marzo,1,0,0,0,0,0,1,0,0,1,0,0,0,0,0,0,0,0,0,1,Sitio Arqueológico
20240315,2022,24,Tumbes,Zona Arqueologica Monumental Cabeza de Vaca,3,Marzo,2,0,0,0,0,4,42,0,4,50,0,0,0,0,0,18,2,0,20,70,Sitio Arqueológico
20240315,2022,24,Tumbes,Zona Arqueologica Monumental Cabeza de Vaca,4,Abril,0,0,0,0,0,10,35,25,4,74,0,0,0,0,6,57,25,9,97,171,Sitio Arqueológico
20240315,2022,24,Tumbes,Zona Arqueologica Monumental Cabeza de Vaca,4,Abril,1,0,0,0,0,0,0,0,0,0,0,0,0,0,0,0,0,0,0,0,Sitio Arqueológico
20240315,2022,24,Tumbes,Zona Arqueologica Monumental Cabeza de Vaca,4,Abril,2,0,0,0,0,10,35,25,4,74,0,0,0,0,6,57,25,9,97,171,Sitio Arqueológico
20240315,2022,24,Tumbes,Zona Arqueologica Monumental Cabeza de Vaca,5,Mayo,0,0,0,0,0,25,47,0,110,182,0,0,0,0,18,158,45,228,449,631,Sitio Arqueológico
20240315,2022,24,Tumbes,Zona Arqueologica Monumental Cabeza de Vaca,5,Mayo,1,0,0,0,0,1,2,0,0,3,0,0,0,0,3,4,0,1,8,11,Sitio Arqueológico
20240315,2022,24,Tumbes,Zona Arqueologica Monumental Cabeza de Vaca,5,Mayo,2,0,0,0,0,26,49,0,110,185,0,0,0,0,21,162,45,229,457,642,Sitio Arqueológico
20240315,2022,24,Tumbes,Zona Arqueologica Monumental Cabeza de Vaca,6,Junio,0,0,0,0,0,76,67,10,205,358,0,0,0,0,12,114,3,52,181,539,Sitio Arqueológico
20240315,2022,24,Tumbes,Zona Arqueologica Monumental Cabeza de Vaca,6,Junio,1,0,0,0,0,0,2,0,0,2,0,0,0,0,0,0,0,0,0,2,Sitio Arqueológico
20240315,2022,24,Tumbes,Zona Arqueologica Monumental Cabeza de Vaca,6,Junio,2,0,0,0,0,76,69,10,205,360,0,0,0,0,12,114,3,52,181,541,Sitio Arqueológico
20240315,2022,24,Tumbes,Zona Arqueologica Monumental Cabeza de Vaca,7,Julio,0,0,0,0,0,15,52,66,270,403,0,0,0,0,0,20,0,80,100,503,Sitio Arqueológico
20240315,2022,24,Tumbes,Zona Arqueologica Monumental Cabeza de Vaca,7,Julio,1,0,0,0,0,0,7,0,0,7,0,0,0,0,0,0,0,0,0,7,Sitio Arqueológico
20240315,2022,24,Tumbes,Zona Arqueologica Monumental Cabeza de Vaca,7,Julio,2,0,0,0,0,15,59,66,270,410,0,0,0,0,0,20,0,80,100,510,Sitio Arqueológico
20240315,2022,24,Tumbes,Zona Arqueologica Monumental Cabeza de Vaca,8,Agosto,0,0,0,0,0,42,85,1,420,548,0,0,0,0,3,6,0,25,34,582,Sitio Arqueológico
20240315,2022,24,Tumbes,Zona Arqueologica Monumental Cabeza de Vaca,8,Agosto,1,0,0,0,0,0,3,0,0,3,0,0,0,0,0,1,0,0,1,4,Sitio Arqueológico
20240315,2022,24,Tumbes,Zona Arqueologica Monumental Cabeza de Vaca,8,Agosto,2,0,0,0,0,42,88,1,420,551,0,0,0,0,3,7,0,25,35,586,Sitio Arqueológico
20240315,2022,24,Tumbes,Zona Arqueologica Monumental Cabeza de Vaca,9,Setiembre,0,0,0,0,0,50,123,9,512,694,0,0,0,0,4,27,24,72,127,821,Sitio Arqueológico
20240315,2022,24,Tumbes,Zona Arqueologica Monumental Cabeza de Vaca,9,Setiembre,1,0,0,0,0,0,0,0,0,0,0,0,0,0,0,0,0,0,0,0,Sitio Arqueológico
20240315,2022,24,Tumbes,Zona Arqueologica Monumental Cabeza de Vaca,9,Setiembre,2,0,0,0,0,50,123,9,512,694,0,0,0,0,4,27,24,72,127,821,Sitio Arqueológico
20240315,2022,24,Tumbes,Zona Arqueologica Monumental Cabeza de Vaca,10,Octubre,0,0,0,0,0,56,96,1,268,421,0,0,0,0,1,14,0,2,17,438,Sitio Arqueológico
20240315,2022,24,Tumbes,Zona Arqueologica Monumental Cabeza de Vaca,10,Octubre,1,0,0,0,0,0,3,0,0,3,0,0,0,0,0,0,0,0,0,3,Sitio Arqueológico
20240315,2022,24,Tumbes,Zona Arqueologica Monumental Cabeza de Vaca,10,Octubre,2,0,0,0,0,56,99,1,268,424,0,0,0,0,1,14,0,2,17,441,Sitio Arqueológico
20240315,2022,24,Tumbes,Zona Arqueologica Monumental Cabeza de Vaca,11,Noviembre,0,0,0,0,0,91,119,5,1002,1217,0,0,0,0,0,6,0,8,14,1231,Sitio Arqueológico
20240315,2022,24,Tumbes,Zona Arqueologica Monumental Cabeza de Vaca,11,Noviembre,1,0,0,0,0,0,2,0,0,2,0,0,0,0,0,0,0,0,0,2,Sitio Arqueológico
20240315,2022,24,Tumbes,Zona Arqueologica Monumental Cabeza de Vaca,11,Noviembre,2,0,0,0,0,91,121,5,1002,1219,0,0,0,0,0,6,0,8,14,1233,Sitio Arqueológico
20240315,2022,24,Tumbes,Zona Arqueologica Monumental Cabeza de Vaca,12,Diciembre,0,0,0,0,0,19,55,34,93,201,0,0,0,0,0,38,0,0,38,239,Sitio Arqueológico
20240315,2022,24,Tumbes,Zona Arqueologica Monumental Cabeza de Vaca,12,Diciembre,1,0,0,0,0,5,7,0,0,12,0,0,0,0,0,0,0,0,0,12,Sitio Arqueológico
20240315,2022,24,Tumbes,Zona Arqueologica Monumental Cabeza de Vaca,12,Diciembre,2,0,0,0,0,24,62,34,93,213,0,0,0,0,0,38,0,0,38,251,Sitio Arqueológico
20240315,2023,1,Amazonas,Zona Arqueologica Monumental Kuelap,1,Enero,0,0,0,0,0,0,0,0,0,0,0,0,0,0,270,1965,180,465,2880,2880,Sitio Arqueológico
20240315,2023,1,Amazonas,Zona Arqueologica Monumental Kuelap,1,Enero,1,0,0,0,0,0,0,0,0,0,0,0,0,0,17,142,4,5,168,168,Sitio Arqueológico
20240315,2023,1,Amazonas,Zona Arqueologica Monumental Kuelap,1,Enero,2,0,0,0,0,0,0,0,0,0,0,0,0,0,287,2107,184,470,3048,3048,Sitio Arqueológico
20240315,2023,1,Amazonas,Zona Arqueologica Monumental Kuelap,2,Febrero,0,0,0,0,0,0,0,0,0,0,0,0,0,0,250,2265,198,489,3202,3202,Sitio Arqueológico
20240315,2023,1,Amazonas,Zona Arqueologica Monumental Kuelap,2,Febrero,1,0,0,0,0,0,0,0,0,0,0,0,0,0,36,117,5,12,170,170,Sitio Arqueológico
20240315,2023,1,Amazonas,Zona Arqueologica Monumental Kuelap,2,Febrero,2,0,0,0,0,0,0,0,0,0,0,0,0,0,286,2382,203,501,3372,3372,Sitio Arqueológico
20240315,2023,1,Amazonas,Zona Arqueologica Monumental Kuelap,3,Marzo,0,0,0,0,0,0,0,0,0,0,0,0,0,0,126,1116,58,160,1460,1460,Sitio Arqueológico
20240315,2023,1,Amazonas,Zona Arqueologica Monumental Kuelap,3,Marzo,1,0,0,0,0,0,0,0,0,0,0,0,0,0,24,111,2,12,149,149,Sitio Arqueológico
20240315,2023,1,Amazonas,Zona Arqueologica Monumental Kuelap,3,Marzo,2,0,0,0,0,0,0,0,0,0,0,0,0,0,150,1227,60,172,1609,1609,Sitio Arqueológico
20240315,2023,1,Amazonas,Zona Arqueologica Monumental Kuelap,4,Abril,0,0,0,0,0,0,0,0,0,0,0,0,0,0,135,1492,40,163,1830,1830,Sitio Arqueológico
20240315,2023,1,Amazonas,Zona Arqueologica Monumental Kuelap,4,Abril,1,0,0,0,0,0,0,0,0,0,0,0,0,0,26,161,5,14,206,206,Sitio Arqueológico
20240315,2023,1,Amazonas,Zona Arqueologica Monumental Kuelap,4,Abril,2,0,0,0,0,0,0,0,0,0,0,0,0,0,161,1653,45,177,2036,2036,Sitio Arqueológico
20240315,2023,1,Amazonas,Zona Arqueologica Monumental Kuelap,5,Mayo,0,0,0,0,0,0,0,0,0,0,0,0,0,0,157,1029,45,150,1381,1381,Sitio Arqueológico
20240315,2023,1,Amazonas,Zona Arqueologica Monumental Kuelap,5,Mayo,1,0,0,0,0,0,0,0,0,0,0,0,0,0,35,131,1,1,168,168,Sitio Arqueológico
20240315,2023,1,Amazonas,Zona Arqueologica Monumental Kuelap,5,Mayo,2,0,0,0,0,0,0,0,0,0,0,0,0,0,192,1160,46,151,1549,1549,Sitio Arqueológico
20240315,2023,1,Amazonas,Zona Arqueologica Monumental Kuelap,6,Junio,0,0,0,0,0,0,0,0,0,0,0,0,0,0,292,1757,57,159,2265,2265,Sitio Arqueológico
20240315,2023,1,Amazonas,Zona Arqueologica Monumental Kuelap,6,Junio,1,0,0,0,0,0,0,0,0,0,0,0,0,0,31,112,2,4,149,149,Sitio Arqueológico
20240315,2023,1,Amazonas,Zona Arqueologica Monumental Kuelap,6,Junio,2,0,0,0,0,0,0,0,0,0,0,0,0,0,323,1869,59,163,2414,2414,Sitio Arqueológico
20240315,2023,1,Amazonas,Zona Arqueologica Monumental Kuelap,7,Julio,0,0,0,0,0,0,0,0,0,0,0,0,0,0,679,4497,505,861,6542,6542,Sitio Arqueológico
20240315,2023,1,Amazonas,Zona Arqueologica Monumental Kuelap,7,Julio,1,0,0,0,0,0,0,0,0,0,0,0,0,0,59,203,21,16,299,299,Sitio Arqueológico
20240315,2023,1,Amazonas,Zona Arqueologica Monumental Kuelap,7,Julio,2,0,0,0,0,0,0,0,0,0,0,0,0,0,738,4700,526,877,6841,6841,Sitio Arqueológico
20240315,2023,1,Amazonas,Zona Arqueologica Monumental Kuelap,8,Agosto,0,0,0,0,0,0,0,0,0,0,0,0,0,0,591,4063,341,771,5766,5766,Sitio Arqueológico
20240315,2023,1,Amazonas,Zona Arqueologica Monumental Kuelap,8,Agosto,1,0,0,0,0,0,0,0,0,0,0,0,0,0,32,382,17,24,455,455,Sitio Arqueológico
20240315,2023,1,Amazonas,Zona Arqueologica Monumental Kuelap,8,Agosto,2,0,0,0,0,0,0,0,0,0,0,0,0,0,623,4445,358,795,6221,6221,Sitio Arqueológico
20240315,2023,1,Amazonas,Zona Arqueologica Monumental Kuelap,9,Setiembre,0,0,0,0,0,0,0,0,0,0,0,0,0,0,568,2726,266,365,3925,3925,Sitio Arqueológico
20240315,2023,1,Amazonas,Zona Arqueologica Monumental Kuelap,9,Setiembre,1,0,0,0,0,0,0,0,0,0,0,0,0,0,58,313,3,10,384,384,Sitio Arqueológico
20240315,2023,1,Amazonas,Zona Arqueologica Monumental Kuelap,9,Setiembre,2,0,0,0,0,0,0,0,0,0,0,0,0,0,626,3039,269,375,4309,4309,Sitio Arqueológico
20240315,2023,1,Amazonas,Zona Arqueologica Monumental Kuelap,10,Octubre,0,0,0,0,0,0,0,0,0,0,0,0,0,0,381,2537,727,494,4139,4139,Sitio Arqueológico
20240315,2023,1,Amazonas,Zona Arqueologica Monumental Kuelap,10,Octubre,1,0,0,0,0,0,0,0,0,0,0,0,0,0,74,250,2,6,332,332,Sitio Arqueológico
20240315,2023,1,Amazonas,Zona Arqueologica Monumental Kuelap,10,Octubre,2,0,0,0,0,0,0,0,0,0,0,0,0,0,455,2787,729,500,4471,4471,Sitio Arqueológico
20240315,2023,1,Amazonas,Zona Arqueologica Monumental Kuelap,11,Noviembre,0,0,0,0,0,0,0,0,0,0,0,0,0,0,271,2531,1139,491,4432,4432,Sitio Arqueológico
20240315,2023,1,Amazonas,Zona Arqueologica Monumental Kuelap,11,Noviembre,1,0,0,0,0,0,0,0,0,0,0,0,0,0,64,195,0,5,264,264,Sitio Arqueológico
20240315,2023,1,Amazonas,Zona Arqueologica Monumental Kuelap,11,Noviembre,2,0,0,0,0,0,0,0,0,0,0,0,0,0,335,2726,1139,496,4696,4696,Sitio Arqueológico
20240315,2023,1,Amazonas,Zona Arqueologica Monumental Kuelap,12,Diciembre,0,0,0,0,0,0,0,0,0,0,0,0,0,0,288,2983,582,474,4327,4327,Sitio Arqueológico
20240315,2023,1,Amazonas,Zona Arqueologica Monumental Kuelap,12,Diciembre,1,0,0,0,0,0,0,0,0,0,0,0,0,0,40,256,5,6,307,307,Sitio Arqueológico
20240315,2023,1,Amazonas,Zona Arqueologica Monumental Kuelap,12,Diciembre,2,0,0,0,0,0,0,0,0,0,0,0,0,0,328,3239,587,480,4634,4634,Sitio Arqueológico
20240315,2023,2,Ancash,Zona Arqueologica Monumental Chavin de Huantar,1,Enero,0,0,0,0,0,260,2066,426,624,3376,0,0,0,1,33,587,17,146,784,4160,Sitio Arqueológico
20240315,2023,2,Ancash,Zona Arqueologica Monumental Chavin de Huantar,1,Enero,1,0,0,0,0,11,160,11,6,188,0,0,0,0,0,2,0,0,2,190,Sitio Arqueológico
20240315,2023,2,Ancash,Zona Arqueologica Monumental Chavin de Huantar,1,Enero,2,0,0,0,0,271,2226,437,630,3564,0,0,0,1,33,589,17,146,786,4350,Sitio Arqueológico
20240315,2023,2,Ancash,Zona Arqueologica Monumental Chavin de Huantar,2,Febrero,0,0,0,0,0,423,2478,391,734,4026,0,0,0,3,41,633,9,175,861,4887,Sitio Arqueológico
20240315,2023,2,Ancash,Zona Arqueologica Monumental Chavin de Huantar,2,Febrero,1,0,0,0,0,0,156,15,2,173,0,0,0,0,0,3,0,0,3,176,Sitio Arqueológico
20240315,2023,2,Ancash,Zona Arqueologica Monumental Chavin de Huantar,2,Febrero,2,0,0,0,0,423,2634,406,736,4199,0,0,0,3,41,636,9,175,864,5063,Sitio Arqueológico
20240315,2023,2,Ancash,Zona Arqueologica Monumental Chavin de Huantar,3,Marzo,0,0,0,0,0,129,1194,187,277,1787,0,0,0,1,35,289,49,78,452,2239,Sitio Arqueológico
20240315,2023,2,Ancash,Zona Arqueologica Monumental Chavin de Huantar,3,Marzo,1,0,0,0,0,3,103,17,0,123,0,0,0,0,0,9,0,0,9,132,Sitio Arqueológico
20240315,2023,2,Ancash,Zona Arqueologica Monumental Chavin de Huantar,3,Marzo,2,0,0,0,0,132,1297,204,277,1910,0,0,0,1,35,298,49,78,461,2371,Sitio Arqueológico
20240315,2023,2,Ancash,Zona Arqueologica Monumental Chavin de Huantar,4,Abril,0,0,0,0,0,391,4355,605,643,5994,0,0,0,0,21,509,46,115,691,6685,Sitio Arqueológico
20240315,2023,2,Ancash,Zona Arqueologica Monumental Chavin de Huantar,4,Abril,1,0,0,0,0,1,177,1,0,179,0,0,0,0,0,0,0,0,0,179,Sitio Arqueológico
20240315,2023,2,Ancash,Zona Arqueologica Monumental Chavin de Huantar,4,Abril,2,0,0,0,0,392,4532,606,643,6173,0,0,0,0,21,509,46,115,691,6864,Sitio Arqueológico
20240315,2023,2,Ancash,Zona Arqueologica Monumental Chavin de Huantar,5,Mayo,0,0,0,0,0,1312,1959,541,592,4404,0,0,0,0,70,253,38,76,437,4841,Sitio Arqueológico
20240315,2023,2,Ancash,Zona Arqueologica Monumental Chavin de Huantar,5,Mayo,1,0,0,0,0,112,228,6,0,346,0,0,0,0,0,0,0,0,0,346,Sitio Arqueológico
20240315,2023,2,Ancash,Zona Arqueologica Monumental Chavin de Huantar,5,Mayo,2,0,0,0,0,1424,2187,547,592,4750,0,0,0,0,70,253,38,76,437,5187,Sitio Arqueológico
20240315,2023,2,Ancash,Zona Arqueologica Monumental Chavin de Huantar,6,Junio,0,0,0,0,0,667,2515,429,602,4213,0,0,0,1,60,524,30,514,1129,5342,Sitio Arqueológico
20240315,2023,2,Ancash,Zona Arqueologica Monumental Chavin de Huantar,6,Junio,1,0,0,0,0,12,364,1,0,377,0,0,0,0,0,41,0,0,41,418,Sitio Arqueológico
20240315,2023,2,Ancash,Zona Arqueologica Monumental Chavin de Huantar,6,Junio,2,0,0,0,0,679,2879,430,602,4590,0,0,0,1,60,565,30,514,1170,5760,Sitio Arqueológico
20240315,2023,2,Ancash,Zona Arqueologica Monumental Chavin de Huantar,7,Julio,0,0,0,0,0,980,8423,1849,2622,13874,0,0,0,2,73,808,16,539,1438,15312,Sitio Arqueológico
20240315,2023,2,Ancash,Zona Arqueologica Monumental Chavin de Huantar,7,Julio,1,0,0,0,0,2,277,11,2,292,0,0,0,0,0,2,0,0,2,294,Sitio Arqueológico
20240315,2023,2,Ancash,Zona Arqueologica Monumental Chavin de Huantar,7,Julio,2,0,0,0,0,982,8700,1860,2624,14166,0,0,0,2,73,810,16,539,1440,15606,Sitio Arqueológico
20240315,2023,2,Ancash,Zona Arqueologica Monumental Chavin de Huantar,8,Agosto,0,0,0,0,0,1107,6538,1526,2260,11431,0,0,0,3,87,966,69,589,1714,13145,Sitio Arqueológico
20240315,2023,2,Ancash,Zona Arqueologica Monumental Chavin de Huantar,8,Agosto,1,0,0,0,0,0,486,14,2,502,0,0,0,0,0,0,0,0,0,502,Sitio Arqueológico
20240315,2023,2,Ancash,Zona Arqueologica Monumental Chavin de Huantar,8,Agosto,2,0,0,0,0,1107,7024,1540,2262,11933,0,0,0,3,87,966,69,589,1714,13647,Sitio Arqueológico
20240315,2023,2,Ancash,Zona Arqueologica Monumental Chavin de Huantar,9,Setiembre,0,0,0,0,0,712,3069,956,1687,6424,0,0,0,0,89,741,33,932,1795,8219,Sitio Arqueológico
20240315,2023,2,Ancash,Zona Arqueologica Monumental Chavin de Huantar,9,Setiembre,1,0,0,0,0,7,461,12,0,480,0,0,0,0,0,0,0,0,0,480,Sitio Arqueológico
20240315,2023,2,Ancash,Zona Arqueologica Monumental Chavin de Huantar,9,Setiembre,2,0,0,0,0,719,3530,968,1687,6904,0,0,0,0,89,741,33,932,1795,8699,Sitio Arqueológico
20240315,2023,2,Ancash,Zona Arqueologica Monumental Chavin de Huantar,10,Octubre,0,0,0,0,0,938,3779,536,2665,7918,0,0,0,0,51,570,75,612,1308,9226,Sitio Arqueológico
20240315,2023,2,Ancash,Zona Arqueologica Monumental Chavin de Huantar,10,Octubre,1,0,0,0,0,3,239,9,0,251,0,0,0,0,0,0,0,0,0,251,Sitio Arqueológico
20240315,2023,2,Ancash,Zona Arqueologica Monumental Chavin de Huantar,10,Octubre,2,0,0,0,0,941,4018,545,2665,8169,0,0,0,0,51,570,75,612,1308,9477,Sitio Arqueológico
20240315,2023,2,Ancash,Zona Arqueologica Monumental Chavin de Huantar,11,Noviembre,0,0,0,0,0,775,2434,690,2133,6032,0,0,0,83,34,480,43,304,944,6976,Sitio Arqueológico
20240315,2023,2,Ancash,Zona Arqueologica Monumental Chavin de Huantar,11,Noviembre,1,0,0,0,0,6,154,8,0,168,0,0,0,0,0,0,0,0,0,168,Sitio Arqueológico
20240315,2023,2,Ancash,Zona Arqueologica Monumental Chavin de Huantar,11,Noviembre,2,0,0,0,0,781,2588,698,2133,6200,0,0,0,83,34,480,43,304,944,7144,Sitio Arqueológico
20240315,2023,2,Ancash,Zona Arqueologica Monumental Chavin de Huantar,12,Diciembre,0,0,0,0,0,500,2464,362,766,4092,0,0,0,0,31,491,32,206,760,4852,Sitio Arqueológico
20240315,2023,2,Ancash,Zona Arqueologica Monumental Chavin de Huantar,12,Diciembre,1,0,0,0,0,17,270,8,7,302,0,0,0,0,0,1,0,0,1,303,Sitio Arqueológico
20240315,2023,2,Ancash,Zona Arqueologica Monumental Chavin de Huantar,12,Diciembre,2,0,0,0,0,517,2734,370,773,4394,0,0,0,0,31,492,32,206,761,5155,Sitio Arqueológico
20240315,2023,2,Ancash,Sitio Arqueologico Pañamarca,1,Enero,0,0,0,0,0,0,57,15,9,81,0,0,0,0,0,0,0,0,0,81,Sitio Arqueológico
20240315,2023,2,Ancash,Sitio Arqueologico Pañamarca,1,Enero,1,0,0,0,0,0,0,0,0,0,0,0,0,0,0,0,0,0,0,0,Sitio Arqueológico
20240315,2023,2,Ancash,Sitio Arqueologico Pañamarca,1,Enero,2,0,0,0,0,0,57,15,9,81,0,0,0,0,0,0,0,0,0,81,Sitio Arqueológico
20240315,2023,2,Ancash,Sitio Arqueologico Pañamarca,2,Febrero,0,0,0,0,0,0,29,1,12,42,0,0,0,0,0,20,0,0,20,62,Sitio Arqueológico
20240315,2023,2,Ancash,Sitio Arqueologico Pañamarca,2,Febrero,1,0,0,0,0,0,0,0,0,0,0,0,0,0,0,0,0,0,0,0,Sitio Arqueológico
20240315,2023,2,Ancash,Sitio Arqueologico Pañamarca,2,Febrero,2,0,0,0,0,0,29,1,12,42,0,0,0,0,0,20,0,0,20,62,Sitio Arqueológico
20240315,2023,2,Ancash,Sitio Arqueologico Pañamarca,3,Marzo,0,0,0,0,0,0,0,0,0,0,0,0,0,0,3,17,0,30,50,50,Sitio Arqueológico
20240315,2023,2,Ancash,Sitio Arqueologico Pañamarca,3,Marzo,1,0,0,0,0,0,0,0,0,0,0,0,0,0,0,0,0,0,0,0,Sitio Arqueológico
20240315,2023,2,Ancash,Sitio Arqueologico Pañamarca,3,Marzo,2,0,0,0,0,0,0,0,0,0,0,0,0,0,3,17,0,30,50,50,Sitio Arqueológico
20240315,2023,2,Ancash,Sitio Arqueologico Pañamarca,4,Abril,0,0,0,0,0,0,38,0,10,48,0,0,0,0,0,10,2,3,15,63,Sitio Arqueológico
20240315,2023,2,Ancash,Sitio Arqueologico Pañamarca,4,Abril,1,0,0,0,0,0,0,0,0,0,0,0,0,0,0,0,0,0,0,0,Sitio Arqueológico
20240315,2023,2,Ancash,Sitio Arqueologico Pañamarca,4,Abril,2,0,0,0,0,0,38,0,10,48,0,0,0,0,0,10,2,3,15,63,Sitio Arqueológico
20240315,2023,2,Ancash,Sitio Arqueologico Pañamarca,5,Mayo,0,0,0,0,0,0,33,40,0,73,0,0,0,0,3,45,11,42,101,174,Sitio Arqueológico
20240315,2023,2,Ancash,Sitio Arqueologico Pañamarca,5,Mayo,1,0,0,0,0,0,0,0,0,0,0,0,0,0,0,0,0,0,0,0,Sitio Arqueológico
20240315,2023,2,Ancash,Sitio Arqueologico Pañamarca,5,Mayo,2,0,0,0,0,0,33,40,0,73,0,0,0,0,3,45,11,42,101,174,Sitio Arqueológico
20240315,2023,2,Ancash,Sitio Arqueologico Pañamarca,6,Junio,0,0,0,0,0,0,31,2,139,172,0,0,0,0,22,37,12,50,121,293,Sitio Arqueológico
20240315,2023,2,Ancash,Sitio Arqueologico Pañamarca,6,Junio,1,0,0,0,0,0,0,0,0,0,0,0,0,0,0,0,0,0,0,0,Sitio Arqueológico
20240315,2023,2,Ancash,Sitio Arqueologico Pañamarca,6,Junio,2,0,0,0,0,0,31,2,139,172,0,0,0,0,22,37,12,50,121,293,Sitio Arqueológico
20240315,2023,2,Ancash,Sitio Arqueologico Pañamarca,7,Julio,0,0,0,0,0,0,42,0,507,549,0,0,0,0,20,61,49,69,199,748,Sitio Arqueológico
20240315,2023,2,Ancash,Sitio Arqueologico Pañamarca,7,Julio,1,0,0,0,0,0,0,0,0,0,0,0,0,0,0,0,0,0,0,0,Sitio Arqueológico
20240315,2023,2,Ancash,Sitio Arqueologico Pañamarca,7,Julio,2,0,0,0,0,0,42,0,507,549,0,0,0,0,20,61,49,69,199,748,Sitio Arqueológico
20240315,2023,2,Ancash,Sitio Arqueologico Pañamarca,8,Agosto,0,0,0,0,0,0,69,7,293,369,0,0,0,0,23,72,59,91,245,614,Sitio Arqueológico
20240315,2023,2,Ancash,Sitio Arqueologico Pañamarca,8,Agosto,1,0,0,0,0,0,0,0,0,0,0,0,0,0,0,0,0,0,0,0,Sitio Arqueológico
20240315,2023,2,Ancash,Sitio Arqueologico Pañamarca,8,Agosto,2,0,0,0,0,0,69,7,293,369,0,0,0,0,23,72,59,91,245,614,Sitio Arqueológico
20240315,2023,2,Ancash,Sitio Arqueologico Pañamarca,9,Setiembre,0,0,0,0,0,0,445,10,1183,1638,0,0,0,0,0,40,10,29,79,1717,Sitio Arqueológico
20240315,2023,2,Ancash,Sitio Arqueologico Pañamarca,9,Setiembre,1,0,0,0,0,0,0,0,0,0,0,0,0,0,0,0,0,0,0,0,Sitio Arqueológico
20240315,2023,2,Ancash,Sitio Arqueologico Pañamarca,9,Setiembre,2,0,0,0,0,0,445,10,1183,1638,0,0,0,0,0,40,10,29,79,1717,Sitio Arqueológico
20240315,2023,2,Ancash,Sitio Arqueologico Pañamarca,10,Octubre,0,0,0,0,0,0,83,4,256,343,0,0,0,0,24,25,36,95,180,523,Sitio Arqueológico
20240315,2023,2,Ancash,Sitio Arqueologico Pañamarca,10,Octubre,1,0,0,0,0,0,0,0,0,0,0,0,0,0,0,0,0,0,0,0,Sitio Arqueológico
20240315,2023,2,Ancash,Sitio Arqueologico Pañamarca,10,Octubre,2,0,0,0,0,0,83,4,256,343,0,0,0,0,24,25,36,95,180,523,Sitio Arqueológico
20240315,2023,2,Ancash,Sitio Arqueologico Pañamarca,11,Noviembre,0,0,0,0,0,0,51,3,246,300,0,0,0,0,0,0,0,0,0,300,Sitio Arqueológico
20240315,2023,2,Ancash,Sitio Arqueologico Pañamarca,11,Noviembre,1,0,0,0,0,0,0,0,0,0,0,0,0,0,0,0,0,0,0,0,Sitio Arqueológico
20240315,2023,2,Ancash,Sitio Arqueologico Pañamarca,11,Noviembre,2,0,0,0,0,0,51,3,246,300,0,0,0,0,0,0,0,0,0,300,Sitio Arqueológico
20240315,2023,2,Ancash,Sitio Arqueologico Pañamarca,12,Diciembre,0,0,0,0,0,0,30,7,16,53,0,0,0,0,0,7,0,8,15,68,Sitio Arqueológico
20240315,2023,2,Ancash,Sitio Arqueologico Pañamarca,12,Diciembre,1,0,0,0,0,0,3,0,0,3,0,0,0,0,0,0,0,0,0,3,Sitio Arqueológico
20240315,2023,2,Ancash,Sitio Arqueologico Pañamarca,12,Diciembre,2,0,0,0,0,0,33,7,16,56,0,0,0,0,0,7,0,8,15,71,Sitio Arqueológico
20240315,2023,3,Apurimac,Sitio Arqueologico Saihuite,1,Enero,0,0,0,0,0,2,32,23,1,58,0,0,0,0,11,59,18,6,94,152,Sitio Arqueológico
20240315,2023,3,Apurimac,Sitio Arqueologico Saihuite,1,Enero,1,0,0,0,0,0,0,0,0,0,0,0,0,0,0,0,0,0,0,0,Sitio Arqueológico
20240315,2023,3,Apurimac,Sitio Arqueologico Saihuite,1,Enero,2,0,0,0,0,2,32,23,1,58,0,0,0,0,11,59,18,6,94,152,Sitio Arqueológico
20240315,2023,3,Apurimac,Sitio Arqueologico Saihuite,2,Febrero,0,0,0,0,0,0,0,0,0,0,0,0,0,0,0,0,0,0,0,0,Sitio Arqueológico
20240315,2023,3,Apurimac,Sitio Arqueologico Saihuite,2,Febrero,1,0,0,0,0,0,0,0,0,0,0,0,0,0,0,0,0,0,0,0,Sitio Arqueológico
20240315,2023,3,Apurimac,Sitio Arqueologico Saihuite,2,Febrero,2,0,0,0,0,0,0,0,0,0,0,0,0,0,0,0,0,0,0,0,Sitio Arqueológico
20240315,2023,3,Apurimac,Sitio Arqueologico Saihuite,3,Marzo,0,0,0,0,0,8,33,87,4,132,0,0,0,0,0,0,0,0,0,132,Sitio Arqueológico
20240315,2023,3,Apurimac,Sitio Arqueologico Saihuite,3,Marzo,1,0,0,0,0,0,0,0,0,0,0,0,0,0,0,0,0,0,0,0,Sitio Arqueológico
20240315,2023,3,Apurimac,Sitio Arqueologico Saihuite,3,Marzo,2,0,0,0,0,8,33,87,4,132,0,0,0,0,0,0,0,0,0,132,Sitio Arqueológico
20240315,2023,3,Apurimac,Sitio Arqueologico Saihuite,4,Abril,0,2,0,0,0,0,280,4,49,335,0,0,0,0,11,52,12,21,96,431,Sitio Arqueológico
20240315,2023,3,Apurimac,Sitio Arqueologico Saihuite,4,Abril,1,0,0,0,0,11,0,0,0,11,0,0,0,0,0,0,0,0,0,11,Sitio Arqueológico
20240315,2023,3,Apurimac,Sitio Arqueologico Saihuite,4,Abril,2,2,0,0,0,11,280,4,49,346,0,0,0,0,11,52,12,21,96,442,Sitio Arqueológico
20240315,2023,3,Apurimac,Sitio Arqueologico Saihuite,5,Mayo,0,0,0,0,0,57,220,96,22,395,0,0,0,0,0,1,11,3,15,410,Sitio Arqueológico
20240315,2023,3,Apurimac,Sitio Arqueologico Saihuite,5,Mayo,1,0,0,0,0,0,0,0,0,0,0,0,0,0,0,0,0,0,0,0,Sitio Arqueológico
20240315,2023,3,Apurimac,Sitio Arqueologico Saihuite,5,Mayo,2,0,0,0,0,57,220,96,22,395,0,0,0,0,0,1,11,3,15,410,Sitio Arqueológico
20240315,2023,3,Apurimac,Sitio Arqueologico Saihuite,6,Junio,0,0,0,0,0,33,292,78,29,432,0,0,0,0,3,3,41,27,74,506,Sitio Arqueológico
20240315,2023,3,Apurimac,Sitio Arqueologico Saihuite,6,Junio,1,0,0,0,0,0,0,0,0,0,0,0,0,0,0,0,0,0,0,0,Sitio Arqueológico
20240315,2023,3,Apurimac,Sitio Arqueologico Saihuite,6,Junio,2,0,0,0,0,33,292,78,29,432,0,0,0,0,3,3,41,27,74,506,Sitio Arqueológico
20240315,2023,3,Apurimac,Sitio Arqueologico Saihuite,7,Julio,0,0,0,0,0,30,357,111,31,529,0,0,0,0,2,42,42,5,91,620,Sitio Arqueológico
20240315,2023,3,Apurimac,Sitio Arqueologico Saihuite,7,Julio,1,0,0,0,0,0,0,0,0,0,0,0,0,0,0,0,0,0,0,0,Sitio Arqueológico
20240315,2023,3,Apurimac,Sitio Arqueologico Saihuite,7,Julio,2,0,0,0,0,30,357,111,31,529,0,0,0,0,2,42,42,5,91,620,Sitio Arqueológico
20240315,2023,3,Apurimac,Sitio Arqueologico Saihuite,8,Agosto,0,0,0,0,0,39,393,95,21,548,0,0,0,0,6,51,18,13,88,636,Sitio Arqueológico
20240315,2023,3,Apurimac,Sitio Arqueologico Saihuite,8,Agosto,1,0,0,0,0,0,0,0,0,0,0,0,0,0,0,0,0,0,0,0,Sitio Arqueológico
20240315,2023,3,Apurimac,Sitio Arqueologico Saihuite,8,Agosto,2,0,0,0,0,39,393,95,21,548,0,0,0,0,6,51,18,13,88,636,Sitio Arqueológico
20240315,2023,3,Apurimac,Sitio Arqueologico Saihuite,9,Setiembre,0,0,0,0,0,47,230,81,58,416,0,0,0,0,1,30,15,8,54,470,Sitio Arqueológico
20240315,2023,3,Apurimac,Sitio Arqueologico Saihuite,9,Setiembre,1,0,0,0,0,0,0,0,0,0,0,0,0,0,0,0,0,0,0,0,Sitio Arqueológico
20240315,2023,3,Apurimac,Sitio Arqueologico Saihuite,9,Setiembre,2,0,0,0,0,47,230,81,58,416,0,0,0,0,1,30,15,8,54,470,Sitio Arqueológico
20240315,2023,3,Apurimac,Sitio Arqueologico Saihuite,10,Octubre,0,0,0,0,0,58,280,98,52,488,0,0,0,0,1,24,8,3,36,524,Sitio Arqueológico
20240315,2023,3,Apurimac,Sitio Arqueologico Saihuite,10,Octubre,1,0,0,0,0,0,0,0,0,0,0,0,0,0,0,0,0,0,0,0,Sitio Arqueológico
20240315,2023,3,Apurimac,Sitio Arqueologico Saihuite,10,Octubre,2,0,0,0,0,58,280,98,52,488,0,0,0,0,1,24,8,3,36,524,Sitio Arqueológico
20240315,2023,3,Apurimac,Sitio Arqueologico Saihuite,11,Noviembre,0,0,0,0,0,56,263,126,131,576,0,0,0,0,1,24,8,3,36,612,Sitio Arqueológico
20240315,2023,3,Apurimac,Sitio Arqueologico Saihuite,11,Noviembre,1,0,0,0,0,0,0,0,0,0,0,0,0,0,0,0,0,0,0,0,Sitio Arqueológico
20240315,2023,3,Apurimac,Sitio Arqueologico Saihuite,11,Noviembre,2,0,0,0,0,56,263,126,131,576,0,0,0,0,1,24,8,3,36,612,Sitio Arqueológico
20240315,2023,3,Apurimac,Sitio Arqueologico Saihuite,12,Diciembre,0,0,0,0,0,64,302,124,129,619,0,0,0,0,4,42,21,6,73,692,Sitio Arqueológico
20240315,2023,3,Apurimac,Sitio Arqueologico Saihuite,12,Diciembre,1,0,0,0,0,0,0,0,0,0,0,0,0,0,0,0,0,0,0,0,Sitio Arqueológico
20240315,2023,3,Apurimac,Sitio Arqueologico Saihuite,12,Diciembre,2,0,0,0,0,64,302,124,129,619,0,0,0,0,4,42,21,6,73,692,Sitio Arqueológico
20240315,2023,4,Arequipa,Complejo Arqueologico Toro Muerto,1,Enero,0,0,0,0,0,0,40,1,1,42,0,0,0,0,0,0,0,0,0,42,Sitio Arqueológico
20240315,2023,4,Arequipa,Complejo Arqueologico Toro Muerto,1,Enero,1,0,0,0,0,0,0,0,0,0,0,0,0,0,0,0,0,0,0,0,Sitio Arqueológico
20240315,2023,4,Arequipa,Complejo Arqueologico Toro Muerto,1,Enero,2,0,0,0,0,0,40,1,1,42,0,0,0,0,0,0,0,0,0,42,Sitio Arqueológico
20240315,2023,4,Arequipa,Complejo Arqueologico Toro Muerto,2,Febrero,0,0,0,0,0,0,0,0,0,0,0,0,0,0,0,0,0,0,0,0,Sitio Arqueológico
20240315,2023,4,Arequipa,Complejo Arqueologico Toro Muerto,2,Febrero,1,0,0,0,0,0,0,0,0,0,0,0,0,0,0,0,0,0,0,0,Sitio Arqueológico
20240315,2023,4,Arequipa,Complejo Arqueologico Toro Muerto,2,Febrero,2,0,0,0,0,0,0,0,0,0,0,0,0,0,0,0,0,0,0,0,Sitio Arqueológico
20240315,2023,4,Arequipa,Complejo Arqueologico Toro Muerto,3,Marzo,0,0,0,0,0,0,0,0,0,0,0,0,0,0,0,7,0,10,17,17,Sitio Arqueológico
20240315,2023,4,Arequipa,Complejo Arqueologico Toro Muerto,3,Marzo,1,0,0,0,0,0,0,0,0,0,0,0,0,0,0,0,0,0,0,0,Sitio Arqueológico
20240315,2023,4,Arequipa,Complejo Arqueologico Toro Muerto,3,Marzo,2,0,0,0,0,0,0,0,0,0,0,0,0,0,0,7,0,10,17,17,Sitio Arqueológico
20240315,2023,4,Arequipa,Complejo Arqueologico Toro Muerto,4,Abril,0,0,0,0,0,0,202,5,4,211,0,0,0,0,0,0,0,0,0,211,Sitio Arqueológico
20240315,2023,4,Arequipa,Complejo Arqueologico Toro Muerto,4,Abril,1,0,0,0,0,0,0,0,0,0,0,0,0,0,0,0,0,0,0,0,Sitio Arqueológico
20240315,2023,4,Arequipa,Complejo Arqueologico Toro Muerto,4,Abril,2,0,0,0,0,0,202,5,4,211,0,0,0,0,0,0,0,0,0,211,Sitio Arqueológico
20240315,2023,4,Arequipa,Complejo Arqueologico Toro Muerto,5,Mayo,0,0,0,0,0,0,96,6,6,108,0,0,0,0,0,15,0,3,18,126,Sitio Arqueológico
20240315,2023,4,Arequipa,Complejo Arqueologico Toro Muerto,5,Mayo,1,0,0,0,0,0,0,0,0,0,0,0,0,0,0,0,0,0,0,0,Sitio Arqueológico
20240315,2023,4,Arequipa,Complejo Arqueologico Toro Muerto,5,Mayo,2,0,0,0,0,0,96,6,6,108,0,0,0,0,0,15,0,3,18,126,Sitio Arqueológico
20240315,2023,4,Arequipa,Complejo Arqueologico Toro Muerto,6,Junio,0,0,0,0,0,0,36,28,136,200,0,0,0,0,0,14,0,3,17,217,Sitio Arqueológico
20240315,2023,4,Arequipa,Complejo Arqueologico Toro Muerto,6,Junio,1,0,0,0,0,0,0,0,0,0,0,0,0,0,0,0,0,0,0,0,Sitio Arqueológico
20240315,2023,4,Arequipa,Complejo Arqueologico Toro Muerto,6,Junio,2,0,0,0,0,0,36,28,136,200,0,0,0,0,0,14,0,3,17,217,Sitio Arqueológico
20240315,2023,4,Arequipa,Complejo Arqueologico Toro Muerto,7,Julio,0,0,0,0,0,0,557,34,312,903,0,0,0,0,0,7,4,2,13,916,Sitio Arqueológico
20240315,2023,4,Arequipa,Complejo Arqueologico Toro Muerto,7,Julio,1,0,0,0,0,0,0,0,0,0,0,0,0,0,0,0,0,0,0,0,Sitio Arqueológico
20240315,2023,4,Arequipa,Complejo Arqueologico Toro Muerto,7,Julio,2,0,0,0,0,0,557,34,312,903,0,0,0,0,0,7,4,2,13,916,Sitio Arqueológico
20240315,2023,4,Arequipa,Complejo Arqueologico Toro Muerto,8,Agosto,0,0,0,0,0,0,191,16,43,250,0,0,0,0,0,25,12,12,49,299,Sitio Arqueológico
20240315,2023,4,Arequipa,Complejo Arqueologico Toro Muerto,8,Agosto,1,0,0,0,0,0,0,0,0,0,0,0,0,0,0,0,0,0,0,0,Sitio Arqueológico
20240315,2023,4,Arequipa,Complejo Arqueologico Toro Muerto,8,Agosto,2,0,0,0,0,0,191,16,43,250,0,0,0,0,0,25,12,12,49,299,Sitio Arqueológico
20240315,2023,4,Arequipa,Complejo Arqueologico Toro Muerto,9,Setiembre,0,0,0,0,0,0,60,13,20,93,0,0,0,0,0,22,5,3,30,123,Sitio Arqueológico
20240315,2023,4,Arequipa,Complejo Arqueologico Toro Muerto,9,Setiembre,1,0,0,0,0,0,0,0,0,0,0,0,0,0,0,0,0,0,0,0,Sitio Arqueológico
20240315,2023,4,Arequipa,Complejo Arqueologico Toro Muerto,9,Setiembre,2,0,0,0,0,0,60,13,20,93,0,0,0,0,0,22,5,3,30,123,Sitio Arqueológico
20240315,2023,4,Arequipa,Complejo Arqueologico Toro Muerto,10,Octubre,0,0,0,0,0,0,79,3,71,153,0,0,0,0,0,20,0,5,25,178,Sitio Arqueológico
20240315,2023,4,Arequipa,Complejo Arqueologico Toro Muerto,10,Octubre,1,0,0,0,0,0,0,0,0,0,0,0,0,0,0,0,0,0,0,0,Sitio Arqueológico
20240315,2023,4,Arequipa,Complejo Arqueologico Toro Muerto,10,Octubre,2,0,0,0,0,0,79,3,71,153,0,0,0,0,0,20,0,5,25,178,Sitio Arqueológico
20240315,2023,4,Arequipa,Complejo Arqueologico Toro Muerto,11,Noviembre,0,0,0,0,0,0,60,5,120,185,0,0,0,0,0,25,2,4,31,216,Sitio Arqueológico
20240315,2023,4,Arequipa,Complejo Arqueologico Toro Muerto,11,Noviembre,1,0,0,0,0,0,0,0,0,0,0,0,0,0,0,0,0,0,0,0,Sitio Arqueológico
20240315,2023,4,Arequipa,Complejo Arqueologico Toro Muerto,11,Noviembre,2,0,0,0,0,0,60,5,120,185,0,0,0,0,0,25,2,4,31,216,Sitio Arqueológico
20240315,2023,4,Arequipa,Complejo Arqueologico Toro Muerto,12,Diciembre,0,0,0,0,0,0,32,1,73,106,0,0,0,0,0,15,0,0,15,121,Sitio Arqueológico
20240315,2023,4,Arequipa,Complejo Arqueologico Toro Muerto,12,Diciembre,1,0,0,0,0,0,0,0,0,0,0,0,0,0,0,0,0,0,0,0,Sitio Arqueológico
20240315,2023,4,Arequipa,Complejo Arqueologico Toro Muerto,12,Diciembre,2,0,0,0,0,0,32,1,73,106,0,0,0,0,0,15,0,0,15,121,Sitio Arqueológico
20240315,2023,4,Arequipa,Complejo Arqueologico de Uyo Uyo,1,Enero,0,0,0,0,0,0,0,0,0,0,0,0,0,0,0,0,0,0,0,0,Sitio Arqueológico
20240315,2023,4,Arequipa,Complejo Arqueologico de Uyo Uyo,1,Enero,1,0,0,0,0,0,0,0,0,0,0,0,0,0,0,0,0,0,0,0,Sitio Arqueológico
20240315,2023,4,Arequipa,Complejo Arqueologico de Uyo Uyo,1,Enero,2,0,0,0,0,0,0,0,0,0,0,0,0,0,0,0,0,0,0,0,Sitio Arqueológico
20240315,2023,4,Arequipa,Complejo Arqueologico de Uyo Uyo,2,Febrero,0,0,0,0,0,0,165,0,0,165,0,0,0,0,0,0,0,0,0,165,Sitio Arqueológico
20240315,2023,4,Arequipa,Complejo Arqueologico de Uyo Uyo,2,Febrero,1,0,0,0,0,0,0,0,0,0,0,0,0,0,0,0,0,0,0,0,Sitio Arqueológico
20240315,2023,4,Arequipa,Complejo Arqueologico de Uyo Uyo,2,Febrero,2,0,0,0,0,0,165,0,0,165,0,0,0,0,0,0,0,0,0,165,Sitio Arqueológico
20240315,2023,4,Arequipa,Complejo Arqueologico de Uyo Uyo,3,Marzo,0,0,0,0,0,0,31,0,0,31,0,0,0,0,0,3,0,0,3,34,Sitio Arqueológico
20240315,2023,4,Arequipa,Complejo Arqueologico de Uyo Uyo,3,Marzo,1,0,0,0,0,0,0,0,0,0,0,0,0,0,0,0,0,0,0,0,Sitio Arqueológico
20240315,2023,4,Arequipa,Complejo Arqueologico de Uyo Uyo,3,Marzo,2,0,0,0,0,0,31,0,0,31,0,0,0,0,0,3,0,0,3,34,Sitio Arqueológico
20240315,2023,4,Arequipa,Complejo Arqueologico de Uyo Uyo,4,Abril,0,0,0,0,0,0,36,0,0,36,0,0,0,0,0,0,0,0,0,36,Sitio Arqueológico
20240315,2023,4,Arequipa,Complejo Arqueologico de Uyo Uyo,4,Abril,1,0,0,0,0,0,0,0,0,0,0,0,0,0,0,0,0,0,0,0,Sitio Arqueológico
20240315,2023,4,Arequipa,Complejo Arqueologico de Uyo Uyo,4,Abril,2,0,0,0,0,0,36,0,0,36,0,0,0,0,0,0,0,0,0,36,Sitio Arqueológico
20240315,2023,4,Arequipa,Complejo Arqueologico de Uyo Uyo,5,Mayo,0,0,0,0,0,0,42,0,0,42,0,0,0,0,0,3,0,0,3,45,Sitio Arqueológico
20240315,2023,4,Arequipa,Complejo Arqueologico de Uyo Uyo,5,Mayo,1,0,0,0,0,0,0,0,0,0,0,0,0,0,0,0,0,0,0,0,Sitio Arqueológico
20240315,2023,4,Arequipa,Complejo Arqueologico de Uyo Uyo,5,Mayo,2,0,0,0,0,0,42,0,0,42,0,0,0,0,0,3,0,0,3,45,Sitio Arqueológico
20240315,2023,4,Arequipa,Complejo Arqueologico de Uyo Uyo,6,Junio,0,0,0,0,0,0,30,0,0,30,0,0,0,0,0,2,0,2,4,34,Sitio Arqueológico
20240315,2023,4,Arequipa,Complejo Arqueologico de Uyo Uyo,6,Junio,1,0,0,0,0,0,0,0,0,0,0,0,0,0,0,0,0,0,0,0,Sitio Arqueológico
20240315,2023,4,Arequipa,Complejo Arqueologico de Uyo Uyo,6,Junio,2,0,0,0,0,0,30,0,0,30,0,0,0,0,0,2,0,2,4,34,Sitio Arqueológico
20240315,2023,4,Arequipa,Complejo Arqueologico de Uyo Uyo,7,Julio,0,0,0,0,0,0,46,0,0,46,0,0,0,0,0,0,0,0,0,46,Sitio Arqueológico
20240315,2023,4,Arequipa,Complejo Arqueologico de Uyo Uyo,7,Julio,1,0,0,0,0,0,0,0,0,0,0,0,0,0,0,0,0,0,0,0,Sitio Arqueológico
20240315,2023,4,Arequipa,Complejo Arqueologico de Uyo Uyo,7,Julio,2,0,0,0,0,0,46,0,0,46,0,0,0,0,0,0,0,0,0,46,Sitio Arqueológico
20240315,2023,4,Arequipa,Complejo Arqueologico de Uyo Uyo,8,Agosto,0,0,0,0,0,0,42,0,0,42,0,0,0,0,0,3,0,0,3,45,Sitio Arqueológico
20240315,2023,4,Arequipa,Complejo Arqueologico de Uyo Uyo,8,Agosto,1,0,0,0,0,0,0,0,0,0,0,0,0,0,0,0,0,0,0,0,Sitio Arqueológico
20240315,2023,4,Arequipa,Complejo Arqueologico de Uyo Uyo,8,Agosto,2,0,0,0,0,0,42,0,0,42,0,0,0,0,0,3,0,0,3,45,Sitio Arqueológico
20240315,2023,4,Arequipa,Complejo Arqueologico de Uyo Uyo,9,Setiembre,0,0,0,0,0,0,26,0,0,26,0,0,0,0,0,0,0,0,0,26,Sitio Arqueológico
20240315,2023,4,Arequipa,Complejo Arqueologico de Uyo Uyo,9,Setiembre,1,0,0,0,0,0,0,0,0,0,0,0,0,0,0,0,0,0,0,0,Sitio Arqueológico
20240315,2023,4,Arequipa,Complejo Arqueologico de Uyo Uyo,9,Setiembre,2,0,0,0,0,0,26,0,0,26,0,0,0,0,0,0,0,0,0,26,Sitio Arqueológico
20240315,2023,4,Arequipa,Complejo Arqueologico de Uyo Uyo,10,Octubre,0,0,0,0,0,0,60,0,0,60,0,0,0,0,0,0,0,0,0,60,Sitio Arqueológico
20240315,2023,4,Arequipa,Complejo Arqueologico de Uyo Uyo,10,Octubre,1,0,0,0,0,0,0,0,0,0,0,0,0,0,0,0,0,0,0,0,Sitio Arqueológico
20240315,2023,4,Arequipa,Complejo Arqueologico de Uyo Uyo,10,Octubre,2,0,0,0,0,0,60,0,0,60,0,0,0,0,0,0,0,0,0,60,Sitio Arqueológico
20240315,2023,4,Arequipa,Complejo Arqueologico de Uyo Uyo,11,Noviembre,0,0,0,0,0,0,43,0,0,43,0,0,0,0,0,0,0,13,13,56,Sitio Arqueológico
20240315,2023,4,Arequipa,Complejo Arqueologico de Uyo Uyo,11,Noviembre,1,0,0,0,0,0,0,0,0,0,0,0,0,0,0,0,0,0,0,0,Sitio Arqueológico
20240315,2023,4,Arequipa,Complejo Arqueologico de Uyo Uyo,11,Noviembre,2,0,0,0,0,0,43,0,0,43,0,0,0,0,0,0,0,13,13,56,Sitio Arqueológico
20240315,2023,4,Arequipa,Complejo Arqueologico de Uyo Uyo,12,Diciembre,0,0,0,0,0,0,103,0,0,103,0,0,0,0,0,5,0,0,5,108,Sitio Arqueológico
20240315,2023,4,Arequipa,Complejo Arqueologico de Uyo Uyo,12,Diciembre,1,0,0,0,0,0,0,0,0,0,0,0,0,0,0,0,0,0,0,0,Sitio Arqueológico
20240315,2023,4,Arequipa,Complejo Arqueologico de Uyo Uyo,12,Diciembre,2,0,0,0,0,0,103,0,0,103,0,0,0,0,0,5,0,0,5,108,Sitio Arqueológico
20240315,2023,5,Ayacucho,Sitio Arqueologico Intihuatana,1,Enero,0,0,0,0,0,0,830,376,116,1322,0,0,0,0,0,185,64,61,310,1632,Sitio Arqueológico
20240315,2023,5,Ayacucho,Sitio Arqueologico Intihuatana,1,Enero,1,0,0,0,0,0,0,0,0,0,0,0,0,0,0,0,0,0,0,0,Sitio Arqueológico
20240315,2023,5,Ayacucho,Sitio Arqueologico Intihuatana,1,Enero,2,0,0,0,0,0,830,376,116,1322,0,0,0,0,0,185,64,61,310,1632,Sitio Arqueológico
20240315,2023,5,Ayacucho,Sitio Arqueologico Intihuatana,2,Febrero,0,0,0,0,0,0,1197,409,140,1746,0,0,0,0,0,44,11,9,64,1810,Sitio Arqueológico
20240315,2023,5,Ayacucho,Sitio Arqueologico Intihuatana,2,Febrero,1,0,0,0,0,0,0,0,0,0,0,0,0,0,0,0,0,0,0,0,Sitio Arqueológico
20240315,2023,5,Ayacucho,Sitio Arqueologico Intihuatana,2,Febrero,2,0,0,0,0,0,1197,409,140,1746,0,0,0,0,0,44,11,9,64,1810,Sitio Arqueológico
20240315,2023,5,Ayacucho,Sitio Arqueologico Intihuatana,3,Marzo,0,0,0,0,0,0,927,439,88,1454,0,0,0,0,0,141,32,28,201,1655,Sitio Arqueológico
20240315,2023,5,Ayacucho,Sitio Arqueologico Intihuatana,3,Marzo,1,0,0,0,0,0,0,0,0,0,0,0,0,0,0,0,0,0,0,0,Sitio Arqueológico
20240315,2023,5,Ayacucho,Sitio Arqueologico Intihuatana,3,Marzo,2,0,0,0,0,0,927,439,88,1454,0,0,0,0,0,141,32,28,201,1655,Sitio Arqueológico
20240315,2023,5,Ayacucho,Sitio Arqueologico Intihuatana,4,Abril,0,0,0,0,0,0,2344,711,0,3055,0,0,0,0,0,42,16,8,66,3121,Sitio Arqueológico
20240315,2023,5,Ayacucho,Sitio Arqueologico Intihuatana,4,Abril,1,0,0,0,0,0,4,2,0,6,0,0,0,0,0,0,0,0,0,6,Sitio Arqueológico
20240315,2023,5,Ayacucho,Sitio Arqueologico Intihuatana,4,Abril,2,0,0,0,0,0,2348,713,0,3061,0,0,0,0,0,42,16,8,66,3127,Sitio Arqueológico
20240315,2023,5,Ayacucho,Sitio Arqueologico Intihuatana,5,Mayo,0,0,0,0,0,0,1269,638,0,1907,0,0,0,0,0,153,35,28,216,2123,Sitio Arqueológico
20240315,2023,5,Ayacucho,Sitio Arqueologico Intihuatana,5,Mayo,1,0,0,0,0,0,0,0,0,0,0,0,0,0,0,0,0,0,0,0,Sitio Arqueológico
20240315,2023,5,Ayacucho,Sitio Arqueologico Intihuatana,5,Mayo,2,0,0,0,0,0,1269,638,0,1907,0,0,0,0,0,153,35,28,216,2123,Sitio Arqueológico
20240315,2023,5,Ayacucho,Sitio Arqueologico Intihuatana,6,Junio,0,0,0,0,0,0,1271,540,0,1811,0,0,0,0,0,88,43,16,147,1958,Sitio Arqueológico
20240315,2023,5,Ayacucho,Sitio Arqueologico Intihuatana,6,Junio,1,0,0,0,0,0,0,0,0,0,0,0,0,0,0,0,0,0,0,0,Sitio Arqueológico
20240315,2023,5,Ayacucho,Sitio Arqueologico Intihuatana,6,Junio,2,0,0,0,0,0,1271,540,0,1811,0,0,0,0,0,88,43,16,147,1958,Sitio Arqueológico
20240315,2023,5,Ayacucho,Sitio Arqueologico Intihuatana,7,Julio,0,0,0,0,0,0,2357,1003,601,3961,0,0,0,0,0,109,33,5,147,4108,Sitio Arqueológico
20240315,2023,5,Ayacucho,Sitio Arqueologico Intihuatana,7,Julio,1,0,0,0,0,0,0,0,0,0,0,0,0,0,0,0,0,0,0,0,Sitio Arqueológico
20240315,2023,5,Ayacucho,Sitio Arqueologico Intihuatana,7,Julio,2,0,0,0,0,0,2357,1003,601,3961,0,0,0,0,0,109,33,5,147,4108,Sitio Arqueológico
20240315,2023,5,Ayacucho,Sitio Arqueologico Intihuatana,8,Agosto,0,0,0,0,0,0,1964,1107,372,3443,0,0,0,0,0,132,29,49,210,3653,Sitio Arqueológico
20240315,2023,5,Ayacucho,Sitio Arqueologico Intihuatana,8,Agosto,1,0,0,0,0,0,0,0,0,0,0,0,0,0,0,0,0,0,0,0,Sitio Arqueológico
20240315,2023,5,Ayacucho,Sitio Arqueologico Intihuatana,8,Agosto,2,0,0,0,0,0,1964,1107,372,3443,0,0,0,0,0,132,29,49,210,3653,Sitio Arqueológico
20240315,2023,5,Ayacucho,Sitio Arqueologico Intihuatana,9,Setiembre,0,0,0,0,0,0,1304,783,638,2725,0,0,0,0,0,84,61,7,152,2877,Sitio Arqueológico
20240315,2023,5,Ayacucho,Sitio Arqueologico Intihuatana,9,Setiembre,1,0,0,0,0,0,0,0,0,0,0,0,0,0,0,0,0,0,0,0,Sitio Arqueológico
20240315,2023,5,Ayacucho,Sitio Arqueologico Intihuatana,9,Setiembre,2,0,0,0,0,0,1304,783,638,2725,0,0,0,0,0,84,61,7,152,2877,Sitio Arqueológico
20240315,2023,5,Ayacucho,Sitio Arqueologico Intihuatana,10,Octubre,0,0,0,0,0,0,1577,844,769,3190,0,0,0,0,0,23,105,12,140,3330,Sitio Arqueológico
20240315,2023,5,Ayacucho,Sitio Arqueologico Intihuatana,10,Octubre,1,0,0,0,0,0,0,0,0,0,0,0,0,0,0,0,0,0,0,0,Sitio Arqueológico
20240315,2023,5,Ayacucho,Sitio Arqueologico Intihuatana,10,Octubre,2,0,0,0,0,0,1577,844,769,3190,0,0,0,0,0,23,105,12,140,3330,Sitio Arqueológico
20240315,2023,5,Ayacucho,Sitio Arqueologico Intihuatana,11,Noviembre,0,0,0,0,0,0,1302,1208,1119,3629,0,0,0,0,0,72,36,22,130,3759,Sitio Arqueológico
20240315,2023,5,Ayacucho,Sitio Arqueologico Intihuatana,11,Noviembre,1,0,0,0,0,0,0,0,0,0,0,0,0,0,0,0,0,0,0,0,Sitio Arqueológico
20240315,2023,5,Ayacucho,Sitio Arqueologico Intihuatana,11,Noviembre,2,0,0,0,0,0,1302,1208,1119,3629,0,0,0,0,0,72,36,22,130,3759,Sitio Arqueológico
20240315,2023,5,Ayacucho,Sitio Arqueologico Intihuatana,12,Diciembre,0,0,0,0,0,0,1203,635,312,2150,0,0,0,0,0,95,55,20,170,2320,Sitio Arqueológico
20240315,2023,5,Ayacucho,Sitio Arqueologico Intihuatana,12,Diciembre,1,0,0,0,0,0,0,0,0,0,0,0,0,0,0,0,0,0,0,0,Sitio Arqueológico
20240315,2023,5,Ayacucho,Sitio Arqueologico Intihuatana,12,Diciembre,2,0,0,0,0,0,1203,635,312,2150,0,0,0,0,0,95,55,20,170,2320,Sitio Arqueológico
20240315,2023,6,Cajamarca,Paisaje Cultural Arqueologico Cumbemayo,1,Enero,0,0,0,0,8,174,1256,552,473,2463,0,0,0,0,11,163,32,63,269,2732,Sitio Arqueológico
20240315,2023,6,Cajamarca,Paisaje Cultural Arqueologico Cumbemayo,1,Enero,1,0,0,0,0,3,104,61,4,172,0,0,0,0,0,0,0,0,0,172,Sitio Arqueológico
20240315,2023,6,Cajamarca,Paisaje Cultural Arqueologico Cumbemayo,1,Enero,2,0,0,0,8,177,1360,613,477,2635,0,0,0,0,11,163,32,63,269,2904,Sitio Arqueológico
20240315,2023,6,Cajamarca,Paisaje Cultural Arqueologico Cumbemayo,2,Febrero,0,0,0,0,41,296,3029,719,648,4733,0,0,0,0,27,190,32,36,285,5018,Sitio Arqueológico
20240315,2023,6,Cajamarca,Paisaje Cultural Arqueologico Cumbemayo,2,Febrero,1,0,0,0,0,22,192,128,27,369,0,0,0,0,0,0,0,0,0,369,Sitio Arqueológico
20240315,2023,6,Cajamarca,Paisaje Cultural Arqueologico Cumbemayo,2,Febrero,2,0,0,0,41,318,3221,847,675,5102,0,0,0,0,27,190,32,36,285,5387,Sitio Arqueológico
20240315,2023,6,Cajamarca,Paisaje Cultural Arqueologico Cumbemayo,3,Marzo,0,0,0,0,2,96,628,285,160,1171,0,0,0,2,2,119,15,32,170,1341,Sitio Arqueológico
20240315,2023,6,Cajamarca,Paisaje Cultural Arqueologico Cumbemayo,3,Marzo,1,0,0,0,0,5,59,18,4,86,0,0,0,0,0,0,0,0,0,86,Sitio Arqueológico
20240315,2023,6,Cajamarca,Paisaje Cultural Arqueologico Cumbemayo,3,Marzo,2,0,0,0,2,101,687,303,164,1257,0,0,0,2,2,119,15,32,170,1427,Sitio Arqueológico
20240315,2023,6,Cajamarca,Paisaje Cultural Arqueologico Cumbemayo,4,Abril,0,0,0,0,5,100,1090,524,251,1970,0,0,0,0,13,74,30,18,135,2105,Sitio Arqueológico
20240315,2023,6,Cajamarca,Paisaje Cultural Arqueologico Cumbemayo,4,Abril,1,0,0,0,0,7,52,27,8,94,0,0,0,0,0,0,0,0,0,94,Sitio Arqueológico
20240315,2023,6,Cajamarca,Paisaje Cultural Arqueologico Cumbemayo,4,Abril,2,0,0,0,5,107,1142,551,259,2064,0,0,0,0,13,74,30,18,135,2199,Sitio Arqueológico
20240315,2023,6,Cajamarca,Paisaje Cultural Arqueologico Cumbemayo,5,Mayo,0,0,0,0,13,250,890,392,342,1887,0,0,0,0,23,116,31,32,202,2089,Sitio Arqueológico
20240315,2023,6,Cajamarca,Paisaje Cultural Arqueologico Cumbemayo,5,Mayo,1,0,0,0,0,0,99,34,6,139,0,0,0,0,0,0,0,0,0,139,Sitio Arqueológico
20240315,2023,6,Cajamarca,Paisaje Cultural Arqueologico Cumbemayo,5,Mayo,2,0,0,0,13,250,989,426,348,2026,0,0,0,0,23,116,31,32,202,2228,Sitio Arqueológico
20240315,2023,6,Cajamarca,Paisaje Cultural Arqueologico Cumbemayo,6,Junio,0,0,0,0,87,231,967,395,339,2019,0,0,0,2,23,127,46,44,242,2261,Sitio Arqueológico
20240315,2023,6,Cajamarca,Paisaje Cultural Arqueologico Cumbemayo,6,Junio,1,0,0,0,0,36,128,63,0,227,0,0,0,0,0,0,0,0,0,227,Sitio Arqueológico
20240315,2023,6,Cajamarca,Paisaje Cultural Arqueologico Cumbemayo,6,Junio,2,0,0,0,87,267,1095,458,339,2246,0,0,0,2,23,127,46,44,242,2488,Sitio Arqueológico
20240315,2023,6,Cajamarca,Paisaje Cultural Arqueologico Cumbemayo,7,Julio,0,0,0,0,63,459,2805,905,1297,5529,0,0,0,0,40,165,26,46,277,5806,Sitio Arqueológico
20240315,2023,6,Cajamarca,Paisaje Cultural Arqueologico Cumbemayo,7,Julio,1,0,0,0,0,52,170,104,20,346,0,0,0,0,0,0,0,0,0,346,Sitio Arqueológico
20240315,2023,6,Cajamarca,Paisaje Cultural Arqueologico Cumbemayo,7,Julio,2,0,0,0,63,511,2975,1009,1317,5875,0,0,0,0,40,165,26,46,277,6152,Sitio Arqueológico
20240315,2023,6,Cajamarca,Paisaje Cultural Arqueologico Cumbemayo,8,Agosto,0,0,0,0,49,540,2410,1063,1362,5424,0,0,0,0,23,285,78,123,509,5933,Sitio Arqueológico
20240315,2023,6,Cajamarca,Paisaje Cultural Arqueologico Cumbemayo,8,Agosto,1,0,0,0,0,52,142,72,10,276,0,0,0,0,0,0,0,0,0,276,Sitio Arqueológico
20240315,2023,6,Cajamarca,Paisaje Cultural Arqueologico Cumbemayo,8,Agosto,2,0,0,0,49,592,2552,1135,1372,5700,0,0,0,0,23,285,78,123,509,6209,Sitio Arqueológico
20240315,2023,6,Cajamarca,Paisaje Cultural Arqueologico Cumbemayo,9,Setiembre,0,0,0,0,17,420,1615,621,1578,4251,0,0,0,0,29,210,41,172,452,4703,Sitio Arqueológico
20240315,2023,6,Cajamarca,Paisaje Cultural Arqueologico Cumbemayo,9,Setiembre,1,0,0,0,0,13,304,58,7,382,0,0,0,0,0,0,0,0,0,382,Sitio Arqueológico
20240315,2023,6,Cajamarca,Paisaje Cultural Arqueologico Cumbemayo,9,Setiembre,2,0,0,0,17,433,1919,679,1585,4633,0,0,0,0,29,210,41,172,452,5085,Sitio Arqueológico
20240315,2023,6,Cajamarca,Paisaje Cultural Arqueologico Cumbemayo,10,Octubre,0,0,0,0,51,332,1662,714,1705,4464,0,0,0,0,36,154,76,121,387,4851,Sitio Arqueológico
20240315,2023,6,Cajamarca,Paisaje Cultural Arqueologico Cumbemayo,10,Octubre,1,0,0,0,0,53,103,46,2,204,0,0,0,0,0,0,0,0,0,204,Sitio Arqueológico
20240315,2023,6,Cajamarca,Paisaje Cultural Arqueologico Cumbemayo,10,Octubre,2,0,0,0,51,385,1765,760,1707,4668,0,0,0,0,36,154,76,121,387,5055,Sitio Arqueológico
20240315,2023,6,Cajamarca,Paisaje Cultural Arqueologico Cumbemayo,11,Noviembre,0,0,0,0,22,139,1357,544,1663,3725,0,0,0,0,19,178,18,99,314,4039,Sitio Arqueológico
20240315,2023,6,Cajamarca,Paisaje Cultural Arqueologico Cumbemayo,11,Noviembre,1,0,0,0,0,19,94,46,2,161,0,0,0,0,0,0,0,0,0,161,Sitio Arqueológico
20240315,2023,6,Cajamarca,Paisaje Cultural Arqueologico Cumbemayo,11,Noviembre,2,0,0,0,22,158,1451,590,1665,3886,0,0,0,0,19,178,18,99,314,4200,Sitio Arqueológico
20240315,2023,6,Cajamarca,Paisaje Cultural Arqueologico Cumbemayo,12,Diciembre,0,0,0,0,8,162,1006,463,432,2071,0,0,0,2,19,43,20,134,218,2289,Sitio Arqueológico
20240315,2023,6,Cajamarca,Paisaje Cultural Arqueologico Cumbemayo,12,Diciembre,1,0,0,0,0,19,73,16,7,115,0,0,0,0,0,0,0,0,0,115,Sitio Arqueológico
20240315,2023,6,Cajamarca,Paisaje Cultural Arqueologico Cumbemayo,12,Diciembre,2,0,0,0,8,181,1079,479,439,2186,0,0,0,2,19,43,20,134,218,2404,Sitio Arqueológico
20240315,2023,6,Cajamarca,Centro Arqueologico Ventanilla de Otuzco,1,Enero,0,0,0,0,40,196,2572,291,852,3951,0,0,0,0,0,403,110,96,609,4560,Sitio Arqueológico
20240315,2023,6,Cajamarca,Centro Arqueologico Ventanilla de Otuzco,1,Enero,1,0,0,0,0,44,183,2,2,231,0,0,0,0,0,0,0,0,0,231,Sitio Arqueológico
20240315,2023,6,Cajamarca,Centro Arqueologico Ventanilla de Otuzco,1,Enero,2,0,0,0,40,240,2755,293,854,4182,0,0,0,0,0,403,110,96,609,4791,Sitio Arqueológico
20240315,2023,6,Cajamarca,Centro Arqueologico Ventanilla de Otuzco,2,Febrero,0,0,0,0,182,724,6909,8657,4797,21269,0,0,0,0,44,266,28,79,417,21686,Sitio Arqueológico
20240315,2023,6,Cajamarca,Centro Arqueologico Ventanilla de Otuzco,2,Febrero,1,0,0,0,0,77,210,3,13,303,0,0,0,0,0,0,0,0,0,303,Sitio Arqueológico
20240315,2023,6,Cajamarca,Centro Arqueologico Ventanilla de Otuzco,2,Febrero,2,0,0,0,182,801,7119,8660,4810,21572,0,0,0,0,44,266,28,79,417,21989,Sitio Arqueológico
20240315,2023,6,Cajamarca,Centro Arqueologico Ventanilla de Otuzco,3,Marzo,0,0,0,0,6,78,1854,270,406,2614,0,0,0,0,33,264,32,82,411,3025,Sitio Arqueológico
20240315,2023,6,Cajamarca,Centro Arqueologico Ventanilla de Otuzco,3,Marzo,1,0,0,0,0,0,72,7,4,83,0,0,0,0,0,0,0,0,0,83,Sitio Arqueológico
20240315,2023,6,Cajamarca,Centro Arqueologico Ventanilla de Otuzco,3,Marzo,2,0,0,0,6,78,1926,277,410,2697,0,0,0,0,33,264,32,82,411,3108,Sitio Arqueológico
20240315,2023,6,Cajamarca,Centro Arqueologico Ventanilla de Otuzco,4,Abril,0,0,0,0,35,104,2075,153,308,2675,0,0,0,0,28,175,18,37,258,2933,Sitio Arqueológico
20240315,2023,6,Cajamarca,Centro Arqueologico Ventanilla de Otuzco,4,Abril,1,0,0,0,0,20,124,6,16,166,0,0,0,0,0,0,0,0,0,166,Sitio Arqueológico
20240315,2023,6,Cajamarca,Centro Arqueologico Ventanilla de Otuzco,4,Abril,2,0,0,0,35,124,2199,159,324,2841,0,0,0,0,28,175,18,37,258,3099,Sitio Arqueológico
20240315,2023,6,Cajamarca,Centro Arqueologico Ventanilla de Otuzco,5,Mayo,0,0,0,0,47,206,1833,299,444,2829,0,0,0,0,43,148,0,0,191,3020,Sitio Arqueológico
20240315,2023,6,Cajamarca,Centro Arqueologico Ventanilla de Otuzco,5,Mayo,1,0,0,4,0,30,194,12,64,304,0,0,0,0,0,0,0,0,0,304,Sitio Arqueológico
20240315,2023,6,Cajamarca,Centro Arqueologico Ventanilla de Otuzco,5,Mayo,2,0,0,4,47,236,2027,311,508,3133,0,0,0,0,43,148,0,0,191,3324,Sitio Arqueológico
20240315,2023,6,Cajamarca,Centro Arqueologico Ventanilla de Otuzco,6,Junio,0,0,0,0,34,224,2014,247,521,3040,0,0,0,0,59,249,12,18,338,3378,Sitio Arqueológico
20240315,2023,6,Cajamarca,Centro Arqueologico Ventanilla de Otuzco,6,Junio,1,0,0,0,0,16,139,0,0,155,0,0,0,0,0,0,0,0,0,155,Sitio Arqueológico
20240315,2023,6,Cajamarca,Centro Arqueologico Ventanilla de Otuzco,6,Junio,2,0,0,0,34,240,2153,247,521,3195,0,0,0,0,59,249,12,18,338,3533,Sitio Arqueológico
20240315,2023,6,Cajamarca,Centro Arqueologico Ventanilla de Otuzco,7,Julio,0,0,0,0,78,492,5173,546,1752,8041,0,0,0,0,59,302,16,65,442,8483,Sitio Arqueológico
20240315,2023,6,Cajamarca,Centro Arqueologico Ventanilla de Otuzco,7,Julio,1,0,0,0,0,108,365,71,143,687,0,0,0,0,0,0,0,0,0,687,Sitio Arqueológico
20240315,2023,6,Cajamarca,Centro Arqueologico Ventanilla de Otuzco,7,Julio,2,0,0,0,78,600,5538,617,1895,8728,0,0,0,0,59,302,16,65,442,9170,Sitio Arqueológico
20240315,2023,6,Cajamarca,Centro Arqueologico Ventanilla de Otuzco,8,Agosto,0,0,0,0,134,473,4611,690,1778,7686,0,0,0,3,116,964,86,184,1353,9039,Sitio Arqueológico
20240315,2023,6,Cajamarca,Centro Arqueologico Ventanilla de Otuzco,8,Agosto,1,0,0,0,0,71,196,54,89,410,0,0,0,0,0,0,0,0,0,410,Sitio Arqueológico
20240315,2023,6,Cajamarca,Centro Arqueologico Ventanilla de Otuzco,8,Agosto,2,0,0,0,134,544,4807,744,1867,8096,0,0,0,3,116,964,86,184,1353,9449,Sitio Arqueológico
20240315,2023,6,Cajamarca,Centro Arqueologico Ventanilla de Otuzco,9,Setiembre,0,0,0,0,75,335,2521,275,1111,4317,0,0,0,0,55,371,30,88,544,4861,Sitio Arqueológico
20240315,2023,6,Cajamarca,Centro Arqueologico Ventanilla de Otuzco,9,Setiembre,1,0,0,0,0,64,146,14,3,227,0,0,0,0,0,0,0,0,0,227,Sitio Arqueológico
20240315,2023,6,Cajamarca,Centro Arqueologico Ventanilla de Otuzco,9,Setiembre,2,0,0,0,75,399,2667,289,1114,4544,0,0,0,0,55,371,30,88,544,5088,Sitio Arqueológico
20240315,2023,6,Cajamarca,Centro Arqueologico Ventanilla de Otuzco,10,Octubre,0,0,0,0,103,450,3195,347,2760,6855,0,0,0,5,44,532,50,211,842,7697,Sitio Arqueológico
20240315,2023,6,Cajamarca,Centro Arqueologico Ventanilla de Otuzco,10,Octubre,1,0,0,0,0,96,188,4,42,330,0,0,0,0,0,0,0,0,0,330,Sitio Arqueológico
20240315,2023,6,Cajamarca,Centro Arqueologico Ventanilla de Otuzco,10,Octubre,2,0,0,0,103,546,3383,351,2802,7185,0,0,0,5,44,532,50,211,842,8027,Sitio Arqueológico
20240315,2023,6,Cajamarca,Centro Arqueologico Ventanilla de Otuzco,11,Noviembre,0,0,0,0,63,412,2999,516,3323,7313,0,0,0,0,35,245,17,127,424,7737,Sitio Arqueológico
20240315,2023,6,Cajamarca,Centro Arqueologico Ventanilla de Otuzco,11,Noviembre,1,0,0,0,0,68,155,0,0,223,0,0,0,0,0,0,0,0,0,223,Sitio Arqueológico
20240315,2023,6,Cajamarca,Centro Arqueologico Ventanilla de Otuzco,11,Noviembre,2,0,0,0,63,480,3154,516,3323,7536,0,0,0,0,35,245,17,127,424,7960,Sitio Arqueológico
20240315,2023,6,Cajamarca,Centro Arqueologico Ventanilla de Otuzco,12,Diciembre,0,0,0,0,27,271,2195,311,1396,4200,0,0,0,0,30,205,17,89,341,4541,Sitio Arqueológico
20240315,2023,6,Cajamarca,Centro Arqueologico Ventanilla de Otuzco,12,Diciembre,1,0,0,0,0,30,121,0,0,151,0,0,0,0,0,0,0,0,0,151,Sitio Arqueológico
20240315,2023,6,Cajamarca,Centro Arqueologico Ventanilla de Otuzco,12,Diciembre,2,0,0,0,27,301,2316,311,1396,4351,0,0,0,0,30,205,17,89,341,4692,Sitio Arqueológico
20240315,2023,6,Cajamarca,Monumento Arqueologico Kuntur Wasi,1,Enero,0,0,0,0,0,17,111,65,39,232,0,0,0,0,0,0,0,0,0,232,Sitio Arqueológico
20240315,2023,6,Cajamarca,Monumento Arqueologico Kuntur Wasi,1,Enero,1,0,0,0,0,0,16,0,8,24,0,0,0,0,0,0,0,0,0,24,Sitio Arqueológico
20240315,2023,6,Cajamarca,Monumento Arqueologico Kuntur Wasi,1,Enero,2,0,0,0,0,17,127,65,47,256,0,0,0,0,0,0,0,0,0,256,Sitio Arqueológico
20240315,2023,6,Cajamarca,Monumento Arqueologico Kuntur Wasi,2,Febrero,0,0,0,0,0,5,110,121,46,282,0,0,0,0,2,35,11,19,67,349,Sitio Arqueológico
20240315,2023,6,Cajamarca,Monumento Arqueologico Kuntur Wasi,2,Febrero,1,0,0,0,0,0,5,0,0,5,0,0,0,0,0,0,0,0,0,5,Sitio Arqueológico
20240315,2023,6,Cajamarca,Monumento Arqueologico Kuntur Wasi,2,Febrero,2,0,0,0,0,5,115,121,46,287,0,0,0,0,2,35,11,19,67,354,Sitio Arqueológico
20240315,2023,6,Cajamarca,Monumento Arqueologico Kuntur Wasi,3,Marzo,0,0,0,0,0,0,26,16,4,46,0,0,0,0,0,11,2,3,16,62,Sitio Arqueológico
20240315,2023,6,Cajamarca,Monumento Arqueologico Kuntur Wasi,3,Marzo,1,0,0,0,0,0,0,0,0,0,0,0,0,0,0,0,0,0,0,0,Sitio Arqueológico
20240315,2023,6,Cajamarca,Monumento Arqueologico Kuntur Wasi,3,Marzo,2,0,0,0,0,0,26,16,4,46,0,0,0,0,0,11,2,3,16,62,Sitio Arqueológico
20240315,2023,6,Cajamarca,Monumento Arqueologico Kuntur Wasi,4,Abril,0,0,0,0,0,0,111,34,19,164,0,0,0,0,0,6,9,2,17,181,Sitio Arqueológico
20240315,2023,6,Cajamarca,Monumento Arqueologico Kuntur Wasi,4,Abril,1,0,0,0,0,0,0,0,0,0,0,0,0,0,0,0,0,0,0,0,Sitio Arqueológico
20240315,2023,6,Cajamarca,Monumento Arqueologico Kuntur Wasi,4,Abril,2,0,0,0,0,0,111,34,19,164,0,0,0,0,0,6,9,2,17,181,Sitio Arqueológico
20240315,2023,6,Cajamarca,Monumento Arqueologico Kuntur Wasi,5,Mayo,0,0,0,0,0,2,126,79,111,318,0,0,0,0,1,18,7,7,33,351,Sitio Arqueológico
20240315,2023,6,Cajamarca,Monumento Arqueologico Kuntur Wasi,5,Mayo,1,0,0,3,0,2,11,0,0,16,0,0,0,0,0,0,0,0,0,16,Sitio Arqueológico
20240315,2023,6,Cajamarca,Monumento Arqueologico Kuntur Wasi,5,Mayo,2,0,0,3,0,4,137,79,111,334,0,0,0,0,1,18,7,7,33,367,Sitio Arqueológico
20240315,2023,6,Cajamarca,Monumento Arqueologico Kuntur Wasi,6,Junio,0,0,0,0,0,11,240,115,414,780,0,0,0,0,3,12,1,4,20,800,Sitio Arqueológico
20240315,2023,6,Cajamarca,Monumento Arqueologico Kuntur Wasi,6,Junio,1,0,0,0,0,0,10,2,4,16,0,0,0,0,0,0,0,0,0,16,Sitio Arqueológico
20240315,2023,6,Cajamarca,Monumento Arqueologico Kuntur Wasi,6,Junio,2,0,0,0,0,11,250,117,418,796,0,0,0,0,3,12,1,4,20,816,Sitio Arqueológico
20240315,2023,6,Cajamarca,Monumento Arqueologico Kuntur Wasi,7,Julio,0,0,0,0,0,22,206,166,138,532,0,0,0,0,0,8,4,4,16,548,Sitio Arqueológico
20240315,2023,6,Cajamarca,Monumento Arqueologico Kuntur Wasi,7,Julio,1,0,0,0,0,0,6,0,0,6,0,0,0,0,0,0,0,0,0,6,Sitio Arqueológico
20240315,2023,6,Cajamarca,Monumento Arqueologico Kuntur Wasi,7,Julio,2,0,0,0,0,22,212,166,138,538,0,0,0,0,0,8,4,4,16,554,Sitio Arqueológico
20240315,2023,6,Cajamarca,Monumento Arqueologico Kuntur Wasi,8,Agosto,0,0,0,0,0,24,214,121,202,561,0,0,0,0,3,29,10,22,64,625,Sitio Arqueológico
20240315,2023,6,Cajamarca,Monumento Arqueologico Kuntur Wasi,8,Agosto,1,0,0,0,0,8,27,5,1,41,0,0,0,0,0,0,0,0,0,41,Sitio Arqueológico
20240315,2023,6,Cajamarca,Monumento Arqueologico Kuntur Wasi,8,Agosto,2,0,0,0,0,32,241,126,203,602,0,0,0,0,3,29,10,22,64,666,Sitio Arqueológico
20240315,2023,6,Cajamarca,Monumento Arqueologico Kuntur Wasi,9,Setiembre,0,0,0,0,3,23,194,183,238,641,0,0,0,0,0,11,6,1,18,659,Sitio Arqueológico
20240315,2023,6,Cajamarca,Monumento Arqueologico Kuntur Wasi,9,Setiembre,1,0,0,0,0,0,3,1,0,4,0,0,0,0,0,0,0,0,0,4,Sitio Arqueológico
20240315,2023,6,Cajamarca,Monumento Arqueologico Kuntur Wasi,9,Setiembre,2,0,0,0,3,23,197,184,238,645,0,0,0,0,0,11,6,1,18,663,Sitio Arqueológico
20240315,2023,6,Cajamarca,Monumento Arqueologico Kuntur Wasi,10,Octubre,0,0,0,0,0,12,148,124,314,598,0,0,0,0,0,21,10,11,42,640,Sitio Arqueológico
20240315,2023,6,Cajamarca,Monumento Arqueologico Kuntur Wasi,10,Octubre,1,0,0,0,0,0,0,0,0,0,0,0,0,0,0,0,0,0,0,0,Sitio Arqueológico
20240315,2023,6,Cajamarca,Monumento Arqueologico Kuntur Wasi,10,Octubre,2,0,0,0,0,12,148,124,314,598,0,0,0,0,0,21,10,11,42,640,Sitio Arqueológico
20240315,2023,6,Cajamarca,Monumento Arqueologico Kuntur Wasi,11,Noviembre,0,0,0,0,0,25,161,100,183,469,0,0,0,0,0,7,9,14,30,499,Sitio Arqueológico
20240315,2023,6,Cajamarca,Monumento Arqueologico Kuntur Wasi,11,Noviembre,1,0,0,0,0,0,0,0,0,0,0,0,0,0,0,0,0,0,0,0,Sitio Arqueológico
20240315,2023,6,Cajamarca,Monumento Arqueologico Kuntur Wasi,11,Noviembre,2,0,0,0,0,25,161,100,183,469,0,0,0,0,0,7,9,14,30,499,Sitio Arqueológico
20240315,2023,6,Cajamarca,Monumento Arqueologico Kuntur Wasi,12,Diciembre,0,0,0,0,1,9,85,68,58,221,0,0,0,0,0,5,0,1,6,227,Sitio Arqueológico
20240315,2023,6,Cajamarca,Monumento Arqueologico Kuntur Wasi,12,Diciembre,1,0,0,0,0,0,0,8,1,9,0,0,0,0,0,0,0,0,0,9,Sitio Arqueológico
20240315,2023,6,Cajamarca,Monumento Arqueologico Kuntur Wasi,12,Diciembre,2,0,0,0,1,9,85,76,59,230,0,0,0,0,0,5,0,1,6,236,Sitio Arqueológico
20240315,2023,8,Cusco,Parque Arqueologico Macchu Picchu (Ruta 1: Camino Inka: Piscacucho Km. 82),1,Enero,0,0,0,0,0,0,2,0,0,2,0,0,0,0,0,0,0,0,0,2,Sitio Arqueológico
20240315,2023,8,Cusco,Parque Arqueologico Macchu Picchu (Ruta 1: Camino Inka: Piscacucho Km. 82),1,Enero,1,0,0,0,0,0,354,9,2,365,0,0,0,0,0,0,0,0,0,365,Sitio Arqueológico
20240315,2023,8,Cusco,Parque Arqueologico Macchu Picchu (Ruta 1: Camino Inka: Piscacucho Km. 82),1,Enero,2,0,0,0,0,0,356,9,2,367,0,0,0,0,0,0,0,0,0,367,Sitio Arqueológico
20240315,2023,8,Cusco,Parque Arqueologico Macchu Picchu (Ruta 1: Camino Inka: Piscacucho Km. 82),2,Febrero,0,0,0,0,0,0,0,0,0,0,0,0,0,0,0,0,0,0,0,0,Sitio Arqueológico
20240315,2023,8,Cusco,Parque Arqueologico Macchu Picchu (Ruta 1: Camino Inka: Piscacucho Km. 82),2,Febrero,1,0,0,0,0,0,0,0,0,0,0,0,0,0,0,0,0,0,0,0,Sitio Arqueológico
20240315,2023,8,Cusco,Parque Arqueologico Macchu Picchu (Ruta 1: Camino Inka: Piscacucho Km. 82),2,Febrero,2,0,0,0,0,0,0,0,0,0,0,0,0,0,0,0,0,0,0,0,Sitio Arqueológico
20240315,2023,8,Cusco,Parque Arqueologico Macchu Picchu (Ruta 1: Camino Inka: Piscacucho Km. 82),3,Marzo,0,0,0,0,0,0,3,0,0,3,0,0,0,0,0,0,0,0,0,3,Sitio Arqueológico
20240315,2023,8,Cusco,Parque Arqueologico Macchu Picchu (Ruta 1: Camino Inka: Piscacucho Km. 82),3,Marzo,1,0,0,0,0,0,1040,16,5,1061,0,0,0,0,0,0,0,0,0,1061,Sitio Arqueológico
20240315,2023,8,Cusco,Parque Arqueologico Macchu Picchu (Ruta 1: Camino Inka: Piscacucho Km. 82),3,Marzo,2,0,0,0,0,0,1043,16,5,1064,0,0,0,0,0,0,0,0,0,1064,Sitio Arqueológico
20240315,2023,8,Cusco,Parque Arqueologico Macchu Picchu (Ruta 1: Camino Inka: Piscacucho Km. 82),4,Abril,0,0,0,0,0,0,72,0,1,73,0,0,0,0,0,0,0,0,0,73,Sitio Arqueológico
20240315,2023,8,Cusco,Parque Arqueologico Macchu Picchu (Ruta 1: Camino Inka: Piscacucho Km. 82),4,Abril,1,0,0,0,0,0,2662,49,22,2733,0,0,0,0,0,0,0,0,0,2733,Sitio Arqueológico
20240315,2023,8,Cusco,Parque Arqueologico Macchu Picchu (Ruta 1: Camino Inka: Piscacucho Km. 82),4,Abril,2,0,0,0,0,0,2734,49,23,2806,0,0,0,0,0,0,0,0,0,2806,Sitio Arqueológico
20240315,2023,8,Cusco,Parque Arqueologico Macchu Picchu (Ruta 1: Camino Inka: Piscacucho Km. 82),5,Mayo,0,0,0,0,0,0,27,0,0,27,0,0,0,0,0,0,0,0,0,27,Sitio Arqueológico
20240315,2023,8,Cusco,Parque Arqueologico Macchu Picchu (Ruta 1: Camino Inka: Piscacucho Km. 82),5,Mayo,1,0,0,0,0,0,3296,32,10,3338,0,0,0,0,0,0,0,0,0,3338,Sitio Arqueológico
20240315,2023,8,Cusco,Parque Arqueologico Macchu Picchu (Ruta 1: Camino Inka: Piscacucho Km. 82),5,Mayo,2,0,0,0,0,0,3323,32,10,3365,0,0,0,0,0,0,0,0,0,3365,Sitio Arqueológico
20240315,2023,8,Cusco,Parque Arqueologico Macchu Picchu (Ruta 1: Camino Inka: Piscacucho Km. 82),6,Junio,0,0,0,0,0,0,93,2,0,95,0,0,0,0,0,0,0,0,0,95,Sitio Arqueológico
20240315,2023,8,Cusco,Parque Arqueologico Macchu Picchu (Ruta 1: Camino Inka: Piscacucho Km. 82),6,Junio,1,0,0,0,0,0,3183,130,18,3331,0,0,0,0,0,0,0,0,0,3331,Sitio Arqueológico
20240315,2023,8,Cusco,Parque Arqueologico Macchu Picchu (Ruta 1: Camino Inka: Piscacucho Km. 82),6,Junio,2,0,0,0,0,0,3276,132,18,3426,0,0,0,0,0,0,0,0,0,3426,Sitio Arqueológico
20240315,2023,8,Cusco,Parque Arqueologico Macchu Picchu (Ruta 1: Camino Inka: Piscacucho Km. 82),7,Julio,0,0,0,0,0,0,319,141,0,460,0,0,0,0,0,28,0,0,28,488,Sitio Arqueológico
20240315,2023,8,Cusco,Parque Arqueologico Macchu Picchu (Ruta 1: Camino Inka: Piscacucho Km. 82),7,Julio,1,0,0,0,0,0,3204,218,4,3426,0,0,0,0,0,0,0,0,0,3426,Sitio Arqueológico
20240315,2023,8,Cusco,Parque Arqueologico Macchu Picchu (Ruta 1: Camino Inka: Piscacucho Km. 82),7,Julio,2,0,0,0,0,0,3523,359,4,3886,0,0,0,0,0,28,0,0,28,3914,Sitio Arqueológico
20240315,2023,8,Cusco,Parque Arqueologico Macchu Picchu (Ruta 1: Camino Inka: Piscacucho Km. 82),8,Agosto,0,0,0,0,0,0,63,114,0,177,0,0,0,0,0,0,0,0,0,177,Sitio Arqueológico
20240315,2023,8,Cusco,Parque Arqueologico Macchu Picchu (Ruta 1: Camino Inka: Piscacucho Km. 82),8,Agosto,1,0,0,0,0,0,3340,129,1,3470,0,0,0,0,0,0,0,0,0,3470,Sitio Arqueológico
20240315,2023,8,Cusco,Parque Arqueologico Macchu Picchu (Ruta 1: Camino Inka: Piscacucho Km. 82),8,Agosto,2,0,0,0,0,0,3403,243,1,3647,0,0,0,0,0,0,0,0,0,3647,Sitio Arqueológico
20240315,2023,8,Cusco,Parque Arqueologico Macchu Picchu (Ruta 1: Camino Inka: Piscacucho Km. 82),9,Setiembre,0,0,0,0,0,0,46,0,0,46,0,0,0,0,0,3745,39,1,3785,3831,Sitio Arqueológico
20240315,2023,8,Cusco,Parque Arqueologico Macchu Picchu (Ruta 1: Camino Inka: Piscacucho Km. 82),9,Setiembre,1,0,0,0,0,0,0,0,0,0,0,0,0,0,0,0,0,0,0,0,Sitio Arqueológico
20240315,2023,8,Cusco,Parque Arqueologico Macchu Picchu (Ruta 1: Camino Inka: Piscacucho Km. 82),9,Setiembre,2,0,0,0,0,0,46,0,0,46,0,0,0,0,0,3745,39,1,3785,3831,Sitio Arqueológico
20240315,2023,8,Cusco,Parque Arqueologico Macchu Picchu (Ruta 1: Camino Inka: Piscacucho Km. 82),10,Octubre,0,0,0,0,0,0,56,60,1,117,0,0,0,0,0,1,16,0,17,134,Sitio Arqueológico
20240315,2023,8,Cusco,Parque Arqueologico Macchu Picchu (Ruta 1: Camino Inka: Piscacucho Km. 82),10,Octubre,1,0,0,0,0,0,3623,23,30,3676,0,0,0,0,0,0,0,0,0,3676,Sitio Arqueológico
20240315,2023,8,Cusco,Parque Arqueologico Macchu Picchu (Ruta 1: Camino Inka: Piscacucho Km. 82),10,Octubre,2,0,0,0,0,0,3679,83,31,3793,0,0,0,0,0,1,16,0,17,3810,Sitio Arqueológico
20240315,2023,8,Cusco,Parque Arqueologico Macchu Picchu (Ruta 1: Camino Inka: Piscacucho Km. 82),11,Noviembre,0,0,0,0,0,0,27,0,0,27,0,0,0,0,0,0,0,0,0,27,Sitio Arqueológico
20240315,2023,8,Cusco,Parque Arqueologico Macchu Picchu (Ruta 1: Camino Inka: Piscacucho Km. 82),11,Noviembre,1,0,0,0,0,0,2677,6,25,2708,0,0,0,0,0,0,0,0,0,2708,Sitio Arqueológico
20240315,2023,8,Cusco,Parque Arqueologico Macchu Picchu (Ruta 1: Camino Inka: Piscacucho Km. 82),11,Noviembre,2,0,0,0,0,0,2704,6,25,2735,0,0,0,0,0,0,0,0,0,2735,Sitio Arqueológico
20240315,2023,8,Cusco,Parque Arqueologico Macchu Picchu (Ruta 1: Camino Inka: Piscacucho Km. 82),12,Diciembre,0,0,0,0,0,0,41,0,1,42,0,0,0,0,0,0,0,0,0,42,Sitio Arqueológico
20240315,2023,8,Cusco,Parque Arqueologico Macchu Picchu (Ruta 1: Camino Inka: Piscacucho Km. 82),12,Diciembre,1,0,0,0,0,0,1689,21,55,1765,0,0,0,0,0,0,0,0,0,1765,Sitio Arqueológico
20240315,2023,8,Cusco,Parque Arqueologico Macchu Picchu (Ruta 1: Camino Inka: Piscacucho Km. 82),12,Diciembre,2,0,0,0,0,0,1730,21,56,1807,0,0,0,0,0,0,0,0,0,1807,Sitio Arqueológico
20240315,2023,8,Cusco,Parque Arqueologico Macchu Picchu (Ruta 2: Camino Inka: Km. 88),1,Enero,0,0,0,0,0,0,0,0,0,0,0,0,0,0,0,0,0,0,0,0,Sitio Arqueológico
20240315,2023,8,Cusco,Parque Arqueologico Macchu Picchu (Ruta 2: Camino Inka: Km. 88),1,Enero,1,0,0,0,0,0,0,0,0,0,0,0,0,0,0,0,0,0,0,0,Sitio Arqueológico
20240315,2023,8,Cusco,Parque Arqueologico Macchu Picchu (Ruta 2: Camino Inka: Km. 88),1,Enero,2,0,0,0,0,0,0,0,0,0,0,0,0,0,0,0,0,0,0,0,Sitio Arqueológico
20240315,2023,8,Cusco,Parque Arqueologico Macchu Picchu (Ruta 2: Camino Inka: Km. 88),2,Febrero,0,0,0,0,0,0,0,0,0,0,0,0,0,0,0,0,0,0,0,0,Sitio Arqueológico
20240315,2023,8,Cusco,Parque Arqueologico Macchu Picchu (Ruta 2: Camino Inka: Km. 88),2,Febrero,1,0,0,0,0,0,0,0,0,0,0,0,0,0,0,0,0,0,0,0,Sitio Arqueológico
20240315,2023,8,Cusco,Parque Arqueologico Macchu Picchu (Ruta 2: Camino Inka: Km. 88),2,Febrero,2,0,0,0,0,0,0,0,0,0,0,0,0,0,0,0,0,0,0,0,Sitio Arqueológico
20240315,2023,8,Cusco,Parque Arqueologico Macchu Picchu (Ruta 2: Camino Inka: Km. 88),3,Marzo,0,0,0,0,0,0,0,0,0,0,0,0,0,0,0,0,0,0,0,0,Sitio Arqueológico
20240315,2023,8,Cusco,Parque Arqueologico Macchu Picchu (Ruta 2: Camino Inka: Km. 88),3,Marzo,1,0,0,0,0,0,14,0,0,14,0,0,0,0,0,0,0,0,0,14,Sitio Arqueológico
20240315,2023,8,Cusco,Parque Arqueologico Macchu Picchu (Ruta 2: Camino Inka: Km. 88),3,Marzo,2,0,0,0,0,0,14,0,0,14,0,0,0,0,0,0,0,0,0,14,Sitio Arqueológico
20240315,2023,8,Cusco,Parque Arqueologico Macchu Picchu (Ruta 2: Camino Inka: Km. 88),4,Abril,0,0,0,0,0,0,0,0,0,0,0,0,0,0,0,0,0,0,0,0,Sitio Arqueológico
20240315,2023,8,Cusco,Parque Arqueologico Macchu Picchu (Ruta 2: Camino Inka: Km. 88),4,Abril,1,0,0,0,0,0,84,2,0,86,0,0,0,0,0,0,0,0,0,86,Sitio Arqueológico
20240315,2023,8,Cusco,Parque Arqueologico Macchu Picchu (Ruta 2: Camino Inka: Km. 88),4,Abril,2,0,0,0,0,0,84,2,0,86,0,0,0,0,0,0,0,0,0,86,Sitio Arqueológico
20240315,2023,8,Cusco,Parque Arqueologico Macchu Picchu (Ruta 2: Camino Inka: Km. 88),5,Mayo,0,0,0,0,0,0,0,0,0,0,0,0,0,0,0,0,0,0,0,0,Sitio Arqueológico
20240315,2023,8,Cusco,Parque Arqueologico Macchu Picchu (Ruta 2: Camino Inka: Km. 88),5,Mayo,1,0,0,0,0,0,174,3,0,177,0,0,0,0,0,0,0,0,0,177,Sitio Arqueológico
20240315,2023,8,Cusco,Parque Arqueologico Macchu Picchu (Ruta 2: Camino Inka: Km. 88),5,Mayo,2,0,0,0,0,0,174,3,0,177,0,0,0,0,0,0,0,0,0,177,Sitio Arqueológico
20240315,2023,8,Cusco,Parque Arqueologico Macchu Picchu (Ruta 2: Camino Inka: Km. 88),6,Junio,0,0,0,0,0,0,0,4,0,4,0,0,0,0,0,0,0,0,0,4,Sitio Arqueológico
20240315,2023,8,Cusco,Parque Arqueologico Macchu Picchu (Ruta 2: Camino Inka: Km. 88),6,Junio,1,0,0,0,0,0,97,0,0,97,0,0,0,0,0,0,0,0,0,97,Sitio Arqueológico
20240315,2023,8,Cusco,Parque Arqueologico Macchu Picchu (Ruta 2: Camino Inka: Km. 88),6,Junio,2,0,0,0,0,0,97,4,0,101,0,0,0,0,0,0,0,0,0,101,Sitio Arqueológico
20240315,2023,8,Cusco,Parque Arqueologico Macchu Picchu (Ruta 2: Camino Inka: Km. 88),7,Julio,0,0,0,0,0,0,0,0,0,0,0,0,0,0,0,0,0,0,0,0,Sitio Arqueológico
20240315,2023,8,Cusco,Parque Arqueologico Macchu Picchu (Ruta 2: Camino Inka: Km. 88),7,Julio,1,0,0,0,0,0,116,0,0,116,0,0,0,0,0,0,0,0,0,116,Sitio Arqueológico
20240315,2023,8,Cusco,Parque Arqueologico Macchu Picchu (Ruta 2: Camino Inka: Km. 88),7,Julio,2,0,0,0,0,0,116,0,0,116,0,0,0,0,0,0,0,0,0,116,Sitio Arqueológico
20240315,2023,8,Cusco,Parque Arqueologico Macchu Picchu (Ruta 2: Camino Inka: Km. 88),8,Agosto,0,0,0,0,0,0,0,0,0,0,0,0,0,0,0,0,0,0,0,0,Sitio Arqueológico
20240315,2023,8,Cusco,Parque Arqueologico Macchu Picchu (Ruta 2: Camino Inka: Km. 88),8,Agosto,1,0,0,0,0,0,84,2,0,86,0,0,0,0,0,0,0,0,0,86,Sitio Arqueológico
20240315,2023,8,Cusco,Parque Arqueologico Macchu Picchu (Ruta 2: Camino Inka: Km. 88),8,Agosto,2,0,0,0,0,0,84,2,0,86,0,0,0,0,0,0,0,0,0,86,Sitio Arqueológico
20240315,2023,8,Cusco,Parque Arqueologico Macchu Picchu (Ruta 2: Camino Inka: Km. 88),9,Setiembre,0,0,0,0,0,0,8,0,0,8,0,0,0,0,0,0,0,0,0,8,Sitio Arqueológico
20240315,2023,8,Cusco,Parque Arqueologico Macchu Picchu (Ruta 2: Camino Inka: Km. 88),9,Setiembre,1,0,0,0,0,0,206,0,0,206,0,0,0,0,0,0,0,0,0,206,Sitio Arqueológico
20240315,2023,8,Cusco,Parque Arqueologico Macchu Picchu (Ruta 2: Camino Inka: Km. 88),9,Setiembre,2,0,0,0,0,0,214,0,0,214,0,0,0,0,0,0,0,0,0,214,Sitio Arqueológico
20240315,2023,8,Cusco,Parque Arqueologico Macchu Picchu (Ruta 2: Camino Inka: Km. 88),10,Octubre,0,0,0,0,0,0,0,0,0,0,0,0,0,0,0,0,0,0,0,0,Sitio Arqueológico
20240315,2023,8,Cusco,Parque Arqueologico Macchu Picchu (Ruta 2: Camino Inka: Km. 88),10,Octubre,1,0,0,0,0,0,143,0,0,143,0,0,0,0,0,0,0,0,0,143,Sitio Arqueológico
20240315,2023,8,Cusco,Parque Arqueologico Macchu Picchu (Ruta 2: Camino Inka: Km. 88),10,Octubre,2,0,0,0,0,0,143,0,0,143,0,0,0,0,0,0,0,0,0,143,Sitio Arqueológico
20240315,2023,8,Cusco,Parque Arqueologico Macchu Picchu (Ruta 2: Camino Inka: Km. 88),11,Noviembre,0,0,0,0,0,0,0,0,0,0,0,0,0,0,0,0,0,0,0,0,Sitio Arqueológico
20240315,2023,8,Cusco,Parque Arqueologico Macchu Picchu (Ruta 2: Camino Inka: Km. 88),11,Noviembre,1,0,0,0,0,0,67,0,0,67,0,0,0,0,0,0,0,0,0,67,Sitio Arqueológico
20240315,2023,8,Cusco,Parque Arqueologico Macchu Picchu (Ruta 2: Camino Inka: Km. 88),11,Noviembre,2,0,0,0,0,0,67,0,0,67,0,0,0,0,0,0,0,0,0,67,Sitio Arqueológico
20240315,2023,8,Cusco,Parque Arqueologico Macchu Picchu (Ruta 2: Camino Inka: Km. 88),12,Diciembre,0,0,0,0,0,0,0,0,0,0,0,0,0,0,0,0,0,0,0,0,Sitio Arqueológico
20240315,2023,8,Cusco,Parque Arqueologico Macchu Picchu (Ruta 2: Camino Inka: Km. 88),12,Diciembre,1,0,0,0,0,0,34,0,0,34,0,0,0,0,0,0,0,0,0,34,Sitio Arqueológico
20240315,2023,8,Cusco,Parque Arqueologico Macchu Picchu (Ruta 2: Camino Inka: Km. 88),12,Diciembre,2,0,0,0,0,0,34,0,0,34,0,0,0,0,0,0,0,0,0,34,Sitio Arqueológico
20240315,2023,8,Cusco,Parque Arqueologico Macchu Picchu (Ruta 5: Camino Iinka: Chanchabamba Km. 104),1,Enero,0,0,0,0,0,0,8,1,0,9,0,0,0,0,0,0,0,0,0,9,Sitio Arqueológico
20240315,2023,8,Cusco,Parque Arqueologico Macchu Picchu (Ruta 5: Camino Iinka: Chanchabamba Km. 104),1,Enero,1,0,0,0,0,0,173,3,4,180,0,0,0,0,0,0,0,0,0,180,Sitio Arqueológico
20240315,2023,8,Cusco,Parque Arqueologico Macchu Picchu (Ruta 5: Camino Iinka: Chanchabamba Km. 104),1,Enero,2,0,0,0,0,0,181,4,4,189,0,0,0,0,0,0,0,0,0,189,Sitio Arqueológico
20240315,2023,8,Cusco,Parque Arqueologico Macchu Picchu (Ruta 5: Camino Iinka: Chanchabamba Km. 104),2,Febrero,0,0,0,0,0,0,0,0,0,0,0,0,0,0,0,0,0,0,0,0,Sitio Arqueológico
20240315,2023,8,Cusco,Parque Arqueologico Macchu Picchu (Ruta 5: Camino Iinka: Chanchabamba Km. 104),2,Febrero,1,0,0,0,0,0,0,0,0,0,0,0,0,0,0,0,0,0,0,0,Sitio Arqueológico
20240315,2023,8,Cusco,Parque Arqueologico Macchu Picchu (Ruta 5: Camino Iinka: Chanchabamba Km. 104),2,Febrero,2,0,0,0,0,0,0,0,0,0,0,0,0,0,0,0,0,0,0,0,Sitio Arqueológico
20240315,2023,8,Cusco,Parque Arqueologico Macchu Picchu (Ruta 5: Camino Iinka: Chanchabamba Km. 104),3,Marzo,0,0,0,0,0,0,13,0,0,13,0,0,0,0,0,0,0,0,0,13,Sitio Arqueológico
20240315,2023,8,Cusco,Parque Arqueologico Macchu Picchu (Ruta 5: Camino Iinka: Chanchabamba Km. 104),3,Marzo,1,0,0,0,0,0,399,33,0,432,0,0,0,0,0,0,0,0,0,432,Sitio Arqueológico
20240315,2023,8,Cusco,Parque Arqueologico Macchu Picchu (Ruta 5: Camino Iinka: Chanchabamba Km. 104),3,Marzo,2,0,0,0,0,0,412,33,0,445,0,0,0,0,0,0,0,0,0,445,Sitio Arqueológico
20240315,2023,8,Cusco,Parque Arqueologico Macchu Picchu (Ruta 5: Camino Iinka: Chanchabamba Km. 104),4,Abril,0,0,0,0,0,0,51,0,0,51,0,0,0,0,0,0,0,0,0,51,Sitio Arqueológico
20240315,2023,8,Cusco,Parque Arqueologico Macchu Picchu (Ruta 5: Camino Iinka: Chanchabamba Km. 104),4,Abril,1,0,0,0,0,0,1159,90,4,1253,0,0,0,0,0,0,0,0,0,1253,Sitio Arqueológico
20240315,2023,8,Cusco,Parque Arqueologico Macchu Picchu (Ruta 5: Camino Iinka: Chanchabamba Km. 104),4,Abril,2,0,0,0,0,0,1210,90,4,1304,0,0,0,0,0,0,0,0,0,1304,Sitio Arqueológico
20240315,2023,8,Cusco,Parque Arqueologico Macchu Picchu (Ruta 5: Camino Iinka: Chanchabamba Km. 104),5,Mayo,0,0,0,0,0,0,32,4,0,36,0,0,0,0,0,0,0,0,0,36,Sitio Arqueológico
20240315,2023,8,Cusco,Parque Arqueologico Macchu Picchu (Ruta 5: Camino Iinka: Chanchabamba Km. 104),5,Mayo,1,0,0,0,0,0,1630,17,2,1649,0,0,0,0,0,0,0,0,0,1649,Sitio Arqueológico
20240315,2023,8,Cusco,Parque Arqueologico Macchu Picchu (Ruta 5: Camino Iinka: Chanchabamba Km. 104),5,Mayo,2,0,0,0,0,0,1662,21,2,1685,0,0,0,0,0,0,0,0,0,1685,Sitio Arqueológico
20240315,2023,8,Cusco,Parque Arqueologico Macchu Picchu (Ruta 5: Camino Iinka: Chanchabamba Km. 104),6,Junio,0,0,0,0,0,0,44,1,0,45,0,0,0,0,0,0,0,0,0,45,Sitio Arqueológico
20240315,2023,8,Cusco,Parque Arqueologico Macchu Picchu (Ruta 5: Camino Iinka: Chanchabamba Km. 104),6,Junio,1,0,0,0,0,0,1491,30,83,1604,0,0,0,0,0,0,0,0,0,1604,Sitio Arqueológico
20240315,2023,8,Cusco,Parque Arqueologico Macchu Picchu (Ruta 5: Camino Iinka: Chanchabamba Km. 104),6,Junio,2,0,0,0,0,0,1535,31,83,1649,0,0,0,0,0,0,0,0,0,1649,Sitio Arqueológico
20240315,2023,8,Cusco,Parque Arqueologico Macchu Picchu (Ruta 5: Camino Iinka: Chanchabamba Km. 104),7,Julio,0,0,0,0,0,0,52,3,6,61,0,0,0,0,0,0,0,0,0,61,Sitio Arqueológico
20240315,2023,8,Cusco,Parque Arqueologico Macchu Picchu (Ruta 5: Camino Iinka: Chanchabamba Km. 104),7,Julio,1,0,0,0,0,0,2014,79,165,2258,0,0,0,0,0,0,0,0,0,2258,Sitio Arqueológico
20240315,2023,8,Cusco,Parque Arqueologico Macchu Picchu (Ruta 5: Camino Iinka: Chanchabamba Km. 104),7,Julio,2,0,0,0,0,0,2066,82,171,2319,0,0,0,0,0,0,0,0,0,2319,Sitio Arqueológico
20240315,2023,8,Cusco,Parque Arqueologico Macchu Picchu (Ruta 5: Camino Iinka: Chanchabamba Km. 104),8,Agosto,0,0,0,0,0,0,25,0,0,25,0,0,0,0,0,0,0,0,0,25,Sitio Arqueológico
20240315,2023,8,Cusco,Parque Arqueologico Macchu Picchu (Ruta 5: Camino Iinka: Chanchabamba Km. 104),8,Agosto,1,0,0,0,0,0,2340,56,183,2579,0,0,0,0,0,0,0,0,0,2579,Sitio Arqueológico
20240315,2023,8,Cusco,Parque Arqueologico Macchu Picchu (Ruta 5: Camino Iinka: Chanchabamba Km. 104),8,Agosto,2,0,0,0,0,0,2365,56,183,2604,0,0,0,0,0,0,0,0,0,2604,Sitio Arqueológico
20240315,2023,8,Cusco,Parque Arqueologico Macchu Picchu (Ruta 5: Camino Iinka: Chanchabamba Km. 104),9,Setiembre,0,0,0,0,0,0,35,0,3,38,0,0,0,0,0,0,0,0,0,38,Sitio Arqueológico
20240315,2023,8,Cusco,Parque Arqueologico Macchu Picchu (Ruta 5: Camino Iinka: Chanchabamba Km. 104),9,Setiembre,1,0,0,0,0,0,2337,7,19,2363,0,0,0,0,0,0,0,0,0,2363,Sitio Arqueológico
20240315,2023,8,Cusco,Parque Arqueologico Macchu Picchu (Ruta 5: Camino Iinka: Chanchabamba Km. 104),9,Setiembre,2,0,0,0,0,0,2372,7,22,2401,0,0,0,0,0,0,0,0,0,2401,Sitio Arqueológico
20240315,2023,8,Cusco,Parque Arqueologico Macchu Picchu (Ruta 5: Camino Iinka: Chanchabamba Km. 104),10,Octubre,0,0,0,0,0,0,39,10,0,49,0,0,0,0,0,0,0,0,0,49,Sitio Arqueológico
20240315,2023,8,Cusco,Parque Arqueologico Macchu Picchu (Ruta 5: Camino Iinka: Chanchabamba Km. 104),10,Octubre,1,0,0,0,0,0,2365,37,0,2402,0,0,0,0,0,0,0,0,0,2402,Sitio Arqueológico
20240315,2023,8,Cusco,Parque Arqueologico Macchu Picchu (Ruta 5: Camino Iinka: Chanchabamba Km. 104),10,Octubre,2,0,0,0,0,0,2404,47,0,2451,0,0,0,0,0,0,0,0,0,2451,Sitio Arqueológico
20240315,2023,8,Cusco,Parque Arqueologico Macchu Picchu (Ruta 5: Camino Iinka: Chanchabamba Km. 104),11,Noviembre,0,0,0,0,0,0,18,0,0,18,0,0,0,0,0,0,0,0,0,18,Sitio Arqueológico
20240315,2023,8,Cusco,Parque Arqueologico Macchu Picchu (Ruta 5: Camino Iinka: Chanchabamba Km. 104),11,Noviembre,1,0,0,0,0,0,1894,93,0,1987,0,0,0,0,0,0,0,0,0,1987,Sitio Arqueológico
20240315,2023,8,Cusco,Parque Arqueologico Macchu Picchu (Ruta 5: Camino Iinka: Chanchabamba Km. 104),11,Noviembre,2,0,0,0,0,0,1912,93,0,2005,0,0,0,0,0,0,0,0,0,2005,Sitio Arqueológico
20240315,2023,8,Cusco,Parque Arqueologico Macchu Picchu (Ruta 5: Camino Iinka: Chanchabamba Km. 104),12,Diciembre,0,0,0,0,0,0,59,0,2,61,0,0,0,0,0,0,0,0,0,61,Sitio Arqueológico
20240315,2023,8,Cusco,Parque Arqueologico Macchu Picchu (Ruta 5: Camino Iinka: Chanchabamba Km. 104),12,Diciembre,1,0,0,0,0,0,1588,141,0,1729,0,0,0,0,0,0,0,0,0,1729,Sitio Arqueológico
20240315,2023,8,Cusco,Parque Arqueologico Macchu Picchu (Ruta 5: Camino Iinka: Chanchabamba Km. 104),12,Diciembre,2,0,0,0,0,0,1647,141,2,1790,0,0,0,0,0,0,0,0,0,1790,Sitio Arqueológico
20240315,2023,8,Cusco,Monumento Arqueologico de Raqchi,1,Enero,0,0,0,0,0,0,100,47,0,147,0,0,0,0,0,177,77,16,270,417,Sitio Arqueológico
20240315,2023,8,Cusco,Monumento Arqueologico de Raqchi,1,Enero,1,0,0,0,0,0,572,13,0,585,0,0,0,0,0,0,0,0,0,585,Sitio Arqueológico
20240315,2023,8,Cusco,Monumento Arqueologico de Raqchi,1,Enero,2,0,0,0,0,0,672,60,0,732,0,0,0,0,0,177,77,16,270,1002,Sitio Arqueológico
20240315,2023,8,Cusco,Monumento Arqueologico de Raqchi,2,Febrero,0,0,0,0,0,0,116,61,0,177,0,0,0,0,0,194,56,19,269,446,Sitio Arqueológico
20240315,2023,8,Cusco,Monumento Arqueologico de Raqchi,2,Febrero,1,0,0,0,0,0,2,0,0,2,0,0,0,0,0,0,0,0,0,2,Sitio Arqueológico
20240315,2023,8,Cusco,Monumento Arqueologico de Raqchi,2,Febrero,2,0,0,0,0,0,118,61,0,179,0,0,0,0,0,194,56,19,269,448,Sitio Arqueológico
20240315,2023,8,Cusco,Monumento Arqueologico de Raqchi,3,Marzo,0,0,0,0,0,0,97,121,0,218,0,0,0,0,0,51,89,26,166,384,Sitio Arqueológico
20240315,2023,8,Cusco,Monumento Arqueologico de Raqchi,3,Marzo,1,0,0,0,0,0,92,71,0,163,0,0,0,0,0,0,0,0,0,163,Sitio Arqueológico
20240315,2023,8,Cusco,Monumento Arqueologico de Raqchi,3,Marzo,2,0,0,0,0,0,189,192,0,381,0,0,0,0,0,51,89,26,166,547,Sitio Arqueológico
20240315,2023,8,Cusco,Monumento Arqueologico de Raqchi,4,Abril,0,0,0,0,0,0,217,117,0,334,0,0,0,0,0,742,98,34,874,1208,Sitio Arqueológico
20240315,2023,8,Cusco,Monumento Arqueologico de Raqchi,4,Abril,1,0,0,0,0,0,773,164,0,937,0,0,0,0,0,0,0,0,0,937,Sitio Arqueológico
20240315,2023,8,Cusco,Monumento Arqueologico de Raqchi,4,Abril,2,0,0,0,0,0,990,281,0,1271,0,0,0,0,0,742,98,34,874,2145,Sitio Arqueológico
20240315,2023,8,Cusco,Monumento Arqueologico de Raqchi,5,Mayo,0,0,0,0,0,0,447,49,0,496,0,0,0,0,0,719,52,35,806,1302,Sitio Arqueológico
20240315,2023,8,Cusco,Monumento Arqueologico de Raqchi,5,Mayo,1,0,0,0,0,0,2285,93,0,2378,0,0,0,0,0,0,0,0,0,2378,Sitio Arqueológico
20240315,2023,8,Cusco,Monumento Arqueologico de Raqchi,5,Mayo,2,0,0,0,0,0,2732,142,0,2874,0,0,0,0,0,719,52,35,806,3680,Sitio Arqueológico
20240315,2023,8,Cusco,Monumento Arqueologico de Raqchi,6,Junio,0,0,0,0,0,0,234,92,0,326,0,0,0,0,0,4165,1180,580,5925,6251,Sitio Arqueológico
20240315,2023,8,Cusco,Monumento Arqueologico de Raqchi,6,Junio,1,0,0,0,0,0,2165,105,0,2270,0,0,0,0,0,0,0,0,0,2270,Sitio Arqueológico
20240315,2023,8,Cusco,Monumento Arqueologico de Raqchi,6,Junio,2,0,0,0,0,0,2399,197,0,2596,0,0,0,0,0,4165,1180,580,5925,8521,Sitio Arqueológico
20240315,2023,8,Cusco,Monumento Arqueologico de Raqchi,7,Julio,0,0,0,0,0,0,391,127,0,518,0,0,0,0,0,898,106,34,1038,1556,Sitio Arqueológico
20240315,2023,8,Cusco,Monumento Arqueologico de Raqchi,7,Julio,1,0,0,0,0,0,2546,179,0,2725,0,0,0,0,0,0,0,0,0,2725,Sitio Arqueológico
20240315,2023,8,Cusco,Monumento Arqueologico de Raqchi,7,Julio,2,0,0,0,0,0,2937,306,0,3243,0,0,0,0,0,898,106,34,1038,4281,Sitio Arqueológico
20240315,2023,8,Cusco,Monumento Arqueologico de Raqchi,8,Agosto,0,0,0,0,0,0,546,182,0,728,0,0,0,0,0,1007,129,53,1189,1917,Sitio Arqueológico
20240315,2023,8,Cusco,Monumento Arqueologico de Raqchi,8,Agosto,1,0,0,0,0,0,4165,244,0,4409,0,0,0,0,0,0,0,0,0,4409,Sitio Arqueológico
20240315,2023,8,Cusco,Monumento Arqueologico de Raqchi,8,Agosto,2,0,0,0,0,0,4711,426,0,5137,0,0,0,0,0,1007,129,53,1189,6326,Sitio Arqueológico
20240315,2023,8,Cusco,Monumento Arqueologico de Raqchi,9,Setiembre,0,0,0,0,0,0,429,118,0,547,0,0,0,0,0,1085,4224,97,5406,5953,Sitio Arqueológico
20240315,2023,8,Cusco,Monumento Arqueologico de Raqchi,9,Setiembre,1,0,0,0,0,0,4731,73,0,4804,0,0,0,0,0,0,0,0,0,4804,Sitio Arqueológico
20240315,2023,8,Cusco,Monumento Arqueologico de Raqchi,9,Setiembre,2,0,0,0,0,0,5160,191,0,5351,0,0,0,0,0,1085,4224,97,5406,10757,Sitio Arqueológico
20240315,2023,8,Cusco,Monumento Arqueologico de Raqchi,10,Octubre,0,0,0,0,0,0,0,11,451,462,0,0,0,0,0,696,123,29,848,1310,Sitio Arqueológico
20240315,2023,8,Cusco,Monumento Arqueologico de Raqchi,10,Octubre,1,0,0,0,0,0,5122,123,0,5245,0,0,0,0,0,0,0,0,0,5245,Sitio Arqueológico
20240315,2023,8,Cusco,Monumento Arqueologico de Raqchi,10,Octubre,2,0,0,0,0,0,5122,134,451,5707,0,0,0,0,0,696,123,29,848,6555,Sitio Arqueológico
20240315,2023,8,Cusco,Monumento Arqueologico de Raqchi,11,Noviembre,0,0,0,0,0,0,305,203,0,508,0,0,0,0,0,689,117,37,843,1351,Sitio Arqueológico
20240315,2023,8,Cusco,Monumento Arqueologico de Raqchi,11,Noviembre,1,0,0,0,0,0,4053,141,0,4194,0,0,0,0,0,0,0,0,0,4194,Sitio Arqueológico
20240315,2023,8,Cusco,Monumento Arqueologico de Raqchi,11,Noviembre,2,0,0,0,0,0,4358,344,0,4702,0,0,0,0,0,689,117,37,843,5545,Sitio Arqueológico
20240315,2023,8,Cusco,Monumento Arqueologico de Raqchi,12,Diciembre,0,0,0,0,0,0,173,109,0,282,0,0,0,0,0,979,177,43,1199,1481,Sitio Arqueológico
20240315,2023,8,Cusco,Monumento Arqueologico de Raqchi,12,Diciembre,1,0,0,0,0,0,1592,121,0,1713,0,0,0,0,0,0,0,0,0,1713,Sitio Arqueológico
20240315,2023,8,Cusco,Monumento Arqueologico de Raqchi,12,Diciembre,2,0,0,0,0,0,1765,230,0,1995,0,0,0,0,0,979,177,43,1199,3194,Sitio Arqueológico
20240315,2023,8,Cusco,Monumento Arqueologico de Moray,1,Enero,0,0,0,0,0,0,5918,1309,0,7227,0,0,0,0,58,824,253,18,1153,8380,Sitio Arqueológico
20240315,2023,8,Cusco,Monumento Arqueologico de Moray,1,Enero,1,0,0,0,0,0,7600,831,0,8431,0,0,0,0,0,0,0,0,0,8431,Sitio Arqueológico
20240315,2023,8,Cusco,Monumento Arqueologico de Moray,1,Enero,2,0,0,0,0,0,13518,2140,0,15658,0,0,0,0,58,824,253,18,1153,16811,Sitio Arqueológico
20240315,2023,8,Cusco,Monumento Arqueologico de Moray,2,Febrero,0,0,0,0,0,0,3770,599,0,4369,0,0,0,0,57,848,262,12,1179,5548,Sitio Arqueológico
20240315,2023,8,Cusco,Monumento Arqueologico de Moray,2,Febrero,1,0,0,0,0,0,4195,223,0,4418,0,0,0,0,0,0,0,0,0,4418,Sitio Arqueológico
20240315,2023,8,Cusco,Monumento Arqueologico de Moray,2,Febrero,2,0,0,0,0,0,7965,822,0,8787,0,0,0,0,57,848,262,12,1179,9966,Sitio Arqueológico
20240315,2023,8,Cusco,Monumento Arqueologico de Moray,3,Marzo,0,0,0,0,0,172,4250,2366,110,6898,0,0,0,0,92,1444,414,16,1966,8864,Sitio Arqueológico
20240315,2023,8,Cusco,Monumento Arqueologico de Moray,3,Marzo,1,0,0,0,0,212,9297,312,68,9889,0,0,0,0,0,0,0,0,0,9889,Sitio Arqueológico
20240315,2023,8,Cusco,Monumento Arqueologico de Moray,3,Marzo,2,0,0,0,0,384,13547,2678,178,16787,0,0,0,0,92,1444,414,16,1966,18753,Sitio Arqueológico
20240315,2023,8,Cusco,Monumento Arqueologico de Moray,4,Abril,0,0,0,0,0,527,9323,336,14,10200,0,0,0,0,113,1282,624,9,2028,12228,Sitio Arqueológico
20240315,2023,8,Cusco,Monumento Arqueologico de Moray,4,Abril,1,0,0,0,0,1202,18551,585,289,20627,0,0,0,0,0,0,0,0,0,20627,Sitio Arqueológico
20240315,2023,8,Cusco,Monumento Arqueologico de Moray,4,Abril,2,0,0,0,0,1729,27874,921,303,30827,0,0,0,0,113,1282,624,9,2028,32855,Sitio Arqueológico
20240315,2023,8,Cusco,Monumento Arqueologico de Moray,5,Mayo,0,0,0,0,0,985,12645,1022,157,14809,0,0,0,0,130,1274,443,52,1899,16708,Sitio Arqueológico
20240315,2023,8,Cusco,Monumento Arqueologico de Moray,5,Mayo,1,0,0,0,0,1221,18999,718,79,21017,0,0,0,0,0,0,0,0,0,21017,Sitio Arqueológico
20240315,2023,8,Cusco,Monumento Arqueologico de Moray,5,Mayo,2,0,0,0,0,2206,31644,1740,236,35826,0,0,0,0,130,1274,443,52,1899,37725,Sitio Arqueológico
20240315,2023,8,Cusco,Monumento Arqueologico de Moray,6,Junio,0,0,0,0,0,1219,11749,1501,32,14501,0,0,0,0,122,1096,339,8,1565,16066,Sitio Arqueológico
20240315,2023,8,Cusco,Monumento Arqueologico de Moray,6,Junio,1,0,0,0,0,1320,18022,1140,33,20515,0,0,0,0,0,0,0,0,0,20515,Sitio Arqueológico
20240315,2023,8,Cusco,Monumento Arqueologico de Moray,6,Junio,2,0,0,0,0,2539,29771,2641,65,35016,0,0,0,0,122,1096,339,8,1565,36581,Sitio Arqueológico
20240315,2023,8,Cusco,Monumento Arqueologico de Moray,7,Julio,0,0,0,0,0,1164,14152,2575,212,18103,0,0,0,0,132,1737,576,52,2497,20600,Sitio Arqueológico
20240315,2023,8,Cusco,Monumento Arqueologico de Moray,7,Julio,1,0,0,0,0,1330,21801,1685,88,24904,0,0,0,0,0,0,0,0,0,24904,Sitio Arqueológico
20240315,2023,8,Cusco,Monumento Arqueologico de Moray,7,Julio,2,0,0,0,0,2494,35953,4260,300,43007,0,0,0,0,132,1737,576,52,2497,45504,Sitio Arqueológico
20240315,2023,8,Cusco,Monumento Arqueologico de Moray,8,Agosto,0,0,0,0,0,870,20509,2772,409,24560,0,0,0,0,169,1911,503,110,2693,27253,Sitio Arqueológico
20240315,2023,8,Cusco,Monumento Arqueologico de Moray,8,Agosto,1,0,0,0,0,1027,27721,1507,218,30473,0,0,0,0,0,0,0,0,0,30473,Sitio Arqueológico
20240315,2023,8,Cusco,Monumento Arqueologico de Moray,8,Agosto,2,0,0,0,0,1897,48230,4279,627,55033,0,0,0,0,169,1911,503,110,2693,57726,Sitio Arqueológico
20240315,2023,8,Cusco,Monumento Arqueologico de Moray,9,Setiembre,0,0,0,0,0,722,17507,2850,319,21398,0,0,0,0,145,1173,1213,106,2637,24035,Sitio Arqueológico
20240315,2023,8,Cusco,Monumento Arqueologico de Moray,9,Setiembre,1,0,0,0,0,907,27454,1286,101,29748,0,0,0,0,0,0,0,0,0,29748,Sitio Arqueológico
20240315,2023,8,Cusco,Monumento Arqueologico de Moray,9,Setiembre,2,0,0,0,0,1629,44961,4136,420,51146,0,0,0,0,145,1173,1213,106,2637,53783,Sitio Arqueológico
20240315,2023,8,Cusco,Monumento Arqueologico de Moray,10,Octubre,0,0,0,0,0,879,18200,5360,681,25120,0,0,0,0,215,1348,1033,172,2768,27888,Sitio Arqueológico
20240315,2023,8,Cusco,Monumento Arqueologico de Moray,10,Octubre,1,0,0,0,0,901,24791,2380,187,28259,0,0,0,0,0,0,0,0,0,28259,Sitio Arqueológico
20240315,2023,8,Cusco,Monumento Arqueologico de Moray,10,Octubre,2,0,0,0,0,1780,42991,7740,868,53379,0,0,0,0,215,1348,1033,172,2768,56147,Sitio Arqueológico
20240315,2023,8,Cusco,Monumento Arqueologico de Moray,11,Noviembre,0,0,0,0,0,828,16367,4660,504,22359,0,0,0,0,312,1082,1382,165,2941,25300,Sitio Arqueológico
20240315,2023,8,Cusco,Monumento Arqueologico de Moray,11,Noviembre,1,0,0,0,0,1060,22572,1123,113,24868,0,0,0,0,0,0,0,0,0,24868,Sitio Arqueológico
20240315,2023,8,Cusco,Monumento Arqueologico de Moray,11,Noviembre,2,0,0,0,0,1888,38939,5783,617,47227,0,0,0,0,312,1082,1382,165,2941,50168,Sitio Arqueológico
20240315,2023,8,Cusco,Monumento Arqueologico de Moray,12,Diciembre,0,0,0,0,0,679,15267,2406,173,18525,0,0,0,0,364,1090,943,127,2524,21049,Sitio Arqueológico
20240315,2023,8,Cusco,Monumento Arqueologico de Moray,12,Diciembre,1,0,0,0,0,921,22002,1167,108,24198,0,0,0,0,0,0,0,0,0,24198,Sitio Arqueológico
20240315,2023,8,Cusco,Monumento Arqueologico de Moray,12,Diciembre,2,0,0,0,0,1600,37269,3573,281,42723,0,0,0,0,364,1090,943,127,2524,45247,Sitio Arqueológico
20240315,2023,8,Cusco,Parque Arqueologico Tipon,1,Enero,0,0,0,0,0,0,831,179,0,1010,0,0,0,0,0,817,240,81,1138,2148,Sitio Arqueológico
20240315,2023,8,Cusco,Parque Arqueologico Tipon,1,Enero,1,0,0,0,0,0,240,28,0,268,0,0,0,0,0,0,0,0,0,268,Sitio Arqueológico
20240315,2023,8,Cusco,Parque Arqueologico Tipon,1,Enero,2,0,0,0,0,0,1071,207,0,1278,0,0,0,0,0,817,240,81,1138,2416,Sitio Arqueológico
20240315,2023,8,Cusco,Parque Arqueologico Tipon,2,Febrero,0,0,0,0,0,0,831,179,0,1010,0,0,0,0,242,817,240,81,1380,2390,Sitio Arqueológico
20240315,2023,8,Cusco,Parque Arqueologico Tipon,2,Febrero,1,0,0,0,0,0,240,28,0,268,0,0,0,0,0,0,0,0,0,268,Sitio Arqueológico
20240315,2023,8,Cusco,Parque Arqueologico Tipon,2,Febrero,2,0,0,0,0,0,1071,207,0,1278,0,0,0,0,242,817,240,81,1380,2658,Sitio Arqueológico
20240315,2023,8,Cusco,Parque Arqueologico Tipon,3,Marzo,0,0,0,0,0,0,101,1403,0,1504,0,0,0,0,272,1027,293,82,1674,3178,Sitio Arqueológico
20240315,2023,8,Cusco,Parque Arqueologico Tipon,3,Marzo,1,0,0,0,0,0,452,39,0,491,0,0,0,0,0,0,0,0,0,491,Sitio Arqueológico
20240315,2023,8,Cusco,Parque Arqueologico Tipon,3,Marzo,2,0,0,0,0,0,553,1442,0,1995,0,0,0,0,272,1027,293,82,1674,3669,Sitio Arqueológico
20240315,2023,8,Cusco,Parque Arqueologico Tipon,4,Abril,0,0,0,0,0,0,27,1949,0,1976,0,0,0,0,359,1095,339,98,1891,3867,Sitio Arqueológico
20240315,2023,8,Cusco,Parque Arqueologico Tipon,4,Abril,1,0,0,0,0,0,1190,84,0,1274,0,0,0,0,0,0,0,0,0,1274,Sitio Arqueológico
20240315,2023,8,Cusco,Parque Arqueologico Tipon,4,Abril,2,0,0,0,0,0,1217,2033,0,3250,0,0,0,0,359,1095,339,98,1891,5141,Sitio Arqueológico
20240315,2023,8,Cusco,Parque Arqueologico Tipon,5,Mayo,0,0,0,0,0,0,0,526,2597,3123,0,0,0,0,0,820,200,45,1065,4188,Sitio Arqueológico
20240315,2023,8,Cusco,Parque Arqueologico Tipon,5,Mayo,1,0,0,0,0,0,1565,53,0,1618,0,0,0,0,0,0,0,0,0,1618,Sitio Arqueológico
20240315,2023,8,Cusco,Parque Arqueologico Tipon,5,Mayo,2,0,0,0,0,0,1565,579,2597,4741,0,0,0,0,0,820,200,45,1065,5806,Sitio Arqueológico
20240315,2023,8,Cusco,Parque Arqueologico Tipon,6,Junio,0,0,0,0,0,0,2375,233,0,2608,0,0,0,0,228,844,314,226,1612,4220,Sitio Arqueológico
20240315,2023,8,Cusco,Parque Arqueologico Tipon,6,Junio,1,0,0,0,0,0,1554,114,0,1668,0,0,0,0,0,0,0,0,0,1668,Sitio Arqueológico
20240315,2023,8,Cusco,Parque Arqueologico Tipon,6,Junio,2,0,0,0,0,0,3929,347,0,4276,0,0,0,0,228,844,314,226,1612,5888,Sitio Arqueológico
20240315,2023,8,Cusco,Parque Arqueologico Tipon,7,Julio,0,0,0,0,0,0,3527,882,0,4409,0,0,0,0,209,1119,370,98,1796,6205,Sitio Arqueológico
20240315,2023,8,Cusco,Parque Arqueologico Tipon,7,Julio,1,0,0,0,0,0,1510,277,0,1787,0,0,0,0,0,0,0,0,0,1787,Sitio Arqueológico
20240315,2023,8,Cusco,Parque Arqueologico Tipon,7,Julio,2,0,0,0,0,0,5037,1159,0,6196,0,0,0,0,209,1119,370,98,1796,7992,Sitio Arqueológico
20240315,2023,8,Cusco,Parque Arqueologico Tipon,8,Agosto,0,0,0,0,0,0,4216,1040,0,5256,0,0,0,0,223,909,330,127,1589,6845,Sitio Arqueológico
20240315,2023,8,Cusco,Parque Arqueologico Tipon,8,Agosto,1,0,0,0,0,0,1378,145,0,1523,0,0,0,0,0,0,0,0,0,1523,Sitio Arqueológico
20240315,2023,8,Cusco,Parque Arqueologico Tipon,8,Agosto,2,0,0,0,0,0,5594,1185,0,6779,0,0,0,0,223,909,330,127,1589,8368,Sitio Arqueológico
20240315,2023,8,Cusco,Parque Arqueologico Tipon,9,Setiembre,0,0,0,0,0,0,3007,1102,0,4109,0,0,0,0,209,793,338,1714,3054,7163,Sitio Arqueológico
20240315,2023,8,Cusco,Parque Arqueologico Tipon,9,Setiembre,1,0,0,0,0,0,1427,158,0,1585,0,0,0,0,0,0,0,0,0,1585,Sitio Arqueológico
20240315,2023,8,Cusco,Parque Arqueologico Tipon,9,Setiembre,2,0,0,0,0,0,4434,1260,0,5694,0,0,0,0,209,793,338,1714,3054,8748,Sitio Arqueológico
20240315,2023,8,Cusco,Parque Arqueologico Tipon,10,Octubre,0,0,0,0,0,0,3002,1804,0,4806,0,0,0,0,261,870,368,377,1876,6682,Sitio Arqueológico
20240315,2023,8,Cusco,Parque Arqueologico Tipon,10,Octubre,1,0,0,0,0,0,0,110,1667,1777,0,0,0,0,0,0,0,0,0,1777,Sitio Arqueológico
20240315,2023,8,Cusco,Parque Arqueologico Tipon,10,Octubre,2,0,0,0,0,0,3002,1914,1667,6583,0,0,0,0,261,870,368,377,1876,8459,Sitio Arqueológico
20240315,2023,8,Cusco,Parque Arqueologico Tipon,11,Noviembre,0,0,0,0,0,0,2264,1326,0,3590,0,0,0,0,301,841,342,256,1740,5330,Sitio Arqueológico
20240315,2023,8,Cusco,Parque Arqueologico Tipon,11,Noviembre,1,0,0,0,0,0,1058,41,0,1099,0,0,0,0,0,0,0,0,0,1099,Sitio Arqueológico
20240315,2023,8,Cusco,Parque Arqueologico Tipon,11,Noviembre,2,0,0,0,0,0,3322,1367,0,4689,0,0,0,0,301,841,342,256,1740,6429,Sitio Arqueológico
20240315,2023,8,Cusco,Parque Arqueologico Tipon,12,Diciembre,0,0,0,0,0,0,2118,358,0,2476,0,0,0,0,235,911,316,191,1653,4129,Sitio Arqueológico
20240315,2023,8,Cusco,Parque Arqueologico Tipon,12,Diciembre,1,0,0,0,0,0,951,108,0,1059,0,0,0,0,0,0,0,0,0,1059,Sitio Arqueológico
20240315,2023,8,Cusco,Parque Arqueologico Tipon,12,Diciembre,2,0,0,0,0,0,3069,466,0,3535,0,0,0,0,235,911,316,191,1653,5188,Sitio Arqueológico
20240315,2023,8,Cusco,Monumento Arqueologico de Tarawasi,1,Enero,0,0,0,0,0,0,6,4,0,10,0,0,0,0,0,0,0,0,0,10,Sitio Arqueológico
20240315,2023,8,Cusco,Monumento Arqueologico de Tarawasi,1,Enero,1,0,0,0,0,0,0,0,0,0,0,0,0,0,0,0,0,0,0,0,Sitio Arqueológico
20240315,2023,8,Cusco,Monumento Arqueologico de Tarawasi,1,Enero,2,0,0,0,0,0,6,4,0,10,0,0,0,0,0,0,0,0,0,10,Sitio Arqueológico
20240315,2023,8,Cusco,Monumento Arqueologico de Tarawasi,2,Febrero,0,0,0,0,0,0,0,0,0,0,0,0,0,0,0,0,0,0,0,0,Sitio Arqueológico
20240315,2023,8,Cusco,Monumento Arqueologico de Tarawasi,2,Febrero,1,0,0,0,0,0,10,4,0,14,0,0,0,0,0,0,0,0,0,14,Sitio Arqueológico
20240315,2023,8,Cusco,Monumento Arqueologico de Tarawasi,2,Febrero,2,0,0,0,0,0,10,4,0,14,0,0,0,0,0,0,0,0,0,14,Sitio Arqueológico
20240315,2023,8,Cusco,Monumento Arqueologico de Tarawasi,3,Marzo,0,0,0,0,0,0,0,0,0,0,0,0,0,0,0,0,0,0,0,0,Sitio Arqueológico
20240315,2023,8,Cusco,Monumento Arqueologico de Tarawasi,3,Marzo,1,0,0,0,0,0,0,0,0,0,0,0,0,0,0,0,0,0,0,0,Sitio Arqueológico
20240315,2023,8,Cusco,Monumento Arqueologico de Tarawasi,3,Marzo,2,0,0,0,0,0,0,0,0,0,0,0,0,0,0,0,0,0,0,0,Sitio Arqueológico
20240315,2023,8,Cusco,Monumento Arqueologico de Tarawasi,4,Abril,0,0,0,0,0,0,0,0,0,0,0,0,0,0,0,0,0,0,0,0,Sitio Arqueológico
20240315,2023,8,Cusco,Monumento Arqueologico de Tarawasi,4,Abril,1,0,0,0,0,0,0,0,0,0,0,0,0,0,0,0,0,0,0,0,Sitio Arqueológico
20240315,2023,8,Cusco,Monumento Arqueologico de Tarawasi,4,Abril,2,0,0,0,0,0,0,0,0,0,0,0,0,0,0,0,0,0,0,0,Sitio Arqueológico
20240315,2023,8,Cusco,Monumento Arqueologico de Tarawasi,5,Mayo,0,0,0,0,0,0,0,0,0,0,0,0,0,0,0,0,0,0,0,0,Sitio Arqueológico
20240315,2023,8,Cusco,Monumento Arqueologico de Tarawasi,5,Mayo,1,0,0,0,0,0,0,0,0,0,0,0,0,0,0,0,0,0,0,0,Sitio Arqueológico
20240315,2023,8,Cusco,Monumento Arqueologico de Tarawasi,5,Mayo,2,0,0,0,0,0,0,0,0,0,0,0,0,0,0,0,0,0,0,0,Sitio Arqueológico
20240315,2023,8,Cusco,Monumento Arqueologico de Tarawasi,6,Junio,0,0,0,0,0,0,0,0,0,0,0,0,0,0,0,0,0,0,0,0,Sitio Arqueológico
20240315,2023,8,Cusco,Monumento Arqueologico de Tarawasi,6,Junio,1,0,0,0,0,0,0,0,0,0,0,0,0,0,0,0,0,0,0,0,Sitio Arqueológico
20240315,2023,8,Cusco,Monumento Arqueologico de Tarawasi,6,Junio,2,0,0,0,0,0,0,0,0,0,0,0,0,0,0,0,0,0,0,0,Sitio Arqueológico
20240315,2023,8,Cusco,Monumento Arqueologico de Tarawasi,7,Julio,0,0,0,0,0,0,0,0,0,0,0,0,0,0,0,0,0,0,0,0,Sitio Arqueológico
20240315,2023,8,Cusco,Monumento Arqueologico de Tarawasi,7,Julio,1,0,0,0,0,0,0,0,0,0,0,0,0,0,0,0,0,0,0,0,Sitio Arqueológico
20240315,2023,8,Cusco,Monumento Arqueologico de Tarawasi,7,Julio,2,0,0,0,0,0,0,0,0,0,0,0,0,0,0,0,0,0,0,0,Sitio Arqueológico
20240315,2023,8,Cusco,Monumento Arqueologico de Tarawasi,8,Agosto,0,0,0,0,0,0,0,0,0,0,0,0,0,0,0,0,0,0,0,0,Sitio Arqueológico
20240315,2023,8,Cusco,Monumento Arqueologico de Tarawasi,8,Agosto,1,0,0,0,0,0,0,0,0,0,0,0,0,0,0,0,0,0,0,0,Sitio Arqueológico
20240315,2023,8,Cusco,Monumento Arqueologico de Tarawasi,8,Agosto,2,0,0,0,0,0,0,0,0,0,0,0,0,0,0,0,0,0,0,0,Sitio Arqueológico
20240315,2023,8,Cusco,Monumento Arqueologico de Tarawasi,9,Setiembre,0,0,0,0,0,0,0,0,0,0,0,0,0,0,0,0,0,0,0,0,Sitio Arqueológico
20240315,2023,8,Cusco,Monumento Arqueologico de Tarawasi,9,Setiembre,1,0,0,0,0,0,0,0,0,0,0,0,0,0,0,0,0,0,0,0,Sitio Arqueológico
20240315,2023,8,Cusco,Monumento Arqueologico de Tarawasi,9,Setiembre,2,0,0,0,0,0,0,0,0,0,0,0,0,0,0,0,0,0,0,0,Sitio Arqueológico
20240315,2023,8,Cusco,Monumento Arqueologico de Tarawasi,10,Octubre,0,0,0,0,0,0,0,0,0,0,0,0,0,0,0,0,0,0,0,0,Sitio Arqueológico
20240315,2023,8,Cusco,Monumento Arqueologico de Tarawasi,10,Octubre,1,0,0,0,0,0,0,0,0,0,0,0,0,0,0,0,0,0,0,0,Sitio Arqueológico
20240315,2023,8,Cusco,Monumento Arqueologico de Tarawasi,10,Octubre,2,0,0,0,0,0,0,0,0,0,0,0,0,0,0,0,0,0,0,0,Sitio Arqueológico
20240315,2023,8,Cusco,Monumento Arqueologico de Tarawasi,11,Noviembre,0,0,0,0,0,0,0,0,0,0,0,0,0,0,0,0,0,0,0,0,Sitio Arqueológico
20240315,2023,8,Cusco,Monumento Arqueologico de Tarawasi,11,Noviembre,1,0,0,0,0,0,0,0,0,0,0,0,0,0,0,0,0,0,0,0,Sitio Arqueológico
20240315,2023,8,Cusco,Monumento Arqueologico de Tarawasi,11,Noviembre,2,0,0,0,0,0,0,0,0,0,0,0,0,0,0,0,0,0,0,0,Sitio Arqueológico
20240315,2023,8,Cusco,Monumento Arqueologico de Tarawasi,12,Diciembre,0,0,0,0,0,0,0,0,0,0,0,0,0,0,0,0,0,0,0,0,Sitio Arqueológico
20240315,2023,8,Cusco,Monumento Arqueologico de Tarawasi,12,Diciembre,1,0,0,0,0,0,0,0,0,0,0,0,0,0,0,0,0,0,0,0,Sitio Arqueológico
20240315,2023,8,Cusco,Monumento Arqueologico de Tarawasi,12,Diciembre,2,0,0,0,0,0,0,0,0,0,0,0,0,0,0,0,0,0,0,0,Sitio Arqueológico
20240315,2023,8,Cusco,Parque Arqueologico Nacional de Vilcabamba (Choquequirao),1,Enero,0,0,0,0,0,0,0,0,0,0,0,0,0,0,0,0,0,0,0,0,Sitio Arqueológico
20240315,2023,8,Cusco,Parque Arqueologico Nacional de Vilcabamba (Choquequirao),1,Enero,1,0,0,0,0,0,0,0,0,0,0,0,0,0,0,0,0,0,0,0,Sitio Arqueológico
20240315,2023,8,Cusco,Parque Arqueologico Nacional de Vilcabamba (Choquequirao),1,Enero,2,0,0,0,0,0,0,0,0,0,0,0,0,0,0,0,0,0,0,0,Sitio Arqueológico
20240315,2023,8,Cusco,Parque Arqueologico Nacional de Vilcabamba (Choquequirao),2,Febrero,0,0,0,0,0,0,0,0,0,0,0,0,0,0,0,0,0,0,0,0,Sitio Arqueológico
20240315,2023,8,Cusco,Parque Arqueologico Nacional de Vilcabamba (Choquequirao),2,Febrero,1,0,0,0,0,0,0,0,0,0,0,0,0,0,0,0,0,0,0,0,Sitio Arqueológico
20240315,2023,8,Cusco,Parque Arqueologico Nacional de Vilcabamba (Choquequirao),2,Febrero,2,0,0,0,0,0,0,0,0,0,0,0,0,0,0,0,0,0,0,0,Sitio Arqueológico
20240315,2023,8,Cusco,Parque Arqueologico Nacional de Vilcabamba (Choquequirao),3,Marzo,0,0,0,0,0,0,17,19,0,36,0,0,0,0,0,0,0,0,0,36,Sitio Arqueológico
20240315,2023,8,Cusco,Parque Arqueologico Nacional de Vilcabamba (Choquequirao),3,Marzo,1,0,0,0,0,0,17,7,0,24,0,0,0,0,0,0,0,0,0,24,Sitio Arqueológico
20240315,2023,8,Cusco,Parque Arqueologico Nacional de Vilcabamba (Choquequirao),3,Marzo,2,0,0,0,0,0,34,26,0,60,0,0,0,0,0,0,0,0,0,60,Sitio Arqueológico
20240315,2023,8,Cusco,Parque Arqueologico Nacional de Vilcabamba (Choquequirao),4,Abril,0,0,0,0,0,0,243,93,0,336,0,0,0,0,0,15,48,0,63,399,Sitio Arqueológico
20240315,2023,8,Cusco,Parque Arqueologico Nacional de Vilcabamba (Choquequirao),4,Abril,1,0,0,0,0,0,155,51,0,206,0,0,0,0,0,0,0,0,0,206,Sitio Arqueológico
20240315,2023,8,Cusco,Parque Arqueologico Nacional de Vilcabamba (Choquequirao),4,Abril,2,0,0,0,0,0,398,144,0,542,0,0,0,0,0,15,48,0,63,605,Sitio Arqueológico
20240315,2023,8,Cusco,Parque Arqueologico Nacional de Vilcabamba (Choquequirao),5,Mayo,0,0,0,0,0,0,94,75,0,169,0,0,0,0,0,9,14,0,23,192,Sitio Arqueológico
20240315,2023,8,Cusco,Parque Arqueologico Nacional de Vilcabamba (Choquequirao),5,Mayo,1,0,0,0,0,0,200,93,0,293,0,0,0,0,0,0,0,0,0,293,Sitio Arqueológico
20240315,2023,8,Cusco,Parque Arqueologico Nacional de Vilcabamba (Choquequirao),5,Mayo,2,0,0,0,0,0,294,168,0,462,0,0,0,0,0,9,14,0,23,485,Sitio Arqueológico
20240315,2023,8,Cusco,Parque Arqueologico Nacional de Vilcabamba (Choquequirao),6,Junio,0,0,0,0,0,0,158,94,0,252,0,0,0,0,0,8,7,0,15,267,Sitio Arqueológico
20240315,2023,8,Cusco,Parque Arqueologico Nacional de Vilcabamba (Choquequirao),6,Junio,1,0,0,0,0,0,208,31,0,239,0,0,0,0,0,0,0,0,0,239,Sitio Arqueológico
20240315,2023,8,Cusco,Parque Arqueologico Nacional de Vilcabamba (Choquequirao),6,Junio,2,0,0,0,0,0,366,125,0,491,0,0,0,0,0,8,7,0,15,506,Sitio Arqueológico
20240315,2023,8,Cusco,Parque Arqueologico Nacional de Vilcabamba (Choquequirao),7,Julio,0,0,0,0,0,0,339,319,0,658,0,0,0,0,0,27,23,0,50,708,Sitio Arqueológico
20240315,2023,8,Cusco,Parque Arqueologico Nacional de Vilcabamba (Choquequirao),7,Julio,1,0,0,0,0,0,286,68,0,354,0,0,0,0,0,0,0,0,0,354,Sitio Arqueológico
20240315,2023,8,Cusco,Parque Arqueologico Nacional de Vilcabamba (Choquequirao),7,Julio,2,0,0,0,0,0,625,387,0,1012,0,0,0,0,0,27,23,0,50,1062,Sitio Arqueológico
20240315,2023,8,Cusco,Parque Arqueologico Nacional de Vilcabamba (Choquequirao),8,Agosto,0,0,0,0,0,0,223,208,0,431,0,0,0,0,0,0,8,25,33,464,Sitio Arqueológico
20240315,2023,8,Cusco,Parque Arqueologico Nacional de Vilcabamba (Choquequirao),8,Agosto,1,0,0,0,0,0,271,63,0,334,0,0,0,0,0,0,0,0,0,334,Sitio Arqueológico
20240315,2023,8,Cusco,Parque Arqueologico Nacional de Vilcabamba (Choquequirao),8,Agosto,2,0,0,0,0,0,494,271,0,765,0,0,0,0,0,0,8,25,33,798,Sitio Arqueológico
20240315,2023,8,Cusco,Parque Arqueologico Nacional de Vilcabamba (Choquequirao),9,Setiembre,0,0,0,0,0,0,82,73,0,155,0,0,0,0,0,12,48,0,60,215,Sitio Arqueológico
20240315,2023,8,Cusco,Parque Arqueologico Nacional de Vilcabamba (Choquequirao),9,Setiembre,1,0,0,0,0,0,239,13,0,252,0,0,0,0,0,0,0,0,0,252,Sitio Arqueológico
20240315,2023,8,Cusco,Parque Arqueologico Nacional de Vilcabamba (Choquequirao),9,Setiembre,2,0,0,0,0,0,321,86,0,407,0,0,0,0,0,12,48,0,60,467,Sitio Arqueológico
20240315,2023,8,Cusco,Parque Arqueologico Nacional de Vilcabamba (Choquequirao),10,Octubre,0,0,0,0,0,0,174,88,0,262,0,0,0,0,0,22,9,0,31,293,Sitio Arqueológico
20240315,2023,8,Cusco,Parque Arqueologico Nacional de Vilcabamba (Choquequirao),10,Octubre,1,0,0,0,0,0,266,48,0,314,0,0,0,0,0,0,0,0,0,314,Sitio Arqueológico
20240315,2023,8,Cusco,Parque Arqueologico Nacional de Vilcabamba (Choquequirao),10,Octubre,2,0,0,0,0,0,440,136,0,576,0,0,0,0,0,22,9,0,31,607,Sitio Arqueológico
20240315,2023,8,Cusco,Parque Arqueologico Nacional de Vilcabamba (Choquequirao),11,Noviembre,0,0,0,0,0,0,56,82,0,138,0,0,0,0,0,16,11,0,27,165,Sitio Arqueológico
20240315,2023,8,Cusco,Parque Arqueologico Nacional de Vilcabamba (Choquequirao),11,Noviembre,1,0,0,0,0,0,179,39,0,218,0,0,0,0,0,0,0,0,0,218,Sitio Arqueológico
20240315,2023,8,Cusco,Parque Arqueologico Nacional de Vilcabamba (Choquequirao),11,Noviembre,2,0,0,0,0,0,235,121,0,356,0,0,0,0,0,16,11,0,27,383,Sitio Arqueológico
20240315,2023,8,Cusco,Parque Arqueologico Nacional de Vilcabamba (Choquequirao),12,Diciembre,0,0,0,0,0,0,63,60,0,123,0,0,0,0,0,0,0,0,0,123,Sitio Arqueológico
20240315,2023,8,Cusco,Parque Arqueologico Nacional de Vilcabamba (Choquequirao),12,Diciembre,1,0,0,0,0,0,109,27,0,136,0,0,0,0,0,0,0,0,0,136,Sitio Arqueológico
20240315,2023,8,Cusco,Parque Arqueologico Nacional de Vilcabamba (Choquequirao),12,Diciembre,2,0,0,0,0,0,172,87,0,259,0,0,0,0,0,0,0,0,0,259,Sitio Arqueológico
20240315,2023,8,Cusco,Conjunto Arqueologico de Huchuy Qosco,1,Enero,0,0,0,0,0,0,15,0,0,15,0,0,0,0,0,0,0,0,0,15,Sitio Arqueológico
20240315,2023,8,Cusco,Conjunto Arqueologico de Huchuy Qosco,1,Enero,1,0,0,0,0,0,50,0,0,50,0,0,0,0,0,0,0,0,0,50,Sitio Arqueológico
20240315,2023,8,Cusco,Conjunto Arqueologico de Huchuy Qosco,1,Enero,2,0,0,0,0,0,65,0,0,65,0,0,0,0,0,0,0,0,0,65,Sitio Arqueológico
20240315,2023,8,Cusco,Conjunto Arqueologico de Huchuy Qosco,2,Febrero,0,0,0,0,0,0,16,0,0,16,0,0,0,0,0,96,215,16,327,343,Sitio Arqueológico
20240315,2023,8,Cusco,Conjunto Arqueologico de Huchuy Qosco,2,Febrero,1,0,0,0,0,0,78,0,0,78,0,0,0,0,0,0,0,0,0,78,Sitio Arqueológico
20240315,2023,8,Cusco,Conjunto Arqueologico de Huchuy Qosco,2,Febrero,2,0,0,0,0,0,94,0,0,94,0,0,0,0,0,96,215,16,327,421,Sitio Arqueológico
20240315,2023,8,Cusco,Conjunto Arqueologico de Huchuy Qosco,3,Marzo,0,0,0,0,0,0,39,0,0,39,0,0,0,0,0,0,0,0,0,39,Sitio Arqueológico
20240315,2023,8,Cusco,Conjunto Arqueologico de Huchuy Qosco,3,Marzo,1,0,0,0,0,0,0,0,0,0,0,0,0,0,0,0,0,0,0,0,Sitio Arqueológico
20240315,2023,8,Cusco,Conjunto Arqueologico de Huchuy Qosco,3,Marzo,2,0,0,0,0,0,39,0,0,39,0,0,0,0,0,0,0,0,0,39,Sitio Arqueológico
20240315,2023,8,Cusco,Conjunto Arqueologico de Huchuy Qosco,4,Abril,0,0,0,0,0,0,47,0,0,47,0,0,0,0,0,119,119,21,259,306,Sitio Arqueológico
20240315,2023,8,Cusco,Conjunto Arqueologico de Huchuy Qosco,4,Abril,1,0,0,0,0,0,57,0,0,57,0,0,0,0,0,0,0,0,0,57,Sitio Arqueológico
20240315,2023,8,Cusco,Conjunto Arqueologico de Huchuy Qosco,4,Abril,2,0,0,0,0,0,104,0,0,104,0,0,0,0,0,119,119,21,259,363,Sitio Arqueológico
20240315,2023,8,Cusco,Conjunto Arqueologico de Huchuy Qosco,5,Mayo,0,0,0,0,0,0,49,0,0,49,0,0,0,0,0,163,97,15,275,324,Sitio Arqueológico
20240315,2023,8,Cusco,Conjunto Arqueologico de Huchuy Qosco,5,Mayo,1,0,0,0,0,0,78,0,0,78,0,0,0,0,0,0,0,0,0,78,Sitio Arqueológico
20240315,2023,8,Cusco,Conjunto Arqueologico de Huchuy Qosco,5,Mayo,2,0,0,0,0,0,127,0,0,127,0,0,0,0,0,163,97,15,275,402,Sitio Arqueológico
20240315,2023,8,Cusco,Conjunto Arqueologico de Huchuy Qosco,6,Junio,0,0,0,0,0,0,48,0,0,48,0,0,0,0,0,92,83,18,193,241,Sitio Arqueológico
20240315,2023,8,Cusco,Conjunto Arqueologico de Huchuy Qosco,6,Junio,1,0,0,0,0,0,86,0,0,86,0,0,0,0,0,0,0,0,0,86,Sitio Arqueológico
20240315,2023,8,Cusco,Conjunto Arqueologico de Huchuy Qosco,6,Junio,2,0,0,0,0,0,134,0,0,134,0,0,0,0,0,92,83,18,193,327,Sitio Arqueológico
20240315,2023,8,Cusco,Conjunto Arqueologico de Huchuy Qosco,7,Julio,0,0,0,0,0,0,59,0,0,59,0,0,0,0,0,103,146,23,272,331,Sitio Arqueológico
20240315,2023,8,Cusco,Conjunto Arqueologico de Huchuy Qosco,7,Julio,1,0,0,0,0,0,91,0,0,91,0,0,0,0,0,0,0,0,0,91,Sitio Arqueológico
20240315,2023,8,Cusco,Conjunto Arqueologico de Huchuy Qosco,7,Julio,2,0,0,0,0,0,150,0,0,150,0,0,0,0,0,103,146,23,272,422,Sitio Arqueológico
20240315,2023,8,Cusco,Conjunto Arqueologico de Huchuy Qosco,8,Agosto,0,0,0,0,0,0,59,0,0,59,0,0,0,0,0,181,100,15,296,355,Sitio Arqueológico
20240315,2023,8,Cusco,Conjunto Arqueologico de Huchuy Qosco,8,Agosto,1,0,0,0,0,0,0,0,155,155,0,0,0,0,0,0,0,0,0,155,Sitio Arqueológico
20240315,2023,8,Cusco,Conjunto Arqueologico de Huchuy Qosco,8,Agosto,2,0,0,0,0,0,59,0,155,214,0,0,0,0,0,181,100,15,296,510,Sitio Arqueológico
20240315,2023,8,Cusco,Conjunto Arqueologico de Huchuy Qosco,9,Setiembre,0,0,0,0,0,0,39,0,0,39,0,0,0,0,0,189,215,37,441,480,Sitio Arqueológico
20240315,2023,8,Cusco,Conjunto Arqueologico de Huchuy Qosco,9,Setiembre,1,0,0,0,0,0,151,0,0,151,0,0,0,0,0,0,0,0,0,151,Sitio Arqueológico
20240315,2023,8,Cusco,Conjunto Arqueologico de Huchuy Qosco,9,Setiembre,2,0,0,0,0,0,190,0,0,190,0,0,0,0,0,189,215,37,441,631,Sitio Arqueológico
20240315,2023,8,Cusco,Conjunto Arqueologico de Huchuy Qosco,10,Octubre,0,0,0,0,0,0,35,0,0,35,0,0,0,0,0,75,89,16,180,215,Sitio Arqueológico
20240315,2023,8,Cusco,Conjunto Arqueologico de Huchuy Qosco,10,Octubre,1,0,0,0,0,0,120,0,0,120,0,0,0,0,0,0,0,0,0,120,Sitio Arqueológico
20240315,2023,8,Cusco,Conjunto Arqueologico de Huchuy Qosco,10,Octubre,2,0,0,0,0,0,155,0,0,155,0,0,0,0,0,75,89,16,180,335,Sitio Arqueológico
20240315,2023,8,Cusco,Conjunto Arqueologico de Huchuy Qosco,11,Noviembre,0,0,0,0,0,0,52,0,0,52,0,0,0,0,0,84,86,17,187,239,Sitio Arqueológico
20240315,2023,8,Cusco,Conjunto Arqueologico de Huchuy Qosco,11,Noviembre,1,0,0,0,0,0,137,0,0,137,0,0,0,0,0,0,0,0,0,137,Sitio Arqueológico
20240315,2023,8,Cusco,Conjunto Arqueologico de Huchuy Qosco,11,Noviembre,2,0,0,0,0,0,189,0,0,189,0,0,0,0,0,84,86,17,187,376,Sitio Arqueológico
20240315,2023,8,Cusco,Conjunto Arqueologico de Huchuy Qosco,12,Diciembre,0,0,0,0,0,0,14,0,0,14,0,0,0,0,0,87,95,21,203,217,Sitio Arqueológico
20240315,2023,8,Cusco,Conjunto Arqueologico de Huchuy Qosco,12,Diciembre,1,0,0,0,0,0,62,0,0,62,0,0,0,0,0,0,0,0,0,62,Sitio Arqueológico
20240315,2023,8,Cusco,Conjunto Arqueologico de Huchuy Qosco,12,Diciembre,2,0,0,0,0,0,76,0,0,76,0,0,0,0,0,87,95,21,203,279,Sitio Arqueológico
20240315,2023,8,Cusco,Parque Arqueologico Machu Picchu,1,Enero,0,0,0,0,0,0,6064,224,1159,7447,0,0,0,0,0,736,0,0,736,8183,Sitio Arqueológico
20240315,2023,8,Cusco,Parque Arqueologico Machu Picchu,1,Enero,1,0,0,0,0,0,10355,248,732,11335,0,0,0,0,0,0,0,0,0,11335,Sitio Arqueológico
20240315,2023,8,Cusco,Parque Arqueologico Machu Picchu,1,Enero,2,0,0,0,0,0,16419,472,1891,18782,0,0,0,0,0,736,0,0,736,19518,Sitio Arqueológico
20240315,2023,8,Cusco,Parque Arqueologico Machu Picchu,2,Febrero,0,0,0,0,0,0,4546,183,1272,6001,0,0,0,0,0,1503,0,0,1503,7504,Sitio Arqueológico
20240315,2023,8,Cusco,Parque Arqueologico Machu Picchu,2,Febrero,1,0,0,0,0,0,4108,106,819,5033,0,0,0,0,0,0,0,0,0,5033,Sitio Arqueológico
20240315,2023,8,Cusco,Parque Arqueologico Machu Picchu,2,Febrero,2,0,0,0,0,0,8654,289,2091,11034,0,0,0,0,0,1503,0,0,1503,12537,Sitio Arqueológico
20240315,2023,8,Cusco,Parque Arqueologico Machu Picchu,3,Marzo,0,0,0,0,0,0,10729,478,1718,12925,0,0,0,0,0,2868,0,0,2868,15793,Sitio Arqueológico
20240315,2023,8,Cusco,Parque Arqueologico Machu Picchu,3,Marzo,1,0,0,0,0,0,21252,341,809,22402,0,0,0,0,0,0,0,0,0,22402,Sitio Arqueológico
20240315,2023,8,Cusco,Parque Arqueologico Machu Picchu,3,Marzo,2,0,0,0,0,0,31981,819,2527,35327,0,0,0,0,0,2868,0,0,2868,38195,Sitio Arqueológico
20240315,2023,8,Cusco,Parque Arqueologico Machu Picchu,4,Abril,0,0,0,0,0,0,16166,566,1902,18634,0,0,0,0,0,2665,0,0,2665,21299,Sitio Arqueológico
20240315,2023,8,Cusco,Parque Arqueologico Machu Picchu,4,Abril,1,0,0,0,0,0,44137,565,2196,46898,0,0,0,0,0,0,0,0,0,46898,Sitio Arqueológico
20240315,2023,8,Cusco,Parque Arqueologico Machu Picchu,4,Abril,2,0,0,0,0,0,60303,1131,4098,65532,0,0,0,0,0,2665,0,0,2665,68197,Sitio Arqueológico
20240315,2023,8,Cusco,Parque Arqueologico Machu Picchu,5,Mayo,0,0,0,0,0,0,18606,598,3427,22631,0,0,0,0,0,1984,0,0,1984,24615,Sitio Arqueológico
20240315,2023,8,Cusco,Parque Arqueologico Machu Picchu,5,Mayo,1,0,0,0,0,0,53508,805,1249,55562,0,0,0,0,0,0,0,0,0,55562,Sitio Arqueológico
20240315,2023,8,Cusco,Parque Arqueologico Machu Picchu,5,Mayo,2,0,0,0,0,0,72114,1403,4676,78193,0,0,0,0,0,1984,0,0,1984,80177,Sitio Arqueológico
20240315,2023,8,Cusco,Parque Arqueologico Machu Picchu,6,Junio,0,0,0,0,0,0,20625,845,2343,23813,0,0,0,0,0,1756,0,0,1756,25569,Sitio Arqueológico
20240315,2023,8,Cusco,Parque Arqueologico Machu Picchu,6,Junio,1,0,0,0,0,0,53944,1241,3602,58787,0,0,0,0,0,0,0,0,0,58787,Sitio Arqueológico
20240315,2023,8,Cusco,Parque Arqueologico Machu Picchu,6,Junio,2,0,0,0,0,0,74569,2086,5945,82600,0,0,0,0,0,1756,0,0,1756,84356,Sitio Arqueológico
20240315,2023,8,Cusco,Parque Arqueologico Machu Picchu,7,Julio,0,0,0,0,0,0,25625,2319,5874,33818,0,0,0,0,0,2926,0,0,2926,36744,Sitio Arqueológico
20240315,2023,8,Cusco,Parque Arqueologico Machu Picchu,7,Julio,1,0,0,0,0,0,61893,2132,7258,71283,0,0,0,0,0,0,0,0,0,71283,Sitio Arqueológico
20240315,2023,8,Cusco,Parque Arqueologico Machu Picchu,7,Julio,2,0,0,0,0,0,87518,4451,13132,105101,0,0,0,0,0,2926,0,0,2926,108027,Sitio Arqueológico
20240315,2023,8,Cusco,Parque Arqueologico Machu Picchu,8,Agosto,0,0,0,0,0,0,30014,1302,5793,37109,0,0,0,0,0,2279,0,0,2279,39388,Sitio Arqueológico
20240315,2023,8,Cusco,Parque Arqueologico Machu Picchu,8,Agosto,1,0,0,0,0,0,62564,1386,4438,68388,0,0,0,0,0,0,0,0,0,68388,Sitio Arqueológico
20240315,2023,8,Cusco,Parque Arqueologico Machu Picchu,8,Agosto,2,0,0,0,0,0,92578,2688,10231,105497,0,0,0,0,0,2279,0,0,2279,107776,Sitio Arqueológico
20240315,2023,8,Cusco,Parque Arqueologico Machu Picchu,9,Setiembre,0,0,0,0,0,0,19722,418,4640,24780,0,0,0,0,0,2620,0,0,2620,27400,Sitio Arqueológico
20240315,2023,8,Cusco,Parque Arqueologico Machu Picchu,9,Setiembre,1,0,0,0,0,0,71005,838,1518,73361,0,0,0,0,0,0,0,0,0,73361,Sitio Arqueológico
20240315,2023,8,Cusco,Parque Arqueologico Machu Picchu,9,Setiembre,2,0,0,0,0,0,90727,1256,6158,98141,0,0,0,0,0,2620,0,0,2620,100761,Sitio Arqueológico
20240315,2023,8,Cusco,Parque Arqueologico Machu Picchu,10,Octubre,0,0,0,0,0,0,20548,736,10297,31581,0,0,0,0,0,3267,0,0,3267,34848,Sitio Arqueológico
20240315,2023,8,Cusco,Parque Arqueologico Machu Picchu,10,Octubre,1,0,0,0,0,0,70768,787,1997,73552,0,0,0,0,0,0,0,0,0,73552,Sitio Arqueológico
20240315,2023,8,Cusco,Parque Arqueologico Machu Picchu,10,Octubre,2,0,0,0,0,0,91316,1523,12294,105133,0,0,0,0,0,3267,0,0,3267,108400,Sitio Arqueológico
20240315,2023,8,Cusco,Parque Arqueologico Machu Picchu,11,Noviembre,0,0,0,0,0,0,16555,714,6610,23879,0,0,0,0,0,4122,0,0,4122,28001,Sitio Arqueológico
20240315,2023,8,Cusco,Parque Arqueologico Machu Picchu,11,Noviembre,1,0,0,0,0,0,66384,826,2284,69494,0,0,0,0,0,0,0,0,0,69494,Sitio Arqueológico
20240315,2023,8,Cusco,Parque Arqueologico Machu Picchu,11,Noviembre,2,0,0,0,0,0,82939,1540,8894,93373,0,0,0,0,0,4122,0,0,4122,97495,Sitio Arqueológico
20240315,2023,8,Cusco,Parque Arqueologico Machu Picchu,12,Diciembre,0,0,0,0,0,0,15786,764,2836,19386,0,0,0,0,0,3572,0,0,3572,22958,Sitio Arqueológico
20240315,2023,8,Cusco,Parque Arqueologico Machu Picchu,12,Diciembre,1,0,0,0,0,0,3419,1519,51764,56702,0,0,0,0,0,0,0,0,0,56702,Sitio Arqueológico
20240315,2023,8,Cusco,Parque Arqueologico Machu Picchu,12,Diciembre,2,0,0,0,0,0,19205,2283,54600,76088,0,0,0,0,0,3572,0,0,3572,79660,Sitio Arqueológico
20240315,2023,8,Cusco,Santuario Historico de Machu Picchu,1,Enero,0,0,0,0,0,0,2,0,0,2,0,0,0,0,0,236,25,0,261,263,Sitio Arqueológico
20240315,2023,8,Cusco,Santuario Historico de Machu Picchu,1,Enero,1,0,0,0,0,0,7,0,0,7,0,0,0,0,0,301,4,0,305,312,Sitio Arqueológico
20240315,2023,8,Cusco,Santuario Historico de Machu Picchu,1,Enero,2,0,0,0,0,0,9,0,0,9,0,0,0,0,0,537,29,0,566,575,Sitio Arqueológico
20240315,2023,8,Cusco,Santuario Historico de Machu Picchu,2,Febrero,0,0,0,0,0,0,0,0,0,0,0,0,0,0,0,245,59,0,304,304,Sitio Arqueológico
20240315,2023,8,Cusco,Santuario Historico de Machu Picchu,2,Febrero,1,0,0,0,0,0,4,0,0,4,0,0,0,0,0,168,7,0,175,179,Sitio Arqueológico
20240315,2023,8,Cusco,Santuario Historico de Machu Picchu,2,Febrero,2,0,0,0,0,0,4,0,0,4,0,0,0,0,0,413,66,0,479,483,Sitio Arqueológico
20240315,2023,8,Cusco,Santuario Historico de Machu Picchu,3,Marzo,0,0,0,0,0,0,5,0,0,5,0,0,0,0,0,523,63,0,586,591,Sitio Arqueológico
20240315,2023,8,Cusco,Santuario Historico de Machu Picchu,3,Marzo,1,0,0,0,0,0,26,1,0,27,0,0,0,0,0,589,5,0,594,621,Sitio Arqueológico
20240315,2023,8,Cusco,Santuario Historico de Machu Picchu,3,Marzo,2,0,0,0,0,0,31,1,0,32,0,0,0,0,0,1112,68,0,1180,1212,Sitio Arqueológico
20240315,2023,8,Cusco,Santuario Historico de Machu Picchu,4,Abril,0,0,0,0,0,0,5,1,0,6,0,0,0,0,0,580,77,0,657,663,Sitio Arqueológico
20240315,2023,8,Cusco,Santuario Historico de Machu Picchu,4,Abril,1,0,0,0,0,0,60,0,0,60,0,0,0,0,0,917,8,0,925,985,Sitio Arqueológico
20240315,2023,8,Cusco,Santuario Historico de Machu Picchu,4,Abril,2,0,0,0,0,0,65,1,0,66,0,0,0,0,0,1497,85,0,1582,1648,Sitio Arqueológico
20240315,2023,8,Cusco,Santuario Historico de Machu Picchu,5,Mayo,0,0,0,0,0,0,3,0,0,3,0,0,0,0,0,475,85,0,560,563,Sitio Arqueológico
20240315,2023,8,Cusco,Santuario Historico de Machu Picchu,5,Mayo,1,0,0,0,0,0,79,2,0,81,0,0,0,0,0,965,20,0,985,1066,Sitio Arqueológico
20240315,2023,8,Cusco,Santuario Historico de Machu Picchu,5,Mayo,2,0,0,0,0,0,82,2,0,84,0,0,0,0,0,1440,105,0,1545,1629,Sitio Arqueológico
20240315,2023,8,Cusco,Santuario Historico de Machu Picchu,6,Junio,0,0,0,0,0,0,14,0,0,14,0,0,0,0,0,264,244,4,512,526,Sitio Arqueológico
20240315,2023,8,Cusco,Santuario Historico de Machu Picchu,6,Junio,1,0,0,0,0,0,50,5,0,55,0,0,0,0,0,781,14,0,795,850,Sitio Arqueológico
20240315,2023,8,Cusco,Santuario Historico de Machu Picchu,6,Junio,2,0,0,0,0,0,64,5,0,69,0,0,0,0,0,1045,258,4,1307,1376,Sitio Arqueológico
20240315,2023,8,Cusco,Santuario Historico de Machu Picchu,7,Julio,0,0,0,0,0,0,16,1,0,17,0,0,0,0,0,448,237,5,690,707,Sitio Arqueológico
20240315,2023,8,Cusco,Santuario Historico de Machu Picchu,7,Julio,1,0,0,0,0,0,116,6,0,122,0,0,0,0,0,917,46,0,963,1085,Sitio Arqueológico
20240315,2023,8,Cusco,Santuario Historico de Machu Picchu,7,Julio,2,0,0,0,0,0,132,7,0,139,0,0,0,0,0,1365,283,5,1653,1792,Sitio Arqueológico
20240315,2023,8,Cusco,Santuario Historico de Machu Picchu,8,Agosto,0,0,0,0,0,0,26,3,0,29,0,0,0,0,0,522,168,4,694,723,Sitio Arqueológico
20240315,2023,8,Cusco,Santuario Historico de Machu Picchu,8,Agosto,1,0,0,0,0,0,124,6,0,130,0,0,0,0,0,873,14,0,887,1017,Sitio Arqueológico
20240315,2023,8,Cusco,Santuario Historico de Machu Picchu,8,Agosto,2,0,0,0,0,0,150,9,0,159,0,0,0,0,0,1395,182,4,1581,1740,Sitio Arqueológico
20240315,2023,8,Cusco,Santuario Historico de Machu Picchu,9,Setiembre,0,0,0,0,0,0,23,3,0,26,0,0,0,0,0,341,93,9,443,469,Sitio Arqueológico
20240315,2023,8,Cusco,Santuario Historico de Machu Picchu,9,Setiembre,1,0,0,0,0,0,126,3,0,129,0,0,0,0,0,765,13,0,778,907,Sitio Arqueológico
20240315,2023,8,Cusco,Santuario Historico de Machu Picchu,9,Setiembre,2,0,0,0,0,0,149,6,0,155,0,0,0,0,0,1106,106,9,1221,1376,Sitio Arqueológico
20240315,2023,8,Cusco,Santuario Historico de Machu Picchu,10,Octubre,0,0,0,0,0,0,28,2,0,30,0,0,0,0,0,358,189,20,567,597,Sitio Arqueológico
20240315,2023,8,Cusco,Santuario Historico de Machu Picchu,10,Octubre,1,0,0,0,0,0,147,5,0,152,0,0,0,0,0,678,3,0,681,833,Sitio Arqueológico
20240315,2023,8,Cusco,Santuario Historico de Machu Picchu,10,Octubre,2,0,0,0,0,0,175,7,0,182,0,0,0,0,0,1036,192,20,1248,1430,Sitio Arqueológico
20240315,2023,8,Cusco,Santuario Historico de Machu Picchu,11,Noviembre,0,0,0,0,0,0,10,8,0,18,0,0,0,0,0,293,244,3,540,558,Sitio Arqueológico
20240315,2023,8,Cusco,Santuario Historico de Machu Picchu,11,Noviembre,1,0,0,0,0,0,131,2,0,133,0,0,0,0,0,609,12,0,621,754,Sitio Arqueológico
20240315,2023,8,Cusco,Santuario Historico de Machu Picchu,11,Noviembre,2,0,0,0,0,0,141,10,0,151,0,0,0,0,0,902,256,3,1161,1312,Sitio Arqueológico
20240315,2023,8,Cusco,Santuario Historico de Machu Picchu,12,Diciembre,0,0,0,0,0,0,10,0,0,10,0,0,0,0,0,312,115,4,431,441,Sitio Arqueológico
20240315,2023,8,Cusco,Santuario Historico de Machu Picchu,12,Diciembre,1,0,0,0,0,0,99,4,0,103,0,0,0,0,0,638,14,0,652,755,Sitio Arqueológico
20240315,2023,8,Cusco,Santuario Historico de Machu Picchu,12,Diciembre,2,0,0,0,0,0,109,4,0,113,0,0,0,0,0,950,129,4,1083,1196,Sitio Arqueológico
20240315,2023,8,Cusco,Parque Arqueologico Macchu Picchu (Ingreso Salkantay-Paucarcancha),1,Enero,0,0,0,0,0,0,0,0,0,0,0,0,0,0,0,0,0,0,0,0,Sitio Arqueológico
20240315,2023,8,Cusco,Parque Arqueologico Macchu Picchu (Ingreso Salkantay-Paucarcancha),1,Enero,1,0,0,0,0,0,0,0,0,0,0,0,0,0,0,0,0,0,0,0,Sitio Arqueológico
20240315,2023,8,Cusco,Parque Arqueologico Macchu Picchu (Ingreso Salkantay-Paucarcancha),1,Enero,2,0,0,0,0,0,0,0,0,0,0,0,0,0,0,0,0,0,0,0,Sitio Arqueológico
20240315,2023,8,Cusco,Parque Arqueologico Macchu Picchu (Ingreso Salkantay-Paucarcancha),2,Febrero,0,0,0,0,0,0,0,0,0,0,0,0,0,0,0,0,0,0,0,0,Sitio Arqueológico
20240315,2023,8,Cusco,Parque Arqueologico Macchu Picchu (Ingreso Salkantay-Paucarcancha),2,Febrero,1,0,0,0,0,0,0,0,0,0,0,0,0,0,0,0,0,0,0,0,Sitio Arqueológico
20240315,2023,8,Cusco,Parque Arqueologico Macchu Picchu (Ingreso Salkantay-Paucarcancha),2,Febrero,2,0,0,0,0,0,0,0,0,0,0,0,0,0,0,0,0,0,0,0,Sitio Arqueológico
20240315,2023,8,Cusco,Parque Arqueologico Macchu Picchu (Ingreso Salkantay-Paucarcancha),3,Marzo,0,0,0,0,0,0,0,0,0,0,0,0,0,0,0,0,0,0,0,0,Sitio Arqueológico
20240315,2023,8,Cusco,Parque Arqueologico Macchu Picchu (Ingreso Salkantay-Paucarcancha),3,Marzo,1,0,0,0,0,0,0,0,0,0,0,0,0,0,0,0,0,0,0,0,Sitio Arqueológico
20240315,2023,8,Cusco,Parque Arqueologico Macchu Picchu (Ingreso Salkantay-Paucarcancha),3,Marzo,2,0,0,0,0,0,0,0,0,0,0,0,0,0,0,0,0,0,0,0,Sitio Arqueológico
20240315,2023,8,Cusco,Parque Arqueologico Macchu Picchu (Ingreso Salkantay-Paucarcancha),4,Abril,0,0,0,0,0,0,0,0,0,0,0,0,0,0,0,0,0,0,0,0,Sitio Arqueológico
20240315,2023,8,Cusco,Parque Arqueologico Macchu Picchu (Ingreso Salkantay-Paucarcancha),4,Abril,1,0,0,0,0,0,34,0,0,34,0,0,0,0,0,0,0,0,0,34,Sitio Arqueológico
20240315,2023,8,Cusco,Parque Arqueologico Macchu Picchu (Ingreso Salkantay-Paucarcancha),4,Abril,2,0,0,0,0,0,34,0,0,34,0,0,0,0,0,0,0,0,0,34,Sitio Arqueológico
20240315,2023,8,Cusco,Parque Arqueologico Macchu Picchu (Ingreso Salkantay-Paucarcancha),5,Mayo,0,0,0,0,0,0,0,0,0,0,0,0,0,0,0,0,0,0,0,0,Sitio Arqueológico
20240315,2023,8,Cusco,Parque Arqueologico Macchu Picchu (Ingreso Salkantay-Paucarcancha),5,Mayo,1,0,0,0,0,0,28,0,0,28,0,0,0,0,0,0,0,0,0,28,Sitio Arqueológico
20240315,2023,8,Cusco,Parque Arqueologico Macchu Picchu (Ingreso Salkantay-Paucarcancha),5,Mayo,2,0,0,0,0,0,28,0,0,28,0,0,0,0,0,0,0,0,0,28,Sitio Arqueológico
20240315,2023,8,Cusco,Parque Arqueologico Macchu Picchu (Ingreso Salkantay-Paucarcancha),6,Junio,0,0,0,0,0,0,0,0,0,0,0,0,0,0,0,0,0,0,0,0,Sitio Arqueológico
20240315,2023,8,Cusco,Parque Arqueologico Macchu Picchu (Ingreso Salkantay-Paucarcancha),6,Junio,1,0,0,0,0,0,63,2,0,65,0,0,0,0,0,0,0,0,0,65,Sitio Arqueológico
20240315,2023,8,Cusco,Parque Arqueologico Macchu Picchu (Ingreso Salkantay-Paucarcancha),6,Junio,2,0,0,0,0,0,63,2,0,65,0,0,0,0,0,0,0,0,0,65,Sitio Arqueológico
20240315,2023,8,Cusco,Parque Arqueologico Macchu Picchu (Ingreso Salkantay-Paucarcancha),7,Julio,0,0,0,0,0,0,0,0,0,0,0,0,0,0,0,0,0,0,0,0,Sitio Arqueológico
20240315,2023,8,Cusco,Parque Arqueologico Macchu Picchu (Ingreso Salkantay-Paucarcancha),7,Julio,1,0,0,0,0,0,72,0,0,72,0,0,0,0,0,0,0,0,0,72,Sitio Arqueológico
20240315,2023,8,Cusco,Parque Arqueologico Macchu Picchu (Ingreso Salkantay-Paucarcancha),7,Julio,2,0,0,0,0,0,72,0,0,72,0,0,0,0,0,0,0,0,0,72,Sitio Arqueológico
20240315,2023,8,Cusco,Parque Arqueologico Macchu Picchu (Ingreso Salkantay-Paucarcancha),8,Agosto,0,0,0,0,0,0,0,0,0,0,0,0,0,0,0,0,0,0,0,0,Sitio Arqueológico
20240315,2023,8,Cusco,Parque Arqueologico Macchu Picchu (Ingreso Salkantay-Paucarcancha),8,Agosto,1,0,0,0,0,0,59,1,0,60,0,0,0,0,0,0,0,0,0,60,Sitio Arqueológico
20240315,2023,8,Cusco,Parque Arqueologico Macchu Picchu (Ingreso Salkantay-Paucarcancha),8,Agosto,2,0,0,0,0,0,59,1,0,60,0,0,0,0,0,0,0,0,0,60,Sitio Arqueológico
20240315,2023,8,Cusco,Parque Arqueologico Macchu Picchu (Ingreso Salkantay-Paucarcancha),9,Setiembre,0,0,0,0,0,0,0,0,0,0,0,0,0,0,0,0,0,0,0,0,Sitio Arqueológico
20240315,2023,8,Cusco,Parque Arqueologico Macchu Picchu (Ingreso Salkantay-Paucarcancha),9,Setiembre,1,0,0,0,0,0,81,0,0,81,0,0,0,0,0,0,0,0,0,81,Sitio Arqueológico
20240315,2023,8,Cusco,Parque Arqueologico Macchu Picchu (Ingreso Salkantay-Paucarcancha),9,Setiembre,2,0,0,0,0,0,81,0,0,81,0,0,0,0,0,0,0,0,0,81,Sitio Arqueológico
20240315,2023,8,Cusco,Parque Arqueologico Macchu Picchu (Ingreso Salkantay-Paucarcancha),10,Octubre,0,0,0,0,0,0,0,0,0,0,0,0,0,0,0,0,0,0,0,0,Sitio Arqueológico
20240315,2023,8,Cusco,Parque Arqueologico Macchu Picchu (Ingreso Salkantay-Paucarcancha),10,Octubre,1,0,0,0,0,0,94,0,0,94,0,0,0,0,0,0,0,0,0,94,Sitio Arqueológico
20240315,2023,8,Cusco,Parque Arqueologico Macchu Picchu (Ingreso Salkantay-Paucarcancha),10,Octubre,2,0,0,0,0,0,94,0,0,94,0,0,0,0,0,0,0,0,0,94,Sitio Arqueológico
20240315,2023,8,Cusco,Parque Arqueologico Macchu Picchu (Ingreso Salkantay-Paucarcancha),11,Noviembre,0,0,0,0,0,0,0,0,0,0,0,0,0,0,0,0,0,0,0,0,Sitio Arqueológico
20240315,2023,8,Cusco,Parque Arqueologico Macchu Picchu (Ingreso Salkantay-Paucarcancha),11,Noviembre,1,0,0,0,0,0,50,0,0,50,0,0,0,0,0,0,0,0,0,50,Sitio Arqueológico
20240315,2023,8,Cusco,Parque Arqueologico Macchu Picchu (Ingreso Salkantay-Paucarcancha),11,Noviembre,2,0,0,0,0,0,50,0,0,50,0,0,0,0,0,0,0,0,0,50,Sitio Arqueológico
20240315,2023,8,Cusco,Parque Arqueologico Macchu Picchu (Ingreso Salkantay-Paucarcancha),12,Diciembre,0,0,0,0,0,0,0,0,0,0,0,0,0,0,0,0,0,0,0,0,Sitio Arqueológico
20240315,2023,8,Cusco,Parque Arqueologico Macchu Picchu (Ingreso Salkantay-Paucarcancha),12,Diciembre,1,0,0,0,0,0,10,0,0,10,0,0,0,0,0,0,0,0,0,10,Sitio Arqueológico
20240315,2023,8,Cusco,Parque Arqueologico Macchu Picchu (Ingreso Salkantay-Paucarcancha),12,Diciembre,2,0,0,0,0,0,10,0,0,10,0,0,0,0,0,0,0,0,0,10,Sitio Arqueológico
20240315,2023,10,Huanuco,Zona Arqueologica Monumental de Garu,1,Enero,0,0,0,0,0,0,36,0,0,36,0,0,0,0,0,0,0,0,0,36,Sitio Arqueológico
20240315,2023,10,Huanuco,Zona Arqueologica Monumental de Garu,1,Enero,1,0,0,0,0,0,0,0,0,0,0,0,0,0,0,0,0,0,0,0,Sitio Arqueológico
20240315,2023,10,Huanuco,Zona Arqueologica Monumental de Garu,1,Enero,2,0,0,0,0,0,36,0,0,36,0,0,0,0,0,0,0,0,0,36,Sitio Arqueológico
20240315,2023,10,Huanuco,Zona Arqueologica Monumental de Garu,2,Febrero,0,0,0,0,0,0,23,0,0,23,0,0,0,0,0,0,0,0,0,23,Sitio Arqueológico
20240315,2023,10,Huanuco,Zona Arqueologica Monumental de Garu,2,Febrero,1,0,0,0,0,0,0,0,0,0,0,0,0,0,0,0,0,0,0,0,Sitio Arqueológico
20240315,2023,10,Huanuco,Zona Arqueologica Monumental de Garu,2,Febrero,2,0,0,0,0,0,23,0,0,23,0,0,0,0,0,0,0,0,0,23,Sitio Arqueológico
20240315,2023,10,Huanuco,Zona Arqueologica Monumental de Garu,3,Marzo,0,0,0,0,0,0,24,0,0,24,0,0,0,0,0,0,0,0,0,24,Sitio Arqueológico
20240315,2023,10,Huanuco,Zona Arqueologica Monumental de Garu,3,Marzo,1,0,0,0,0,0,0,0,0,0,0,0,0,0,0,0,0,0,0,0,Sitio Arqueológico
20240315,2023,10,Huanuco,Zona Arqueologica Monumental de Garu,3,Marzo,2,0,0,0,0,0,24,0,0,24,0,0,0,0,0,0,0,0,0,24,Sitio Arqueológico
20240315,2023,10,Huanuco,Zona Arqueologica Monumental de Garu,4,Abril,0,0,0,0,0,0,37,0,0,37,0,0,0,0,0,2,0,0,2,39,Sitio Arqueológico
20240315,2023,10,Huanuco,Zona Arqueologica Monumental de Garu,4,Abril,1,0,0,0,0,0,0,0,0,0,0,0,0,0,0,0,0,0,0,0,Sitio Arqueológico
20240315,2023,10,Huanuco,Zona Arqueologica Monumental de Garu,4,Abril,2,0,0,0,0,0,37,0,0,37,0,0,0,0,0,2,0,0,2,39,Sitio Arqueológico
20240315,2023,10,Huanuco,Zona Arqueologica Monumental de Garu,5,Mayo,0,0,0,0,0,0,33,0,0,33,0,0,0,0,0,4,0,0,4,37,Sitio Arqueológico
20240315,2023,10,Huanuco,Zona Arqueologica Monumental de Garu,5,Mayo,1,0,0,0,0,0,0,0,0,0,0,0,0,0,0,0,0,0,0,0,Sitio Arqueológico
20240315,2023,10,Huanuco,Zona Arqueologica Monumental de Garu,5,Mayo,2,0,0,0,0,0,33,0,0,33,0,0,0,0,0,4,0,0,4,37,Sitio Arqueológico
20240315,2023,10,Huanuco,Zona Arqueologica Monumental de Garu,6,Junio,0,0,0,0,0,0,38,0,0,38,0,0,0,0,0,6,0,0,6,44,Sitio Arqueológico
20240315,2023,10,Huanuco,Zona Arqueologica Monumental de Garu,6,Junio,1,0,0,0,0,0,0,0,0,0,0,0,0,0,0,0,0,0,0,0,Sitio Arqueológico
20240315,2023,10,Huanuco,Zona Arqueologica Monumental de Garu,6,Junio,2,0,0,0,0,0,38,0,0,38,0,0,0,0,0,6,0,0,6,44,Sitio Arqueológico
20240315,2023,10,Huanuco,Zona Arqueologica Monumental de Garu,7,Julio,0,0,0,0,0,0,92,13,0,105,0,0,0,0,0,5,0,0,5,110,Sitio Arqueológico
20240315,2023,10,Huanuco,Zona Arqueologica Monumental de Garu,7,Julio,1,0,0,0,0,0,0,0,0,0,0,0,0,0,0,0,0,0,0,0,Sitio Arqueológico
20240315,2023,10,Huanuco,Zona Arqueologica Monumental de Garu,7,Julio,2,0,0,0,0,0,92,13,0,105,0,0,0,0,0,5,0,0,5,110,Sitio Arqueológico
20240315,2023,10,Huanuco,Zona Arqueologica Monumental de Garu,8,Agosto,0,0,0,0,0,0,43,65,145,253,0,0,0,0,0,6,0,0,6,259,Sitio Arqueológico
20240315,2023,10,Huanuco,Zona Arqueologica Monumental de Garu,8,Agosto,1,0,0,0,0,0,0,0,0,0,0,0,0,0,0,0,0,0,0,0,Sitio Arqueológico
20240315,2023,10,Huanuco,Zona Arqueologica Monumental de Garu,8,Agosto,2,0,0,0,0,0,43,65,145,253,0,0,0,0,0,6,0,0,6,259,Sitio Arqueológico
20240315,2023,10,Huanuco,Zona Arqueologica Monumental de Garu,9,Setiembre,0,0,0,0,0,0,35,15,85,135,0,0,0,0,0,4,0,0,4,139,Sitio Arqueológico
20240315,2023,10,Huanuco,Zona Arqueologica Monumental de Garu,9,Setiembre,1,0,0,0,0,0,0,0,0,0,0,0,0,0,0,0,0,0,0,0,Sitio Arqueológico
20240315,2023,10,Huanuco,Zona Arqueologica Monumental de Garu,9,Setiembre,2,0,0,0,0,0,35,15,85,135,0,0,0,0,0,4,0,0,4,139,Sitio Arqueológico
20240315,2023,10,Huanuco,Zona Arqueologica Monumental de Garu,10,Octubre,0,0,0,0,0,0,47,2,0,49,0,0,0,0,0,8,0,0,8,57,Sitio Arqueológico
20240315,2023,10,Huanuco,Zona Arqueologica Monumental de Garu,10,Octubre,1,0,0,0,0,0,0,0,0,0,0,0,0,0,0,0,0,0,0,0,Sitio Arqueológico
20240315,2023,10,Huanuco,Zona Arqueologica Monumental de Garu,10,Octubre,2,0,0,0,0,0,47,2,0,49,0,0,0,0,0,8,0,0,8,57,Sitio Arqueológico
20240315,2023,10,Huanuco,Zona Arqueologica Monumental de Garu,11,Noviembre,0,0,0,0,0,0,36,0,1,37,0,0,0,0,0,16,0,0,16,53,Sitio Arqueológico
20240315,2023,10,Huanuco,Zona Arqueologica Monumental de Garu,11,Noviembre,1,0,0,0,0,0,0,0,0,0,0,0,0,0,0,0,0,0,0,0,Sitio Arqueológico
20240315,2023,10,Huanuco,Zona Arqueologica Monumental de Garu,11,Noviembre,2,0,0,0,0,0,36,0,1,37,0,0,0,0,0,16,0,0,16,53,Sitio Arqueológico
20240315,2023,10,Huanuco,Zona Arqueologica Monumental de Garu,12,Diciembre,0,0,0,0,0,0,28,2,0,30,0,0,0,0,0,4,0,0,4,34,Sitio Arqueológico
20240315,2023,10,Huanuco,Zona Arqueologica Monumental de Garu,12,Diciembre,1,0,0,0,0,0,0,0,0,0,0,0,0,0,0,0,0,0,0,0,Sitio Arqueológico
20240315,2023,10,Huanuco,Zona Arqueologica Monumental de Garu,12,Diciembre,2,0,0,0,0,0,28,2,0,30,0,0,0,0,0,4,0,0,4,34,Sitio Arqueológico
20240315,2023,10,Huanuco,Huanucopampa,1,Enero,0,0,0,0,0,0,496,320,164,980,0,0,0,0,0,48,23,17,88,1068,Sitio Arqueológico
20240315,2023,10,Huanuco,Huanucopampa,1,Enero,1,0,0,0,0,0,10,0,0,10,0,0,0,0,0,0,0,0,0,10,Sitio Arqueológico
20240315,2023,10,Huanuco,Huanucopampa,1,Enero,2,0,0,0,0,0,506,320,164,990,0,0,0,0,0,48,23,17,88,1078,Sitio Arqueológico
20240315,2023,10,Huanuco,Huanucopampa,2,Febrero,0,0,0,0,0,0,367,203,161,731,0,0,0,0,0,53,24,18,95,826,Sitio Arqueológico
20240315,2023,10,Huanuco,Huanucopampa,2,Febrero,1,0,0,0,0,0,0,0,0,0,0,0,0,0,0,0,0,0,0,0,Sitio Arqueológico
20240315,2023,10,Huanuco,Huanucopampa,2,Febrero,2,0,0,0,0,0,367,203,161,731,0,0,0,0,0,53,24,18,95,826,Sitio Arqueológico
20240315,2023,10,Huanuco,Huanucopampa,3,Marzo,0,0,0,0,0,0,133,79,41,253,0,0,0,0,0,27,10,8,45,298,Sitio Arqueológico
20240315,2023,10,Huanuco,Huanucopampa,3,Marzo,1,0,0,0,0,0,0,0,0,0,0,0,0,0,0,0,0,0,0,0,Sitio Arqueológico
20240315,2023,10,Huanuco,Huanucopampa,3,Marzo,2,0,0,0,0,0,133,79,41,253,0,0,0,0,0,27,10,8,45,298,Sitio Arqueológico
20240315,2023,10,Huanuco,Huanucopampa,4,Abril,0,0,0,0,0,0,387,219,151,757,0,0,0,0,0,25,13,8,46,803,Sitio Arqueológico
20240315,2023,10,Huanuco,Huanucopampa,4,Abril,1,0,0,0,0,0,0,0,0,0,0,0,0,0,0,0,0,0,0,0,Sitio Arqueológico
20240315,2023,10,Huanuco,Huanucopampa,4,Abril,2,0,0,0,0,0,387,219,151,757,0,0,0,0,0,25,13,8,46,803,Sitio Arqueológico
20240315,2023,10,Huanuco,Huanucopampa,5,Mayo,0,0,0,0,0,0,405,258,141,804,0,0,0,0,0,89,32,24,145,949,Sitio Arqueológico
20240315,2023,10,Huanuco,Huanucopampa,5,Mayo,1,0,0,0,0,0,0,0,0,0,0,0,0,0,0,0,0,0,0,0,Sitio Arqueológico
20240315,2023,10,Huanuco,Huanucopampa,5,Mayo,2,0,0,0,0,0,405,258,141,804,0,0,0,0,0,89,32,24,145,949,Sitio Arqueológico
20240315,2023,10,Huanuco,Huanucopampa,6,Junio,0,0,0,0,0,0,316,351,517,1184,0,0,0,0,0,67,25,12,104,1288,Sitio Arqueológico
20240315,2023,10,Huanuco,Huanucopampa,6,Junio,1,0,0,0,0,0,0,0,0,0,0,0,0,0,0,0,0,0,0,0,Sitio Arqueológico
20240315,2023,10,Huanuco,Huanucopampa,6,Junio,2,0,0,0,0,0,316,351,517,1184,0,0,0,0,0,67,25,12,104,1288,Sitio Arqueológico
20240315,2023,10,Huanuco,Huanucopampa,7,Julio,0,0,0,0,0,0,799,513,328,1640,0,0,0,0,0,62,37,26,125,1765,Sitio Arqueológico
20240315,2023,10,Huanuco,Huanucopampa,7,Julio,1,0,0,0,0,0,12,0,0,12,0,0,0,0,0,0,0,0,0,12,Sitio Arqueológico
20240315,2023,10,Huanuco,Huanucopampa,7,Julio,2,0,0,0,0,0,811,513,328,1652,0,0,0,0,0,62,37,26,125,1777,Sitio Arqueológico
20240315,2023,10,Huanuco,Huanucopampa,8,Agosto,0,0,0,0,0,0,407,281,255,943,0,0,0,0,0,79,28,15,122,1065,Sitio Arqueológico
20240315,2023,10,Huanuco,Huanucopampa,8,Agosto,1,0,0,0,0,0,13,0,0,13,0,0,0,0,0,0,0,0,0,13,Sitio Arqueológico
20240315,2023,10,Huanuco,Huanucopampa,8,Agosto,2,0,0,0,0,0,420,281,255,956,0,0,0,0,0,79,28,15,122,1078,Sitio Arqueológico
20240315,2023,10,Huanuco,Huanucopampa,9,Setiembre,0,0,0,0,0,0,353,400,857,1610,0,0,0,0,0,68,23,16,107,1717,Sitio Arqueológico
20240315,2023,10,Huanuco,Huanucopampa,9,Setiembre,1,0,0,0,0,0,9,0,0,9,0,0,0,0,0,0,0,0,0,9,Sitio Arqueológico
20240315,2023,10,Huanuco,Huanucopampa,9,Setiembre,2,0,0,0,0,0,362,400,857,1619,0,0,0,0,0,68,23,16,107,1726,Sitio Arqueológico
20240315,2023,10,Huanuco,Huanucopampa,10,Octubre,0,0,0,0,0,0,383,357,445,1185,0,0,0,0,0,79,19,18,116,1301,Sitio Arqueológico
20240315,2023,10,Huanuco,Huanucopampa,10,Octubre,1,0,0,0,0,0,0,0,0,0,0,0,0,0,0,0,0,0,0,0,Sitio Arqueológico
20240315,2023,10,Huanuco,Huanucopampa,10,Octubre,2,0,0,0,0,0,383,357,445,1185,0,0,0,0,0,79,19,18,116,1301,Sitio Arqueológico
20240315,2023,10,Huanuco,Huanucopampa,11,Noviembre,0,0,0,0,0,0,344,336,288,968,0,0,0,0,0,52,21,11,84,1052,Sitio Arqueológico
20240315,2023,10,Huanuco,Huanucopampa,11,Noviembre,1,0,0,0,0,0,0,0,0,0,0,0,0,0,0,0,0,0,0,0,Sitio Arqueológico
20240315,2023,10,Huanuco,Huanucopampa,11,Noviembre,2,0,0,0,0,0,344,336,288,968,0,0,0,0,0,52,21,11,84,1052,Sitio Arqueológico
20240315,2023,10,Huanuco,Huanucopampa,12,Diciembre,0,0,0,0,0,0,285,313,161,759,0,0,0,0,0,87,18,14,119,878,Sitio Arqueológico
20240315,2023,10,Huanuco,Huanucopampa,12,Diciembre,1,0,0,0,0,0,0,0,0,0,0,0,0,0,0,0,0,0,0,0,Sitio Arqueológico
20240315,2023,10,Huanuco,Huanucopampa,12,Diciembre,2,0,0,0,0,0,285,313,161,759,0,0,0,0,0,87,18,14,119,878,Sitio Arqueológico
20240315,2023,11,Ica,Sitio Arqueologico Pampas de Huayuri,1,Enero,0,0,0,0,0,0,15,0,0,15,0,0,0,0,0,0,0,0,0,15,Sitio Arqueológico
20240315,2023,11,Ica,Sitio Arqueologico Pampas de Huayuri,1,Enero,1,0,0,0,0,0,0,0,0,0,0,0,0,0,0,0,0,0,0,0,Sitio Arqueológico
20240315,2023,11,Ica,Sitio Arqueologico Pampas de Huayuri,1,Enero,2,0,0,0,0,0,15,0,0,15,0,0,0,0,0,0,0,0,0,15,Sitio Arqueológico
20240315,2023,11,Ica,Sitio Arqueologico Pampas de Huayuri,2,Febrero,0,0,0,0,0,0,0,0,0,0,0,0,0,0,0,0,0,0,0,0,Sitio Arqueológico
20240315,2023,11,Ica,Sitio Arqueologico Pampas de Huayuri,2,Febrero,1,0,0,0,0,0,0,0,0,0,0,0,0,0,0,0,0,0,0,0,Sitio Arqueológico
20240315,2023,11,Ica,Sitio Arqueologico Pampas de Huayuri,2,Febrero,2,0,0,0,0,0,0,0,0,0,0,0,0,0,0,0,0,0,0,0,Sitio Arqueológico
20240315,2023,11,Ica,Sitio Arqueologico Pampas de Huayuri,3,Marzo,0,0,0,0,0,0,8,0,2,10,0,0,0,0,0,0,0,0,0,10,Sitio Arqueológico
20240315,2023,11,Ica,Sitio Arqueologico Pampas de Huayuri,3,Marzo,1,0,0,0,0,0,0,0,0,0,0,0,0,0,0,0,0,0,0,0,Sitio Arqueológico
20240315,2023,11,Ica,Sitio Arqueologico Pampas de Huayuri,3,Marzo,2,0,0,0,0,0,8,0,2,10,0,0,0,0,0,0,0,0,0,10,Sitio Arqueológico
20240315,2023,11,Ica,Sitio Arqueologico Pampas de Huayuri,4,Abril,0,0,0,0,0,0,23,1,0,24,0,0,0,0,0,0,0,0,0,24,Sitio Arqueológico
20240315,2023,11,Ica,Sitio Arqueologico Pampas de Huayuri,4,Abril,1,0,0,0,0,0,0,0,0,0,0,0,0,0,0,0,0,0,0,0,Sitio Arqueológico
20240315,2023,11,Ica,Sitio Arqueologico Pampas de Huayuri,4,Abril,2,0,0,0,0,0,23,1,0,24,0,0,0,0,0,0,0,0,0,24,Sitio Arqueológico
20240315,2023,11,Ica,Sitio Arqueologico Pampas de Huayuri,5,Mayo,0,0,0,0,0,0,50,0,0,50,0,0,0,0,0,0,0,0,0,50,Sitio Arqueológico
20240315,2023,11,Ica,Sitio Arqueologico Pampas de Huayuri,5,Mayo,1,0,0,0,0,0,0,0,0,0,0,0,0,0,0,0,0,0,0,0,Sitio Arqueológico
20240315,2023,11,Ica,Sitio Arqueologico Pampas de Huayuri,5,Mayo,2,0,0,0,0,0,50,0,0,50,0,0,0,0,0,0,0,0,0,50,Sitio Arqueológico
20240315,2023,11,Ica,Sitio Arqueologico Pampas de Huayuri,6,Junio,0,0,0,0,0,0,12,0,0,12,0,0,0,0,0,4,0,0,4,16,Sitio Arqueológico
20240315,2023,11,Ica,Sitio Arqueologico Pampas de Huayuri,6,Junio,1,0,0,0,0,0,0,0,0,0,0,0,0,0,0,0,0,0,0,0,Sitio Arqueológico
20240315,2023,11,Ica,Sitio Arqueologico Pampas de Huayuri,6,Junio,2,0,0,0,0,0,12,0,0,12,0,0,0,0,0,4,0,0,4,16,Sitio Arqueológico
20240315,2023,11,Ica,Sitio Arqueologico Pampas de Huayuri,7,Julio,0,0,0,0,0,0,16,0,0,16,0,0,0,0,0,6,0,0,6,22,Sitio Arqueológico
20240315,2023,11,Ica,Sitio Arqueologico Pampas de Huayuri,7,Julio,1,0,0,0,0,0,0,0,0,0,0,0,0,0,0,0,0,0,0,0,Sitio Arqueológico
20240315,2023,11,Ica,Sitio Arqueologico Pampas de Huayuri,7,Julio,2,0,0,0,0,0,16,0,0,16,0,0,0,0,0,6,0,0,6,22,Sitio Arqueológico
20240315,2023,11,Ica,Sitio Arqueologico Pampas de Huayuri,8,Agosto,0,0,0,0,0,0,38,0,0,38,0,0,0,0,0,5,0,0,5,43,Sitio Arqueológico
20240315,2023,11,Ica,Sitio Arqueologico Pampas de Huayuri,8,Agosto,1,0,0,0,0,0,0,0,0,0,0,0,0,0,0,0,0,0,0,0,Sitio Arqueológico
20240315,2023,11,Ica,Sitio Arqueologico Pampas de Huayuri,8,Agosto,2,0,0,0,0,0,38,0,0,38,0,0,0,0,0,5,0,0,5,43,Sitio Arqueológico
20240315,2023,11,Ica,Sitio Arqueologico Pampas de Huayuri,9,Setiembre,0,0,0,0,0,0,16,4,11,31,0,0,0,0,0,5,0,0,5,36,Sitio Arqueológico
20240315,2023,11,Ica,Sitio Arqueologico Pampas de Huayuri,9,Setiembre,1,0,0,0,0,0,0,0,0,0,0,0,0,0,0,0,0,0,0,0,Sitio Arqueológico
20240315,2023,11,Ica,Sitio Arqueologico Pampas de Huayuri,9,Setiembre,2,0,0,0,0,0,16,4,11,31,0,0,0,0,0,5,0,0,5,36,Sitio Arqueológico
20240315,2023,11,Ica,Sitio Arqueologico Pampas de Huayuri,10,Octubre,0,0,0,0,0,0,17,8,0,25,0,0,0,0,0,12,0,0,12,37,Sitio Arqueológico
20240315,2023,11,Ica,Sitio Arqueologico Pampas de Huayuri,10,Octubre,1,0,0,0,0,0,0,0,0,0,0,0,0,0,0,0,0,0,0,0,Sitio Arqueológico
20240315,2023,11,Ica,Sitio Arqueologico Pampas de Huayuri,10,Octubre,2,0,0,0,0,0,17,8,0,25,0,0,0,0,0,12,0,0,12,37,Sitio Arqueológico
20240315,2023,11,Ica,Sitio Arqueologico Pampas de Huayuri,11,Noviembre,0,0,0,0,0,0,0,0,0,0,0,0,0,0,0,0,0,0,0,0,Sitio Arqueológico
20240315,2023,11,Ica,Sitio Arqueologico Pampas de Huayuri,11,Noviembre,1,0,0,0,0,0,0,0,0,0,0,0,0,0,0,0,0,0,0,0,Sitio Arqueológico
20240315,2023,11,Ica,Sitio Arqueologico Pampas de Huayuri,11,Noviembre,2,0,0,0,0,0,0,0,0,0,0,0,0,0,0,0,0,0,0,0,Sitio Arqueológico
20240315,2023,11,Ica,Sitio Arqueologico Pampas de Huayuri,12,Diciembre,0,0,0,0,0,0,8,0,0,8,0,0,0,0,0,7,2,2,11,19,Sitio Arqueológico
20240315,2023,11,Ica,Sitio Arqueologico Pampas de Huayuri,12,Diciembre,1,0,0,0,0,0,0,0,0,0,0,0,0,0,0,0,0,0,0,0,Sitio Arqueológico
20240315,2023,11,Ica,Sitio Arqueologico Pampas de Huayuri,12,Diciembre,2,0,0,0,0,0,8,0,0,8,0,0,0,0,0,7,2,2,11,19,Sitio Arqueológico
20240315,2023,11,Ica,Monumento Arqueologico de Palpa (Lineas y Geoglifos de Sacramento),1,Enero,0,0,0,0,0,0,2,0,0,2,0,0,0,0,0,0,0,0,0,2,Sitio Arqueológico
20240315,2023,11,Ica,Monumento Arqueologico de Palpa (Lineas y Geoglifos de Sacramento),1,Enero,1,0,0,0,0,0,0,0,0,0,0,0,0,0,0,0,0,0,0,0,Sitio Arqueológico
20240315,2023,11,Ica,Monumento Arqueologico de Palpa (Lineas y Geoglifos de Sacramento),1,Enero,2,0,0,0,0,0,2,0,0,2,0,0,0,0,0,0,0,0,0,2,Sitio Arqueológico
20240315,2023,11,Ica,Monumento Arqueologico de Palpa (Lineas y Geoglifos de Sacramento),2,Febrero,0,0,0,0,0,0,0,0,0,0,0,0,0,0,0,0,0,0,0,0,Sitio Arqueológico
20240315,2023,11,Ica,Monumento Arqueologico de Palpa (Lineas y Geoglifos de Sacramento),2,Febrero,1,0,0,0,0,0,0,0,0,0,0,0,0,0,0,0,0,0,0,0,Sitio Arqueológico
20240315,2023,11,Ica,Monumento Arqueologico de Palpa (Lineas y Geoglifos de Sacramento),2,Febrero,2,0,0,0,0,0,0,0,0,0,0,0,0,0,0,0,0,0,0,0,Sitio Arqueológico
20240315,2023,11,Ica,Monumento Arqueologico de Palpa (Lineas y Geoglifos de Sacramento),3,Marzo,0,0,0,0,0,0,6,0,8,14,0,0,0,0,0,0,0,0,0,14,Sitio Arqueológico
20240315,2023,11,Ica,Monumento Arqueologico de Palpa (Lineas y Geoglifos de Sacramento),3,Marzo,1,0,0,0,0,0,0,0,0,0,0,0,0,0,0,0,0,0,0,0,Sitio Arqueológico
20240315,2023,11,Ica,Monumento Arqueologico de Palpa (Lineas y Geoglifos de Sacramento),3,Marzo,2,0,0,0,0,0,6,0,8,14,0,0,0,0,0,0,0,0,0,14,Sitio Arqueológico
20240315,2023,11,Ica,Monumento Arqueologico de Palpa (Lineas y Geoglifos de Sacramento),4,Abril,0,0,0,0,0,0,32,2,4,38,0,0,0,0,0,0,0,0,0,38,Sitio Arqueológico
20240315,2023,11,Ica,Monumento Arqueologico de Palpa (Lineas y Geoglifos de Sacramento),4,Abril,1,0,0,0,0,0,0,0,0,0,0,0,0,0,0,0,0,0,0,0,Sitio Arqueológico
20240315,2023,11,Ica,Monumento Arqueologico de Palpa (Lineas y Geoglifos de Sacramento),4,Abril,2,0,0,0,0,0,32,2,4,38,0,0,0,0,0,0,0,0,0,38,Sitio Arqueológico
20240315,2023,11,Ica,Monumento Arqueologico de Palpa (Lineas y Geoglifos de Sacramento),5,Mayo,0,0,0,0,0,0,0,0,0,0,0,0,0,0,0,8,0,0,8,8,Sitio Arqueológico
20240315,2023,11,Ica,Monumento Arqueologico de Palpa (Lineas y Geoglifos de Sacramento),5,Mayo,1,0,0,0,0,0,0,0,0,0,0,0,0,0,0,0,0,0,0,0,Sitio Arqueológico
20240315,2023,11,Ica,Monumento Arqueologico de Palpa (Lineas y Geoglifos de Sacramento),5,Mayo,2,0,0,0,0,0,0,0,0,0,0,0,0,0,0,8,0,0,8,8,Sitio Arqueológico
20240315,2023,11,Ica,Monumento Arqueologico de Palpa (Lineas y Geoglifos de Sacramento),6,Junio,0,0,0,0,0,0,43,0,0,43,0,0,0,0,0,5,0,0,5,48,Sitio Arqueológico
20240315,2023,11,Ica,Monumento Arqueologico de Palpa (Lineas y Geoglifos de Sacramento),6,Junio,1,0,0,0,0,0,0,0,0,0,0,0,0,0,0,0,0,0,0,0,Sitio Arqueológico
20240315,2023,11,Ica,Monumento Arqueologico de Palpa (Lineas y Geoglifos de Sacramento),6,Junio,2,0,0,0,0,0,43,0,0,43,0,0,0,0,0,5,0,0,5,48,Sitio Arqueológico
20240315,2023,11,Ica,Monumento Arqueologico de Palpa (Lineas y Geoglifos de Sacramento),7,Julio,0,0,0,0,0,0,94,0,0,94,0,0,0,0,0,10,0,0,10,104,Sitio Arqueológico
20240315,2023,11,Ica,Monumento Arqueologico de Palpa (Lineas y Geoglifos de Sacramento),7,Julio,1,0,0,0,0,0,0,0,0,0,0,0,0,0,0,0,0,0,0,0,Sitio Arqueológico
20240315,2023,11,Ica,Monumento Arqueologico de Palpa (Lineas y Geoglifos de Sacramento),7,Julio,2,0,0,0,0,0,94,0,0,94,0,0,0,0,0,10,0,0,10,104,Sitio Arqueológico
20240315,2023,11,Ica,Monumento Arqueologico de Palpa (Lineas y Geoglifos de Sacramento),8,Agosto,0,0,0,0,0,0,72,0,0,72,0,0,0,0,0,8,0,0,8,80,Sitio Arqueológico
20240315,2023,11,Ica,Monumento Arqueologico de Palpa (Lineas y Geoglifos de Sacramento),8,Agosto,1,0,0,0,0,0,0,0,0,0,0,0,0,0,0,0,0,0,0,0,Sitio Arqueológico
20240315,2023,11,Ica,Monumento Arqueologico de Palpa (Lineas y Geoglifos de Sacramento),8,Agosto,2,0,0,0,0,0,72,0,0,72,0,0,0,0,0,8,0,0,8,80,Sitio Arqueológico
20240315,2023,11,Ica,Monumento Arqueologico de Palpa (Lineas y Geoglifos de Sacramento),9,Setiembre,0,0,0,0,0,0,10,25,117,152,0,0,0,0,0,8,0,0,8,160,Sitio Arqueológico
20240315,2023,11,Ica,Monumento Arqueologico de Palpa (Lineas y Geoglifos de Sacramento),9,Setiembre,1,0,0,0,0,0,0,0,0,0,0,0,0,0,0,0,0,0,0,0,Sitio Arqueológico
20240315,2023,11,Ica,Monumento Arqueologico de Palpa (Lineas y Geoglifos de Sacramento),9,Setiembre,2,0,0,0,0,0,10,25,117,152,0,0,0,0,0,8,0,0,8,160,Sitio Arqueológico
20240315,2023,11,Ica,Monumento Arqueologico de Palpa (Lineas y Geoglifos de Sacramento),10,Octubre,0,0,0,0,0,0,12,7,0,19,0,0,0,0,0,10,0,0,10,29,Sitio Arqueológico
20240315,2023,11,Ica,Monumento Arqueologico de Palpa (Lineas y Geoglifos de Sacramento),10,Octubre,1,0,0,0,0,0,0,0,0,0,0,0,0,0,0,0,0,0,0,0,Sitio Arqueológico
20240315,2023,11,Ica,Monumento Arqueologico de Palpa (Lineas y Geoglifos de Sacramento),10,Octubre,2,0,0,0,0,0,12,7,0,19,0,0,0,0,0,10,0,0,10,29,Sitio Arqueológico
20240315,2023,11,Ica,Monumento Arqueologico de Palpa (Lineas y Geoglifos de Sacramento),11,Noviembre,0,0,0,0,0,0,10,3,0,13,0,0,0,0,0,15,0,0,15,28,Sitio Arqueológico
20240315,2023,11,Ica,Monumento Arqueologico de Palpa (Lineas y Geoglifos de Sacramento),11,Noviembre,1,0,0,0,0,0,0,0,0,0,0,0,0,0,0,0,0,0,0,0,Sitio Arqueológico
20240315,2023,11,Ica,Monumento Arqueologico de Palpa (Lineas y Geoglifos de Sacramento),11,Noviembre,2,0,0,0,0,0,10,3,0,13,0,0,0,0,0,15,0,0,15,28,Sitio Arqueológico
20240315,2023,11,Ica,Monumento Arqueologico de Palpa (Lineas y Geoglifos de Sacramento),12,Diciembre,0,0,0,0,0,0,14,25,0,39,0,0,0,0,0,5,3,3,11,50,Sitio Arqueológico
20240315,2023,11,Ica,Monumento Arqueologico de Palpa (Lineas y Geoglifos de Sacramento),12,Diciembre,1,0,0,0,0,0,0,0,0,0,0,0,0,0,0,0,0,0,0,0,Sitio Arqueológico
20240315,2023,11,Ica,Monumento Arqueologico de Palpa (Lineas y Geoglifos de Sacramento),12,Diciembre,2,0,0,0,0,0,14,25,0,39,0,0,0,0,0,5,3,3,11,50,Sitio Arqueológico
20240315,2023,11,Ica,Sitio Arqueologico Centinela,1,Enero,0,0,0,0,0,0,0,0,0,0,0,0,0,0,0,0,0,0,0,0,Sitio Arqueológico
20240315,2023,11,Ica,Sitio Arqueologico Centinela,1,Enero,1,0,0,0,0,0,0,0,0,0,0,0,0,0,0,0,0,0,0,0,Sitio Arqueológico
20240315,2023,11,Ica,Sitio Arqueologico Centinela,1,Enero,2,0,0,0,0,0,0,0,0,0,0,0,0,0,0,0,0,0,0,0,Sitio Arqueológico
20240315,2023,11,Ica,Sitio Arqueologico Centinela,2,Febrero,0,0,0,0,0,0,0,0,0,0,0,0,0,0,0,0,0,0,0,0,Sitio Arqueológico
20240315,2023,11,Ica,Sitio Arqueologico Centinela,2,Febrero,1,0,0,0,0,0,0,0,0,0,0,0,0,0,0,0,0,0,0,0,Sitio Arqueológico
20240315,2023,11,Ica,Sitio Arqueologico Centinela,2,Febrero,2,0,0,0,0,0,0,0,0,0,0,0,0,0,0,0,0,0,0,0,Sitio Arqueológico
20240315,2023,11,Ica,Sitio Arqueologico Centinela,3,Marzo,0,0,0,0,0,0,0,0,0,0,0,0,0,0,0,0,0,0,0,0,Sitio Arqueológico
20240315,2023,11,Ica,Sitio Arqueologico Centinela,3,Marzo,1,0,0,0,0,0,0,0,0,0,0,0,0,0,0,0,0,0,0,0,Sitio Arqueológico
20240315,2023,11,Ica,Sitio Arqueologico Centinela,3,Marzo,2,0,0,0,0,0,0,0,0,0,0,0,0,0,0,0,0,0,0,0,Sitio Arqueológico
20240315,2023,11,Ica,Sitio Arqueologico Centinela,4,Abril,0,0,0,0,0,0,0,0,0,0,0,0,0,0,0,0,0,0,0,0,Sitio Arqueológico
20240315,2023,11,Ica,Sitio Arqueologico Centinela,4,Abril,1,0,0,0,0,0,0,0,0,0,0,0,0,0,0,0,0,0,0,0,Sitio Arqueológico
20240315,2023,11,Ica,Sitio Arqueologico Centinela,4,Abril,2,0,0,0,0,0,0,0,0,0,0,0,0,0,0,0,0,0,0,0,Sitio Arqueológico
20240315,2023,11,Ica,Sitio Arqueologico Centinela,5,Mayo,0,0,0,0,0,0,0,0,0,0,0,0,0,0,0,0,0,0,0,0,Sitio Arqueológico
20240315,2023,11,Ica,Sitio Arqueologico Centinela,5,Mayo,1,0,0,0,0,0,0,0,0,0,0,0,0,0,0,0,0,0,0,0,Sitio Arqueológico
20240315,2023,11,Ica,Sitio Arqueologico Centinela,5,Mayo,2,0,0,0,0,0,0,0,0,0,0,0,0,0,0,0,0,0,0,0,Sitio Arqueológico
20240315,2023,11,Ica,Sitio Arqueologico Centinela,6,Junio,0,0,0,0,0,0,0,0,0,0,0,0,0,0,0,0,0,0,0,0,Sitio Arqueológico
20240315,2023,11,Ica,Sitio Arqueologico Centinela,6,Junio,1,0,0,0,0,0,0,0,0,0,0,0,0,0,0,0,0,0,0,0,Sitio Arqueológico
20240315,2023,11,Ica,Sitio Arqueologico Centinela,6,Junio,2,0,0,0,0,0,0,0,0,0,0,0,0,0,0,0,0,0,0,0,Sitio Arqueológico
20240315,2023,11,Ica,Sitio Arqueologico Centinela,7,Julio,0,0,0,0,0,0,0,0,0,0,0,0,0,0,0,0,0,0,0,0,Sitio Arqueológico
20240315,2023,11,Ica,Sitio Arqueologico Centinela,7,Julio,1,0,0,0,0,0,0,0,0,0,0,0,0,0,0,0,0,0,0,0,Sitio Arqueológico
20240315,2023,11,Ica,Sitio Arqueologico Centinela,7,Julio,2,0,0,0,0,0,0,0,0,0,0,0,0,0,0,0,0,0,0,0,Sitio Arqueológico
20240315,2023,11,Ica,Sitio Arqueologico Centinela,8,Agosto,0,0,0,0,0,0,0,0,0,0,0,0,0,0,0,0,0,0,0,0,Sitio Arqueológico
20240315,2023,11,Ica,Sitio Arqueologico Centinela,8,Agosto,1,0,0,0,0,0,0,0,0,0,0,0,0,0,0,0,0,0,0,0,Sitio Arqueológico
20240315,2023,11,Ica,Sitio Arqueologico Centinela,8,Agosto,2,0,0,0,0,0,0,0,0,0,0,0,0,0,0,0,0,0,0,0,Sitio Arqueológico
20240315,2023,11,Ica,Sitio Arqueologico Centinela,9,Setiembre,0,0,0,0,0,0,0,0,0,0,0,0,0,0,0,0,0,0,0,0,Sitio Arqueológico
20240315,2023,11,Ica,Sitio Arqueologico Centinela,9,Setiembre,1,0,0,0,0,0,0,0,0,0,0,0,0,0,0,0,0,0,0,0,Sitio Arqueológico
20240315,2023,11,Ica,Sitio Arqueologico Centinela,9,Setiembre,2,0,0,0,0,0,0,0,0,0,0,0,0,0,0,0,0,0,0,0,Sitio Arqueológico
20240315,2023,11,Ica,Sitio Arqueologico Centinela,10,Octubre,0,0,0,0,0,0,0,0,0,0,0,0,0,0,0,0,0,0,0,0,Sitio Arqueológico
20240315,2023,11,Ica,Sitio Arqueologico Centinela,10,Octubre,1,0,0,0,0,0,0,0,0,0,0,0,0,0,0,0,0,0,0,0,Sitio Arqueológico
20240315,2023,11,Ica,Sitio Arqueologico Centinela,10,Octubre,2,0,0,0,0,0,0,0,0,0,0,0,0,0,0,0,0,0,0,0,Sitio Arqueológico
20240315,2023,11,Ica,Sitio Arqueologico Centinela,11,Noviembre,0,0,0,0,0,0,0,0,0,0,0,0,0,0,0,0,0,0,0,0,Sitio Arqueológico
20240315,2023,11,Ica,Sitio Arqueologico Centinela,11,Noviembre,1,0,0,0,0,0,0,0,0,0,0,0,0,0,0,0,0,0,0,0,Sitio Arqueológico
20240315,2023,11,Ica,Sitio Arqueologico Centinela,11,Noviembre,2,0,0,0,0,0,0,0,0,0,0,0,0,0,0,0,0,0,0,0,Sitio Arqueológico
20240315,2023,11,Ica,Sitio Arqueologico Centinela,12,Diciembre,0,0,0,0,0,0,0,0,0,0,0,0,0,0,0,0,0,0,0,0,Sitio Arqueológico
20240315,2023,11,Ica,Sitio Arqueologico Centinela,12,Diciembre,1,0,0,0,0,0,0,0,0,0,0,0,0,0,0,0,0,0,0,0,Sitio Arqueológico
20240315,2023,11,Ica,Sitio Arqueologico Centinela,12,Diciembre,2,0,0,0,0,0,0,0,0,0,0,0,0,0,0,0,0,0,0,0,Sitio Arqueológico
20240315,2023,11,Ica,Reserva Arqueologica Lineas y Geoglifos de Nazca,1,Enero,0,0,0,0,0,0,1068,0,818,1886,0,0,0,0,0,0,0,0,0,1886,Sitio Arqueológico
20240315,2023,11,Ica,Reserva Arqueologica Lineas y Geoglifos de Nazca,1,Enero,1,0,0,0,0,0,563,0,372,935,0,0,0,0,0,0,0,0,0,935,Sitio Arqueológico
20240315,2023,11,Ica,Reserva Arqueologica Lineas y Geoglifos de Nazca,1,Enero,2,0,0,0,0,0,1631,0,1190,2821,0,0,0,0,0,0,0,0,0,2821,Sitio Arqueológico
20240315,2023,11,Ica,Reserva Arqueologica Lineas y Geoglifos de Nazca,2,Febrero,0,0,0,0,0,0,0,0,0,0,0,0,0,0,0,0,0,0,0,0,Sitio Arqueológico
20240315,2023,11,Ica,Reserva Arqueologica Lineas y Geoglifos de Nazca,2,Febrero,1,0,0,0,0,0,0,0,0,0,0,0,0,0,0,0,0,0,0,0,Sitio Arqueológico
20240315,2023,11,Ica,Reserva Arqueologica Lineas y Geoglifos de Nazca,2,Febrero,2,0,0,0,0,0,0,0,0,0,0,0,0,0,0,0,0,0,0,0,Sitio Arqueológico
20240315,2023,11,Ica,Reserva Arqueologica Lineas y Geoglifos de Nazca,3,Marzo,0,0,0,0,0,0,0,0,0,0,0,0,0,0,0,0,0,0,0,0,Sitio Arqueológico
20240315,2023,11,Ica,Reserva Arqueologica Lineas y Geoglifos de Nazca,3,Marzo,1,0,0,0,0,0,0,0,0,0,0,0,0,0,0,0,0,0,0,0,Sitio Arqueológico
20240315,2023,11,Ica,Reserva Arqueologica Lineas y Geoglifos de Nazca,3,Marzo,2,0,0,0,0,0,0,0,0,0,0,0,0,0,0,0,0,0,0,0,Sitio Arqueológico
20240315,2023,11,Ica,Reserva Arqueologica Lineas y Geoglifos de Nazca,4,Abril,0,0,0,0,0,0,1622,0,883,2505,0,0,0,0,0,80,25,15,120,2625,Sitio Arqueológico
20240315,2023,11,Ica,Reserva Arqueologica Lineas y Geoglifos de Nazca,4,Abril,1,0,0,0,0,0,1434,0,444,1878,0,0,0,0,0,0,0,0,0,1878,Sitio Arqueológico
20240315,2023,11,Ica,Reserva Arqueologica Lineas y Geoglifos de Nazca,4,Abril,2,0,0,0,0,0,3056,0,1327,4383,0,0,0,0,0,80,25,15,120,4503,Sitio Arqueológico
20240315,2023,11,Ica,Reserva Arqueologica Lineas y Geoglifos de Nazca,5,Mayo,0,0,0,0,0,0,1368,0,901,2269,0,0,0,0,0,120,31,12,163,2432,Sitio Arqueológico
20240315,2023,11,Ica,Reserva Arqueologica Lineas y Geoglifos de Nazca,5,Mayo,1,0,0,0,0,0,1414,0,501,1915,0,0,0,0,0,0,0,0,0,1915,Sitio Arqueológico
20240315,2023,11,Ica,Reserva Arqueologica Lineas y Geoglifos de Nazca,5,Mayo,2,0,0,0,0,0,2782,0,1402,4184,0,0,0,0,0,120,31,12,163,4347,Sitio Arqueológico
20240315,2023,11,Ica,Reserva Arqueologica Lineas y Geoglifos de Nazca,6,Junio,0,0,0,0,0,0,2272,0,0,2272,0,0,0,0,0,130,0,0,130,2402,Sitio Arqueológico
20240315,2023,11,Ica,Reserva Arqueologica Lineas y Geoglifos de Nazca,6,Junio,1,0,0,0,0,0,1765,0,0,1765,0,0,0,0,0,0,0,0,0,1765,Sitio Arqueológico
20240315,2023,11,Ica,Reserva Arqueologica Lineas y Geoglifos de Nazca,6,Junio,2,0,0,0,0,0,4037,0,0,4037,0,0,0,0,0,130,0,0,130,4167,Sitio Arqueológico
20240315,2023,11,Ica,Reserva Arqueologica Lineas y Geoglifos de Nazca,7,Julio,0,0,0,0,0,0,4725,0,0,4725,0,0,0,0,0,180,0,0,180,4905,Sitio Arqueológico
20240315,2023,11,Ica,Reserva Arqueologica Lineas y Geoglifos de Nazca,7,Julio,1,0,0,0,0,0,4120,0,0,4120,0,0,0,0,0,0,0,0,0,4120,Sitio Arqueológico
20240315,2023,11,Ica,Reserva Arqueologica Lineas y Geoglifos de Nazca,7,Julio,2,0,0,0,0,0,8845,0,0,8845,0,0,0,0,0,180,0,0,180,9025,Sitio Arqueológico
20240315,2023,11,Ica,Reserva Arqueologica Lineas y Geoglifos de Nazca,8,Agosto,0,0,0,0,0,0,2330,0,0,2330,0,0,0,0,0,320,0,0,320,2650,Sitio Arqueológico
20240315,2023,11,Ica,Reserva Arqueologica Lineas y Geoglifos de Nazca,8,Agosto,1,0,0,0,0,0,3419,0,0,3419,0,0,0,0,0,0,0,0,0,3419,Sitio Arqueológico
20240315,2023,11,Ica,Reserva Arqueologica Lineas y Geoglifos de Nazca,8,Agosto,2,0,0,0,0,0,5749,0,0,5749,0,0,0,0,0,320,0,0,320,6069,Sitio Arqueológico
20240315,2023,11,Ica,Reserva Arqueologica Lineas y Geoglifos de Nazca,9,Setiembre,0,0,0,0,0,0,1650,127,1671,3448,0,0,0,0,0,180,30,15,225,3673,Sitio Arqueológico
20240315,2023,11,Ica,Reserva Arqueologica Lineas y Geoglifos de Nazca,9,Setiembre,1,0,0,0,0,0,1943,0,437,2380,0,0,0,0,0,0,0,0,0,2380,Sitio Arqueológico
20240315,2023,11,Ica,Reserva Arqueologica Lineas y Geoglifos de Nazca,9,Setiembre,2,0,0,0,0,0,3593,127,2108,5828,0,0,0,0,0,180,30,15,225,6053,Sitio Arqueológico
20240315,2023,11,Ica,Reserva Arqueologica Lineas y Geoglifos de Nazca,10,Octubre,0,0,0,0,0,0,2211,622,2405,5238,0,0,0,0,0,155,20,30,205,5443,Sitio Arqueológico
20240315,2023,11,Ica,Reserva Arqueologica Lineas y Geoglifos de Nazca,10,Octubre,1,0,0,0,0,0,2699,35,848,3582,0,0,0,0,0,0,0,0,0,3582,Sitio Arqueológico
20240315,2023,11,Ica,Reserva Arqueologica Lineas y Geoglifos de Nazca,10,Octubre,2,0,0,0,0,0,4910,657,3253,8820,0,0,0,0,0,155,20,30,205,9025,Sitio Arqueológico
20240315,2023,11,Ica,Reserva Arqueologica Lineas y Geoglifos de Nazca,11,Noviembre,0,0,0,0,0,0,1634,72,1910,3616,0,0,0,0,0,95,10,25,130,3746,Sitio Arqueológico
20240315,2023,11,Ica,Reserva Arqueologica Lineas y Geoglifos de Nazca,11,Noviembre,1,0,0,0,0,0,1870,49,1251,3170,0,0,0,0,0,0,0,0,0,3170,Sitio Arqueológico
20240315,2023,11,Ica,Reserva Arqueologica Lineas y Geoglifos de Nazca,11,Noviembre,2,0,0,0,0,0,3504,121,3161,6786,0,0,0,0,0,95,10,25,130,6916,Sitio Arqueológico
20240315,2023,11,Ica,Reserva Arqueologica Lineas y Geoglifos de Nazca,12,Diciembre,0,0,0,0,0,0,1557,0,1447,3004,0,0,0,0,0,95,15,15,125,3129,Sitio Arqueológico
20240315,2023,11,Ica,Reserva Arqueologica Lineas y Geoglifos de Nazca,12,Diciembre,1,0,0,0,0,0,1931,0,903,2834,0,0,0,0,0,0,0,0,0,2834,Sitio Arqueológico
20240315,2023,11,Ica,Reserva Arqueologica Lineas y Geoglifos de Nazca,12,Diciembre,2,0,0,0,0,0,3488,0,2350,5838,0,0,0,0,0,95,15,15,125,5963,Sitio Arqueológico
20240315,2023,13,La Libertad,Complejo Arqueologico Chan Chan (Palacio Nik-An),1,Enero,0,0,0,0,0,0,3418,920,1410,5748,0,0,0,0,0,174,37,92,303,6051,Sitio Arqueológico
20240315,2023,13,La Libertad,Complejo Arqueologico Chan Chan (Palacio Nik-An),1,Enero,1,0,0,0,0,0,664,219,18,901,0,0,0,0,0,0,0,0,0,901,Sitio Arqueológico
20240315,2023,13,La Libertad,Complejo Arqueologico Chan Chan (Palacio Nik-An),1,Enero,2,0,0,0,0,0,4082,1139,1428,6649,0,0,0,0,0,174,37,92,303,6952,Sitio Arqueológico
20240315,2023,13,La Libertad,Complejo Arqueologico Chan Chan (Palacio Nik-An),2,Febrero,0,0,0,0,0,0,4026,1247,1744,7017,0,0,0,0,0,758,248,395,1401,8418,Sitio Arqueológico
20240315,2023,13,La Libertad,Complejo Arqueologico Chan Chan (Palacio Nik-An),2,Febrero,1,0,0,0,0,0,1106,303,0,1409,0,0,0,0,0,0,0,0,0,1409,Sitio Arqueológico
20240315,2023,13,La Libertad,Complejo Arqueologico Chan Chan (Palacio Nik-An),2,Febrero,2,0,0,0,0,0,5132,1550,1744,8426,0,0,0,0,0,758,248,395,1401,9827,Sitio Arqueológico
20240315,2023,13,La Libertad,Complejo Arqueologico Chan Chan (Palacio Nik-An),3,Marzo,0,0,0,0,0,0,1272,366,395,2033,0,0,0,0,0,600,204,340,1144,3177,Sitio Arqueológico
20240315,2023,13,La Libertad,Complejo Arqueologico Chan Chan (Palacio Nik-An),3,Marzo,1,0,0,0,0,0,531,160,1,692,0,0,0,0,0,0,0,0,0,692,Sitio Arqueológico
20240315,2023,13,La Libertad,Complejo Arqueologico Chan Chan (Palacio Nik-An),3,Marzo,2,0,0,0,0,0,1803,526,396,2725,0,0,0,0,0,600,204,340,1144,3869,Sitio Arqueológico
20240315,2023,13,La Libertad,Complejo Arqueologico Chan Chan (Palacio Nik-An),4,Abril,0,0,0,0,0,0,1704,676,418,2798,0,0,0,0,0,352,88,130,570,3368,Sitio Arqueológico
20240315,2023,13,La Libertad,Complejo Arqueologico Chan Chan (Palacio Nik-An),4,Abril,1,0,0,0,0,0,1153,125,114,1392,0,0,0,0,0,0,0,0,0,1392,Sitio Arqueológico
20240315,2023,13,La Libertad,Complejo Arqueologico Chan Chan (Palacio Nik-An),4,Abril,2,0,0,0,0,0,2857,801,532,4190,0,0,0,0,0,352,88,130,570,4760,Sitio Arqueológico
20240315,2023,13,La Libertad,Complejo Arqueologico Chan Chan (Palacio Nik-An),5,Mayo,0,0,0,0,0,0,1363,480,594,2437,0,0,0,0,0,1218,217,141,1576,4013,Sitio Arqueológico
20240315,2023,13,La Libertad,Complejo Arqueologico Chan Chan (Palacio Nik-An),5,Mayo,1,0,0,0,0,0,887,207,29,1123,0,0,0,0,0,0,0,0,0,1123,Sitio Arqueológico
20240315,2023,13,La Libertad,Complejo Arqueologico Chan Chan (Palacio Nik-An),5,Mayo,2,0,0,0,0,0,2250,687,623,3560,0,0,0,0,0,1218,217,141,1576,5136,Sitio Arqueológico
20240315,2023,13,La Libertad,Complejo Arqueologico Chan Chan (Palacio Nik-An),6,Junio,0,0,0,0,0,0,1540,683,887,3110,0,0,0,0,0,1000,193,598,1791,4901,Sitio Arqueológico
20240315,2023,13,La Libertad,Complejo Arqueologico Chan Chan (Palacio Nik-An),6,Junio,1,0,0,0,0,0,783,226,11,1020,0,0,0,0,0,0,0,0,0,1020,Sitio Arqueológico
20240315,2023,13,La Libertad,Complejo Arqueologico Chan Chan (Palacio Nik-An),6,Junio,2,0,0,0,0,0,2323,909,898,4130,0,0,0,0,0,1000,193,598,1791,5921,Sitio Arqueológico
20240315,2023,13,La Libertad,Complejo Arqueologico Chan Chan (Palacio Nik-An),7,Julio,0,0,0,0,0,0,5180,1616,5244,12040,0,0,0,0,0,797,204,625,1626,13666,Sitio Arqueológico
20240315,2023,13,La Libertad,Complejo Arqueologico Chan Chan (Palacio Nik-An),7,Julio,1,0,0,0,0,0,680,210,1,891,0,0,0,0,0,0,0,0,0,891,Sitio Arqueológico
20240315,2023,13,La Libertad,Complejo Arqueologico Chan Chan (Palacio Nik-An),7,Julio,2,0,0,0,0,0,5860,1826,5245,12931,0,0,0,0,0,797,204,625,1626,14557,Sitio Arqueológico
20240315,2023,13,La Libertad,Complejo Arqueologico Chan Chan (Palacio Nik-An),8,Agosto,0,0,0,0,0,0,4164,1381,2993,8538,0,0,0,0,0,1244,522,814,2580,11118,Sitio Arqueológico
20240315,2023,13,La Libertad,Complejo Arqueologico Chan Chan (Palacio Nik-An),8,Agosto,1,0,0,0,0,0,506,169,9,684,0,0,0,0,0,0,0,0,0,684,Sitio Arqueológico
20240315,2023,13,La Libertad,Complejo Arqueologico Chan Chan (Palacio Nik-An),8,Agosto,2,0,0,0,0,0,4670,1550,3002,9222,0,0,0,0,0,1244,522,814,2580,11802,Sitio Arqueológico
20240315,2023,13,La Libertad,Complejo Arqueologico Chan Chan (Palacio Nik-An),9,Setiembre,0,0,0,0,0,0,4059,1636,3571,9266,0,0,0,0,0,1134,413,590,2137,11403,Sitio Arqueológico
20240315,2023,13,La Libertad,Complejo Arqueologico Chan Chan (Palacio Nik-An),9,Setiembre,1,0,0,0,0,0,558,160,0,718,0,0,0,0,0,0,0,0,0,718,Sitio Arqueológico
20240315,2023,13,La Libertad,Complejo Arqueologico Chan Chan (Palacio Nik-An),9,Setiembre,2,0,0,0,0,0,4617,1796,3571,9984,0,0,0,0,0,1134,413,590,2137,12121,Sitio Arqueológico
20240315,2023,13,La Libertad,Complejo Arqueologico Chan Chan (Palacio Nik-An),10,Octubre,0,0,0,0,0,0,4349,1268,3826,9443,0,0,0,0,0,1191,524,612,2327,11770,Sitio Arqueológico
20240315,2023,13,La Libertad,Complejo Arqueologico Chan Chan (Palacio Nik-An),10,Octubre,1,0,0,0,0,0,881,210,15,1106,0,0,0,0,0,0,0,0,0,1106,Sitio Arqueológico
20240315,2023,13,La Libertad,Complejo Arqueologico Chan Chan (Palacio Nik-An),10,Octubre,2,0,0,0,0,0,5230,1478,3841,10549,0,0,0,0,0,1191,524,612,2327,12876,Sitio Arqueológico
20240315,2023,13,La Libertad,Complejo Arqueologico Chan Chan (Palacio Nik-An),11,Noviembre,0,0,0,0,0,0,2950,983,3055,6988,0,0,0,0,0,940,298,646,1884,8872,Sitio Arqueológico
20240315,2023,13,La Libertad,Complejo Arqueologico Chan Chan (Palacio Nik-An),11,Noviembre,1,0,0,0,0,0,614,139,0,753,0,0,0,0,0,0,0,0,0,753,Sitio Arqueológico
20240315,2023,13,La Libertad,Complejo Arqueologico Chan Chan (Palacio Nik-An),11,Noviembre,2,0,0,0,0,0,3564,1122,3055,7741,0,0,0,0,0,940,298,646,1884,9625,Sitio Arqueológico
20240315,2023,13,La Libertad,Complejo Arqueologico Chan Chan (Palacio Nik-An),12,Diciembre,0,0,0,0,0,0,2665,803,1227,4695,0,0,0,0,0,852,238,401,1491,6186,Sitio Arqueológico
20240315,2023,13,La Libertad,Complejo Arqueologico Chan Chan (Palacio Nik-An),12,Diciembre,1,0,0,0,0,0,731,81,58,870,0,0,0,0,0,0,0,0,0,870,Sitio Arqueológico
20240315,2023,13,La Libertad,Complejo Arqueologico Chan Chan (Palacio Nik-An),12,Diciembre,2,0,0,0,0,0,3396,884,1285,5565,0,0,0,0,0,852,238,401,1491,7056,Sitio Arqueológico
20240315,2023,13,La Libertad,Zona Arqueologica Monumental Huaca del Sol y de La Luna,1,Enero,0,0,0,0,0,0,3317,1190,1276,5783,0,0,0,0,0,0,0,0,0,5783,Sitio Arqueológico
20240315,2023,13,La Libertad,Zona Arqueologica Monumental Huaca del Sol y de La Luna,1,Enero,1,0,0,0,0,0,837,214,112,1163,0,0,0,0,0,0,0,0,0,1163,Sitio Arqueológico
20240315,2023,13,La Libertad,Zona Arqueologica Monumental Huaca del Sol y de La Luna,1,Enero,2,0,0,0,0,0,4154,1404,1388,6946,0,0,0,0,0,0,0,0,0,6946,Sitio Arqueológico
20240315,2023,13,La Libertad,Zona Arqueologica Monumental Huaca del Sol y de La Luna,2,Febrero,0,0,0,0,0,0,4327,1515,1712,7554,0,0,0,0,0,435,30,127,592,8146,Sitio Arqueológico
20240315,2023,13,La Libertad,Zona Arqueologica Monumental Huaca del Sol y de La Luna,2,Febrero,1,0,0,0,0,0,745,160,76,981,0,0,0,0,0,0,0,0,0,981,Sitio Arqueológico
20240315,2023,13,La Libertad,Zona Arqueologica Monumental Huaca del Sol y de La Luna,2,Febrero,2,0,0,0,0,0,5072,1675,1788,8535,0,0,0,0,0,435,30,127,592,9127,Sitio Arqueológico
20240315,2023,13,La Libertad,Zona Arqueologica Monumental Huaca del Sol y de La Luna,3,Marzo,0,0,0,0,0,0,1513,504,357,2374,0,0,0,0,0,548,40,154,742,3116,Sitio Arqueológico
20240315,2023,13,La Libertad,Zona Arqueologica Monumental Huaca del Sol y de La Luna,3,Marzo,1,0,0,0,0,0,336,125,36,497,0,0,0,0,0,0,0,0,0,497,Sitio Arqueológico
20240315,2023,13,La Libertad,Zona Arqueologica Monumental Huaca del Sol y de La Luna,3,Marzo,2,0,0,0,0,0,1849,629,393,2871,0,0,0,0,0,548,40,154,742,3613,Sitio Arqueológico
20240315,2023,13,La Libertad,Zona Arqueologica Monumental Huaca del Sol y de La Luna,4,Abril,0,0,0,0,0,0,2315,907,581,3803,0,0,0,0,0,552,213,46,811,4614,Sitio Arqueológico
20240315,2023,13,La Libertad,Zona Arqueologica Monumental Huaca del Sol y de La Luna,4,Abril,1,0,0,0,0,0,261,12,59,332,0,0,0,0,0,0,0,0,0,332,Sitio Arqueológico
20240315,2023,13,La Libertad,Zona Arqueologica Monumental Huaca del Sol y de La Luna,4,Abril,2,0,0,0,0,0,2576,919,640,4135,0,0,0,0,0,552,213,46,811,4946,Sitio Arqueológico
20240315,2023,13,La Libertad,Zona Arqueologica Monumental Huaca del Sol y de La Luna,5,Mayo,0,0,0,0,0,0,1617,779,836,3232,0,0,0,0,0,268,66,89,423,3655,Sitio Arqueológico
20240315,2023,13,La Libertad,Zona Arqueologica Monumental Huaca del Sol y de La Luna,5,Mayo,1,0,0,0,0,0,563,160,19,742,0,0,0,0,0,0,0,0,0,742,Sitio Arqueológico
20240315,2023,13,La Libertad,Zona Arqueologica Monumental Huaca del Sol y de La Luna,5,Mayo,2,0,0,0,0,0,2180,939,855,3974,0,0,0,0,0,268,66,89,423,4397,Sitio Arqueológico
20240315,2023,13,La Libertad,Zona Arqueologica Monumental Huaca del Sol y de La Luna,6,Junio,0,0,0,0,0,0,2153,874,2013,5040,0,0,0,0,0,275,22,117,414,5454,Sitio Arqueológico
20240315,2023,13,La Libertad,Zona Arqueologica Monumental Huaca del Sol y de La Luna,6,Junio,1,0,0,0,0,0,612,157,46,815,0,0,0,0,0,0,0,0,0,815,Sitio Arqueológico
20240315,2023,13,La Libertad,Zona Arqueologica Monumental Huaca del Sol y de La Luna,6,Junio,2,0,0,0,0,0,2765,1031,2059,5855,0,0,0,0,0,275,22,117,414,6269,Sitio Arqueológico
20240315,2023,13,La Libertad,Zona Arqueologica Monumental Huaca del Sol y de La Luna,7,Julio,0,0,0,0,0,0,6366,2198,7421,15985,0,0,0,0,0,445,28,221,694,16679,Sitio Arqueológico
20240315,2023,13,La Libertad,Zona Arqueologica Monumental Huaca del Sol y de La Luna,7,Julio,1,0,0,0,0,0,710,211,111,1032,0,0,0,0,0,0,0,0,0,1032,Sitio Arqueológico
20240315,2023,13,La Libertad,Zona Arqueologica Monumental Huaca del Sol y de La Luna,7,Julio,2,0,0,0,0,0,7076,2409,7532,17017,0,0,0,0,0,445,28,221,694,17711,Sitio Arqueológico
20240315,2023,13,La Libertad,Zona Arqueologica Monumental Huaca del Sol y de La Luna,8,Agosto,0,0,0,0,0,0,5251,1728,4749,11728,0,0,0,0,0,483,68,137,688,12416,Sitio Arqueológico
20240315,2023,13,La Libertad,Zona Arqueologica Monumental Huaca del Sol y de La Luna,8,Agosto,1,0,0,0,0,0,790,212,22,1024,0,0,0,0,0,0,0,0,0,1024,Sitio Arqueológico
20240315,2023,13,La Libertad,Zona Arqueologica Monumental Huaca del Sol y de La Luna,8,Agosto,2,0,0,0,0,0,6041,1940,4771,12752,0,0,0,0,0,483,68,137,688,13440,Sitio Arqueológico
20240315,2023,13,La Libertad,Zona Arqueologica Monumental Huaca del Sol y de La Luna,9,Setiembre,0,0,0,0,0,0,2799,1183,4222,8204,0,0,0,0,0,177,2,453,632,8836,Sitio Arqueológico
20240315,2023,13,La Libertad,Zona Arqueologica Monumental Huaca del Sol y de La Luna,9,Setiembre,1,0,0,0,0,0,738,222,24,984,0,0,0,0,0,0,0,0,0,984,Sitio Arqueológico
20240315,2023,13,La Libertad,Zona Arqueologica Monumental Huaca del Sol y de La Luna,9,Setiembre,2,0,0,0,0,0,3537,1405,4246,9188,0,0,0,0,0,177,2,453,632,9820,Sitio Arqueológico
20240315,2023,13,La Libertad,Zona Arqueologica Monumental Huaca del Sol y de La Luna,10,Octubre,0,0,0,0,0,0,2906,1232,3711,7849,0,0,0,0,0,292,23,179,494,8343,Sitio Arqueológico
20240315,2023,13,La Libertad,Zona Arqueologica Monumental Huaca del Sol y de La Luna,10,Octubre,1,0,0,0,0,0,1315,260,39,1614,0,0,0,0,0,0,0,0,0,1614,Sitio Arqueológico
20240315,2023,13,La Libertad,Zona Arqueologica Monumental Huaca del Sol y de La Luna,10,Octubre,2,0,0,0,0,0,4221,1492,3750,9463,0,0,0,0,0,292,23,179,494,9957,Sitio Arqueológico
20240315,2023,13,La Libertad,Zona Arqueologica Monumental Huaca del Sol y de La Luna,11,Noviembre,0,0,0,0,0,0,2543,1236,3347,7126,0,0,0,0,0,562,31,347,940,8066,Sitio Arqueológico
20240315,2023,13,La Libertad,Zona Arqueologica Monumental Huaca del Sol y de La Luna,11,Noviembre,1,0,0,0,0,0,778,243,25,1046,0,0,0,0,0,0,0,0,0,1046,Sitio Arqueológico
20240315,2023,13,La Libertad,Zona Arqueologica Monumental Huaca del Sol y de La Luna,11,Noviembre,2,0,0,0,0,0,3321,1479,3372,8172,0,0,0,0,0,562,31,347,940,9112,Sitio Arqueológico
20240315,2023,13,La Libertad,Zona Arqueologica Monumental Huaca del Sol y de La Luna,12,Diciembre,0,0,0,0,0,0,2376,894,1111,4381,0,0,0,0,0,360,2,127,489,4870,Sitio Arqueológico
20240315,2023,13,La Libertad,Zona Arqueologica Monumental Huaca del Sol y de La Luna,12,Diciembre,1,0,0,0,0,0,1270,256,102,1628,0,0,0,0,0,0,0,0,0,1628,Sitio Arqueológico
20240315,2023,13,La Libertad,Zona Arqueologica Monumental Huaca del Sol y de La Luna,12,Diciembre,2,0,0,0,0,0,3646,1150,1213,6009,0,0,0,0,0,360,2,127,489,6498,Sitio Arqueológico
20240315,2023,13,La Libertad,Zona Arqueologica Monumental El Brujo,1,Enero,0,0,0,0,0,0,872,427,220,1519,0,0,0,0,0,43,9,18,70,1589,Sitio Arqueológico
20240315,2023,13,La Libertad,Zona Arqueologica Monumental El Brujo,1,Enero,1,0,0,0,0,0,183,72,6,261,0,0,0,0,0,0,0,0,0,261,Sitio Arqueológico
20240315,2023,13,La Libertad,Zona Arqueologica Monumental El Brujo,1,Enero,2,0,0,0,0,0,1055,499,226,1780,0,0,0,0,0,43,9,18,70,1850,Sitio Arqueológico
20240315,2023,13,La Libertad,Zona Arqueologica Monumental El Brujo,2,Febrero,0,0,0,0,0,0,1029,623,315,1967,0,0,0,0,0,240,170,101,511,2478,Sitio Arqueológico
20240315,2023,13,La Libertad,Zona Arqueologica Monumental El Brujo,2,Febrero,1,0,0,0,0,0,190,32,0,222,0,0,0,0,0,0,0,0,0,222,Sitio Arqueológico
20240315,2023,13,La Libertad,Zona Arqueologica Monumental El Brujo,2,Febrero,2,0,0,0,0,0,1219,655,315,2189,0,0,0,0,0,240,170,101,511,2700,Sitio Arqueológico
20240315,2023,13,La Libertad,Zona Arqueologica Monumental El Brujo,3,Marzo,0,0,0,0,0,0,226,115,72,413,0,0,0,0,0,197,140,112,449,862,Sitio Arqueológico
20240315,2023,13,La Libertad,Zona Arqueologica Monumental El Brujo,3,Marzo,1,0,0,0,0,0,64,21,1,86,0,0,0,0,0,0,0,0,0,86,Sitio Arqueológico
20240315,2023,13,La Libertad,Zona Arqueologica Monumental El Brujo,3,Marzo,2,0,0,0,0,0,290,136,73,499,0,0,0,0,0,197,140,112,449,948,Sitio Arqueológico
20240315,2023,13,La Libertad,Zona Arqueologica Monumental El Brujo,4,Abril,0,0,0,0,0,0,681,313,106,1100,0,0,0,0,0,93,83,51,227,1327,Sitio Arqueológico
20240315,2023,13,La Libertad,Zona Arqueologica Monumental El Brujo,4,Abril,1,0,0,0,0,0,118,28,0,146,0,0,0,0,0,0,0,0,0,146,Sitio Arqueológico
20240315,2023,13,La Libertad,Zona Arqueologica Monumental El Brujo,4,Abril,2,0,0,0,0,0,799,341,106,1246,0,0,0,0,0,93,83,51,227,1473,Sitio Arqueológico
20240315,2023,13,La Libertad,Zona Arqueologica Monumental El Brujo,5,Mayo,0,0,0,0,0,0,458,304,362,1124,0,0,0,0,0,142,122,371,635,1759,Sitio Arqueológico
20240315,2023,13,La Libertad,Zona Arqueologica Monumental El Brujo,5,Mayo,1,0,0,0,0,0,84,44,6,134,0,0,0,0,0,0,0,0,0,134,Sitio Arqueológico
20240315,2023,13,La Libertad,Zona Arqueologica Monumental El Brujo,5,Mayo,2,0,0,0,0,0,542,348,368,1258,0,0,0,0,0,142,122,371,635,1893,Sitio Arqueológico
20240315,2023,13,La Libertad,Zona Arqueologica Monumental El Brujo,6,Junio,0,0,0,0,0,0,841,421,1698,2960,0,0,0,0,0,131,97,482,710,3670,Sitio Arqueológico
20240315,2023,13,La Libertad,Zona Arqueologica Monumental El Brujo,6,Junio,1,0,0,0,0,0,129,25,0,154,0,0,0,0,0,0,0,0,0,154,Sitio Arqueológico
20240315,2023,13,La Libertad,Zona Arqueologica Monumental El Brujo,6,Junio,2,0,0,0,0,0,970,446,1698,3114,0,0,0,0,0,131,97,482,710,3824,Sitio Arqueológico
20240315,2023,13,La Libertad,Zona Arqueologica Monumental El Brujo,7,Julio,0,0,0,0,0,0,2261,1002,3199,6462,0,0,0,0,0,268,154,392,814,7276,Sitio Arqueológico
20240315,2023,13,La Libertad,Zona Arqueologica Monumental El Brujo,7,Julio,1,0,0,0,0,0,195,51,11,257,0,0,0,0,0,0,0,0,0,257,Sitio Arqueológico
20240315,2023,13,La Libertad,Zona Arqueologica Monumental El Brujo,7,Julio,2,0,0,0,0,0,2456,1053,3210,6719,0,0,0,0,0,268,154,392,814,7533,Sitio Arqueológico
20240315,2023,13,La Libertad,Zona Arqueologica Monumental El Brujo,8,Agosto,0,0,0,0,0,0,1813,789,2867,5469,0,0,0,0,0,279,197,158,634,6103,Sitio Arqueológico
20240315,2023,13,La Libertad,Zona Arqueologica Monumental El Brujo,8,Agosto,1,0,0,0,0,0,157,39,4,200,0,0,0,0,0,0,0,0,0,200,Sitio Arqueológico
20240315,2023,13,La Libertad,Zona Arqueologica Monumental El Brujo,8,Agosto,2,0,0,0,0,0,1970,828,2871,5669,0,0,0,0,0,279,197,158,634,6303,Sitio Arqueológico
20240315,2023,13,La Libertad,Zona Arqueologica Monumental El Brujo,9,Setiembre,0,0,0,0,0,0,1114,620,2029,3763,0,0,0,0,0,336,146,282,764,4527,Sitio Arqueológico
20240315,2023,13,La Libertad,Zona Arqueologica Monumental El Brujo,9,Setiembre,1,0,0,0,0,0,186,69,1,256,0,0,0,0,0,0,0,0,0,256,Sitio Arqueológico
20240315,2023,13,La Libertad,Zona Arqueologica Monumental El Brujo,9,Setiembre,2,0,0,0,0,0,1300,689,2030,4019,0,0,0,0,0,336,146,282,764,4783,Sitio Arqueológico
20240315,2023,13,La Libertad,Zona Arqueologica Monumental El Brujo,10,Octubre,0,0,0,0,0,0,1052,663,1409,3124,0,0,0,0,0,319,153,184,656,3780,Sitio Arqueológico
20240315,2023,13,La Libertad,Zona Arqueologica Monumental El Brujo,10,Octubre,1,0,0,0,0,0,247,53,4,304,0,0,0,0,0,0,0,0,0,304,Sitio Arqueológico
20240315,2023,13,La Libertad,Zona Arqueologica Monumental El Brujo,10,Octubre,2,0,0,0,0,0,1299,716,1413,3428,0,0,0,0,0,319,153,184,656,4084,Sitio Arqueológico
20240315,2023,13,La Libertad,Zona Arqueologica Monumental El Brujo,11,Noviembre,0,0,0,0,0,0,782,572,1454,2808,0,0,0,0,0,379,132,102,613,3421,Sitio Arqueológico
20240315,2023,13,La Libertad,Zona Arqueologica Monumental El Brujo,11,Noviembre,1,0,0,0,0,0,155,99,4,258,0,0,0,0,0,0,0,0,0,258,Sitio Arqueológico
20240315,2023,13,La Libertad,Zona Arqueologica Monumental El Brujo,11,Noviembre,2,0,0,0,0,0,937,671,1458,3066,0,0,0,0,0,379,132,102,613,3679,Sitio Arqueológico
20240315,2023,13,La Libertad,Zona Arqueologica Monumental El Brujo,12,Diciembre,0,0,0,0,0,0,625,315,172,1112,0,0,0,0,0,217,100,187,504,1616,Sitio Arqueológico
20240315,2023,13,La Libertad,Zona Arqueologica Monumental El Brujo,12,Diciembre,1,0,0,0,0,0,316,48,6,370,0,0,0,0,0,0,0,0,0,370,Sitio Arqueológico
20240315,2023,13,La Libertad,Zona Arqueologica Monumental El Brujo,12,Diciembre,2,0,0,0,0,0,941,363,178,1482,0,0,0,0,0,217,100,187,504,1986,Sitio Arqueológico
20240315,2023,13,La Libertad,Sitio Arqueologico Huaca Arco Iris (Huaca El Dragon),1,Enero,0,0,0,0,0,0,0,0,0,0,0,0,0,0,0,0,0,0,0,0,Sitio Arqueológico
20240315,2023,13,La Libertad,Sitio Arqueologico Huaca Arco Iris (Huaca El Dragon),1,Enero,1,0,0,0,0,0,0,0,0,0,0,0,0,0,0,0,0,0,0,0,Sitio Arqueológico
20240315,2023,13,La Libertad,Sitio Arqueologico Huaca Arco Iris (Huaca El Dragon),1,Enero,2,0,0,0,0,0,0,0,0,0,0,0,0,0,0,0,0,0,0,0,Sitio Arqueológico
20240315,2023,13,La Libertad,Sitio Arqueologico Huaca Arco Iris (Huaca El Dragon),2,Febrero,0,0,0,0,0,0,0,0,0,0,0,0,0,0,0,0,0,0,0,0,Sitio Arqueológico
20240315,2023,13,La Libertad,Sitio Arqueologico Huaca Arco Iris (Huaca El Dragon),2,Febrero,1,0,0,0,0,0,0,0,0,0,0,0,0,0,0,0,0,0,0,0,Sitio Arqueológico
20240315,2023,13,La Libertad,Sitio Arqueologico Huaca Arco Iris (Huaca El Dragon),2,Febrero,2,0,0,0,0,0,0,0,0,0,0,0,0,0,0,0,0,0,0,0,Sitio Arqueológico
20240315,2023,13,La Libertad,Sitio Arqueologico Huaca Arco Iris (Huaca El Dragon),3,Marzo,0,0,0,0,0,0,0,0,0,0,0,0,0,0,0,0,0,0,0,0,Sitio Arqueológico
20240315,2023,13,La Libertad,Sitio Arqueologico Huaca Arco Iris (Huaca El Dragon),3,Marzo,1,0,0,0,0,0,0,0,0,0,0,0,0,0,0,0,0,0,0,0,Sitio Arqueológico
20240315,2023,13,La Libertad,Sitio Arqueologico Huaca Arco Iris (Huaca El Dragon),3,Marzo,2,0,0,0,0,0,0,0,0,0,0,0,0,0,0,0,0,0,0,0,Sitio Arqueológico
20240315,2023,13,La Libertad,Sitio Arqueologico Huaca Arco Iris (Huaca El Dragon),4,Abril,0,0,0,0,0,0,0,0,0,0,0,0,0,0,0,0,0,0,0,0,Sitio Arqueológico
20240315,2023,13,La Libertad,Sitio Arqueologico Huaca Arco Iris (Huaca El Dragon),4,Abril,1,0,0,0,0,0,0,0,0,0,0,0,0,0,0,0,0,0,0,0,Sitio Arqueológico
20240315,2023,13,La Libertad,Sitio Arqueologico Huaca Arco Iris (Huaca El Dragon),4,Abril,2,0,0,0,0,0,0,0,0,0,0,0,0,0,0,0,0,0,0,0,Sitio Arqueológico
20240315,2023,13,La Libertad,Sitio Arqueologico Huaca Arco Iris (Huaca El Dragon),5,Mayo,0,0,0,0,0,0,0,0,0,0,0,0,0,0,0,0,0,0,0,0,Sitio Arqueológico
20240315,2023,13,La Libertad,Sitio Arqueologico Huaca Arco Iris (Huaca El Dragon),5,Mayo,1,0,0,0,0,0,0,0,0,0,0,0,0,0,0,0,0,0,0,0,Sitio Arqueológico
20240315,2023,13,La Libertad,Sitio Arqueologico Huaca Arco Iris (Huaca El Dragon),5,Mayo,2,0,0,0,0,0,0,0,0,0,0,0,0,0,0,0,0,0,0,0,Sitio Arqueológico
20240315,2023,13,La Libertad,Sitio Arqueologico Huaca Arco Iris (Huaca El Dragon),6,Junio,0,0,0,0,0,0,0,0,0,0,0,0,0,0,0,0,0,0,0,0,Sitio Arqueológico
20240315,2023,13,La Libertad,Sitio Arqueologico Huaca Arco Iris (Huaca El Dragon),6,Junio,1,0,0,0,0,0,0,0,0,0,0,0,0,0,0,0,0,0,0,0,Sitio Arqueológico
20240315,2023,13,La Libertad,Sitio Arqueologico Huaca Arco Iris (Huaca El Dragon),6,Junio,2,0,0,0,0,0,0,0,0,0,0,0,0,0,0,0,0,0,0,0,Sitio Arqueológico
20240315,2023,13,La Libertad,Sitio Arqueologico Huaca Arco Iris (Huaca El Dragon),7,Julio,0,0,0,0,0,0,0,0,0,0,0,0,0,0,0,0,0,0,0,0,Sitio Arqueológico
20240315,2023,13,La Libertad,Sitio Arqueologico Huaca Arco Iris (Huaca El Dragon),7,Julio,1,0,0,0,0,0,0,0,0,0,0,0,0,0,0,0,0,0,0,0,Sitio Arqueológico
20240315,2023,13,La Libertad,Sitio Arqueologico Huaca Arco Iris (Huaca El Dragon),7,Julio,2,0,0,0,0,0,0,0,0,0,0,0,0,0,0,0,0,0,0,0,Sitio Arqueológico
20240315,2023,13,La Libertad,Sitio Arqueologico Huaca Arco Iris (Huaca El Dragon),8,Agosto,0,0,0,0,0,0,0,0,0,0,0,0,0,0,0,0,0,0,0,0,Sitio Arqueológico
20240315,2023,13,La Libertad,Sitio Arqueologico Huaca Arco Iris (Huaca El Dragon),8,Agosto,1,0,0,0,0,0,0,0,0,0,0,0,0,0,0,0,0,0,0,0,Sitio Arqueológico
20240315,2023,13,La Libertad,Sitio Arqueologico Huaca Arco Iris (Huaca El Dragon),8,Agosto,2,0,0,0,0,0,0,0,0,0,0,0,0,0,0,0,0,0,0,0,Sitio Arqueológico
20240315,2023,13,La Libertad,Sitio Arqueologico Huaca Arco Iris (Huaca El Dragon),9,Setiembre,0,0,0,0,0,0,0,0,0,0,0,0,0,0,0,0,0,0,0,0,Sitio Arqueológico
20240315,2023,13,La Libertad,Sitio Arqueologico Huaca Arco Iris (Huaca El Dragon),9,Setiembre,1,0,0,0,0,0,0,0,0,0,0,0,0,0,0,0,0,0,0,0,Sitio Arqueológico
20240315,2023,13,La Libertad,Sitio Arqueologico Huaca Arco Iris (Huaca El Dragon),9,Setiembre,2,0,0,0,0,0,0,0,0,0,0,0,0,0,0,0,0,0,0,0,Sitio Arqueológico
20240315,2023,13,La Libertad,Sitio Arqueologico Huaca Arco Iris (Huaca El Dragon),10,Octubre,0,0,0,0,0,0,0,0,0,0,0,0,0,0,0,0,0,0,0,0,Sitio Arqueológico
20240315,2023,13,La Libertad,Sitio Arqueologico Huaca Arco Iris (Huaca El Dragon),10,Octubre,1,0,0,0,0,0,0,0,0,0,0,0,0,0,0,0,0,0,0,0,Sitio Arqueológico
20240315,2023,13,La Libertad,Sitio Arqueologico Huaca Arco Iris (Huaca El Dragon),10,Octubre,2,0,0,0,0,0,0,0,0,0,0,0,0,0,0,0,0,0,0,0,Sitio Arqueológico
20240315,2023,13,La Libertad,Sitio Arqueologico Huaca Arco Iris (Huaca El Dragon),11,Noviembre,0,0,0,0,0,0,0,0,0,0,0,0,0,0,0,0,0,0,0,0,Sitio Arqueológico
20240315,2023,13,La Libertad,Sitio Arqueologico Huaca Arco Iris (Huaca El Dragon),11,Noviembre,1,0,0,0,0,0,0,0,0,0,0,0,0,0,0,0,0,0,0,0,Sitio Arqueológico
20240315,2023,13,La Libertad,Sitio Arqueologico Huaca Arco Iris (Huaca El Dragon),11,Noviembre,2,0,0,0,0,0,0,0,0,0,0,0,0,0,0,0,0,0,0,0,Sitio Arqueológico
20240315,2023,13,La Libertad,Sitio Arqueologico Huaca Arco Iris (Huaca El Dragon),12,Diciembre,0,0,0,0,0,0,0,0,0,0,0,0,0,0,0,0,0,0,0,0,Sitio Arqueológico
20240315,2023,13,La Libertad,Sitio Arqueologico Huaca Arco Iris (Huaca El Dragon),12,Diciembre,1,0,0,0,0,0,0,0,0,0,0,0,0,0,0,0,0,0,0,0,Sitio Arqueológico
20240315,2023,13,La Libertad,Sitio Arqueologico Huaca Arco Iris (Huaca El Dragon),12,Diciembre,2,0,0,0,0,0,0,0,0,0,0,0,0,0,0,0,0,0,0,0,Sitio Arqueológico
20240315,2023,14,Lambayeque,Sitio Arqueologico Cerro Ventarron,1,Enero,0,0,0,0,0,0,27,0,12,39,0,0,0,0,0,0,0,0,0,39,Sitio Arqueológico
20240315,2023,14,Lambayeque,Sitio Arqueologico Cerro Ventarron,1,Enero,1,0,0,0,0,0,3,0,0,3,0,0,0,0,0,0,0,0,0,3,Sitio Arqueológico
20240315,2023,14,Lambayeque,Sitio Arqueologico Cerro Ventarron,1,Enero,2,0,0,0,0,0,30,0,12,42,0,0,0,0,0,0,0,0,0,42,Sitio Arqueológico
20240315,2023,14,Lambayeque,Sitio Arqueologico Cerro Ventarron,2,Febrero,0,0,0,0,0,0,11,11,8,30,0,0,0,0,0,5,0,0,5,35,Sitio Arqueológico
20240315,2023,14,Lambayeque,Sitio Arqueologico Cerro Ventarron,2,Febrero,1,0,0,0,0,0,0,0,0,0,0,0,0,0,0,0,0,0,0,0,Sitio Arqueológico
20240315,2023,14,Lambayeque,Sitio Arqueologico Cerro Ventarron,2,Febrero,2,0,0,0,0,0,11,11,8,30,0,0,0,0,0,5,0,0,5,35,Sitio Arqueológico
20240315,2023,14,Lambayeque,Sitio Arqueologico Cerro Ventarron,3,Marzo,0,0,0,0,0,0,0,0,0,0,0,0,0,0,0,0,0,0,0,0,Sitio Arqueológico
20240315,2023,14,Lambayeque,Sitio Arqueologico Cerro Ventarron,3,Marzo,1,0,0,0,0,0,0,0,0,0,0,0,0,0,0,0,0,0,0,0,Sitio Arqueológico
20240315,2023,14,Lambayeque,Sitio Arqueologico Cerro Ventarron,3,Marzo,2,0,0,0,0,0,0,0,0,0,0,0,0,0,0,0,0,0,0,0,Sitio Arqueológico
20240315,2023,14,Lambayeque,Sitio Arqueologico Cerro Ventarron,4,Abril,0,0,0,0,0,0,8,43,0,51,0,0,0,0,0,0,0,0,0,51,Sitio Arqueológico
20240315,2023,14,Lambayeque,Sitio Arqueologico Cerro Ventarron,4,Abril,1,0,0,0,0,0,3,0,0,3,0,0,0,0,0,0,0,0,0,3,Sitio Arqueológico
20240315,2023,14,Lambayeque,Sitio Arqueologico Cerro Ventarron,4,Abril,2,0,0,0,0,0,11,43,0,54,0,0,0,0,0,0,0,0,0,54,Sitio Arqueológico
20240315,2023,14,Lambayeque,Sitio Arqueologico Cerro Ventarron,5,Mayo,0,0,0,0,0,0,5,6,0,11,0,0,0,0,0,0,0,0,0,11,Sitio Arqueológico
20240315,2023,14,Lambayeque,Sitio Arqueologico Cerro Ventarron,5,Mayo,1,0,0,0,0,0,13,0,0,13,0,0,0,0,0,0,0,0,0,13,Sitio Arqueológico
20240315,2023,14,Lambayeque,Sitio Arqueologico Cerro Ventarron,5,Mayo,2,0,0,0,0,0,18,6,0,24,0,0,0,0,0,0,0,0,0,24,Sitio Arqueológico
20240315,2023,14,Lambayeque,Sitio Arqueologico Cerro Ventarron,6,Junio,0,0,0,0,0,0,15,8,0,23,0,0,0,0,0,0,0,0,0,23,Sitio Arqueológico
20240315,2023,14,Lambayeque,Sitio Arqueologico Cerro Ventarron,6,Junio,1,0,0,0,0,0,19,0,0,19,0,0,0,0,0,0,0,0,0,19,Sitio Arqueológico
20240315,2023,14,Lambayeque,Sitio Arqueologico Cerro Ventarron,6,Junio,2,0,0,0,0,0,34,8,0,42,0,0,0,0,0,0,0,0,0,42,Sitio Arqueológico
20240315,2023,14,Lambayeque,Sitio Arqueologico Cerro Ventarron,7,Julio,0,0,0,0,0,0,69,1,6,76,0,0,0,0,0,0,0,0,0,76,Sitio Arqueológico
20240315,2023,14,Lambayeque,Sitio Arqueologico Cerro Ventarron,7,Julio,1,0,0,0,0,0,0,0,0,0,0,0,0,0,0,0,0,0,0,0,Sitio Arqueológico
20240315,2023,14,Lambayeque,Sitio Arqueologico Cerro Ventarron,7,Julio,2,0,0,0,0,0,69,1,6,76,0,0,0,0,0,0,0,0,0,76,Sitio Arqueológico
20240315,2023,14,Lambayeque,Sitio Arqueologico Cerro Ventarron,8,Agosto,0,0,0,0,0,0,18,5,0,23,0,0,0,0,2,2,2,4,10,33,Sitio Arqueológico
20240315,2023,14,Lambayeque,Sitio Arqueologico Cerro Ventarron,8,Agosto,1,0,0,0,0,0,7,0,0,7,0,0,0,0,0,0,0,0,0,7,Sitio Arqueológico
20240315,2023,14,Lambayeque,Sitio Arqueologico Cerro Ventarron,8,Agosto,2,0,0,0,0,0,25,5,0,30,0,0,0,0,2,2,2,4,10,40,Sitio Arqueológico
20240315,2023,14,Lambayeque,Sitio Arqueologico Cerro Ventarron,9,Setiembre,0,0,0,0,0,21,81,50,398,550,0,0,0,0,0,0,0,0,0,550,Sitio Arqueológico
20240315,2023,14,Lambayeque,Sitio Arqueologico Cerro Ventarron,9,Setiembre,1,0,0,0,0,0,21,0,0,21,0,0,0,0,0,0,0,0,0,21,Sitio Arqueológico
20240315,2023,14,Lambayeque,Sitio Arqueologico Cerro Ventarron,9,Setiembre,2,0,0,0,0,21,102,50,398,571,0,0,0,0,0,0,0,0,0,571,Sitio Arqueológico
20240315,2023,14,Lambayeque,Sitio Arqueologico Cerro Ventarron,10,Octubre,0,0,0,0,0,0,30,23,20,73,0,0,0,0,0,0,0,0,0,73,Sitio Arqueológico
20240315,2023,14,Lambayeque,Sitio Arqueologico Cerro Ventarron,10,Octubre,1,0,0,0,0,0,18,0,0,18,0,0,0,0,0,0,0,0,0,18,Sitio Arqueológico
20240315,2023,14,Lambayeque,Sitio Arqueologico Cerro Ventarron,10,Octubre,2,0,0,0,0,0,48,23,20,91,0,0,0,0,0,0,0,0,0,91,Sitio Arqueológico
20240315,2023,14,Lambayeque,Sitio Arqueologico Cerro Ventarron,11,Noviembre,0,0,0,0,0,0,24,23,6,53,0,0,0,0,0,0,0,0,0,53,Sitio Arqueológico
20240315,2023,14,Lambayeque,Sitio Arqueologico Cerro Ventarron,11,Noviembre,1,0,0,0,0,0,12,0,0,12,0,0,0,0,0,0,0,0,0,12,Sitio Arqueológico
20240315,2023,14,Lambayeque,Sitio Arqueologico Cerro Ventarron,11,Noviembre,2,0,0,0,0,0,36,23,6,65,0,0,0,0,0,0,0,0,0,65,Sitio Arqueológico
20240315,2023,14,Lambayeque,Sitio Arqueologico Cerro Ventarron,12,Diciembre,0,0,0,0,0,0,9,2,34,45,0,0,0,0,0,0,0,0,0,45,Sitio Arqueológico
20240315,2023,14,Lambayeque,Sitio Arqueologico Cerro Ventarron,12,Diciembre,1,0,0,0,0,0,2,0,0,2,0,0,0,0,0,0,0,0,0,2,Sitio Arqueológico
20240315,2023,14,Lambayeque,Sitio Arqueologico Cerro Ventarron,12,Diciembre,2,0,0,0,0,0,11,2,34,47,0,0,0,0,0,0,0,0,0,47,Sitio Arqueológico
20240315,2023,15,Lima,Sitio Arqueologico Caral,1,Enero,0,0,0,0,0,0,1215,219,579,2013,0,0,0,0,0,406,0,0,406,2419,Sitio Arqueológico
20240315,2023,15,Lima,Sitio Arqueologico Caral,1,Enero,1,0,0,0,0,0,27,9,0,36,0,0,0,0,0,0,0,0,0,36,Sitio Arqueológico
20240315,2023,15,Lima,Sitio Arqueologico Caral,1,Enero,2,0,0,0,0,0,1242,228,579,2049,0,0,0,0,0,406,0,0,406,2455,Sitio Arqueológico
20240315,2023,15,Lima,Sitio Arqueologico Caral,2,Febrero,0,0,0,0,0,0,939,245,568,1752,0,0,0,0,0,241,4,2,247,1999,Sitio Arqueológico
20240315,2023,15,Lima,Sitio Arqueologico Caral,2,Febrero,1,0,0,0,0,0,31,4,21,56,0,0,0,0,0,3,1,0,4,60,Sitio Arqueológico
20240315,2023,15,Lima,Sitio Arqueologico Caral,2,Febrero,2,0,0,0,0,0,970,249,589,1808,0,0,0,0,0,244,5,2,251,2059,Sitio Arqueológico
20240315,2023,15,Lima,Sitio Arqueologico Caral,3,Marzo,0,0,0,0,0,0,353,116,187,656,0,0,0,0,0,143,3,3,149,805,Sitio Arqueológico
20240315,2023,15,Lima,Sitio Arqueologico Caral,3,Marzo,1,0,0,0,0,0,38,0,10,48,0,0,0,0,0,3,2,0,5,53,Sitio Arqueológico
20240315,2023,15,Lima,Sitio Arqueologico Caral,3,Marzo,2,0,0,0,0,0,391,116,197,704,0,0,0,0,0,146,5,3,154,858,Sitio Arqueológico
20240315,2023,15,Lima,Sitio Arqueologico Caral,4,Abril,0,0,0,0,0,0,1034,196,554,1784,0,0,0,0,0,192,15,13,220,2004,Sitio Arqueológico
20240315,2023,15,Lima,Sitio Arqueologico Caral,4,Abril,1,0,0,0,0,0,55,15,3,73,0,0,0,0,0,14,7,7,28,101,Sitio Arqueológico
20240315,2023,15,Lima,Sitio Arqueologico Caral,4,Abril,2,0,0,0,0,0,1089,211,557,1857,0,0,0,0,0,206,22,20,248,2105,Sitio Arqueológico
20240315,2023,15,Lima,Sitio Arqueologico Caral,5,Mayo,0,0,0,0,0,0,683,131,568,1382,0,0,0,0,0,226,3,3,232,1614,Sitio Arqueológico
20240315,2023,15,Lima,Sitio Arqueologico Caral,5,Mayo,1,0,0,0,0,0,86,5,26,117,0,0,0,0,0,4,1,1,6,123,Sitio Arqueológico
20240315,2023,15,Lima,Sitio Arqueologico Caral,5,Mayo,2,0,0,0,0,0,769,136,594,1499,0,0,0,0,0,230,4,4,238,1737,Sitio Arqueológico
20240315,2023,15,Lima,Sitio Arqueologico Caral,6,Junio,0,0,0,0,0,0,860,591,3563,5014,0,0,0,0,0,101,324,16,441,5455,Sitio Arqueológico
20240315,2023,15,Lima,Sitio Arqueologico Caral,6,Junio,1,0,0,0,0,0,131,11,20,162,0,0,0,0,0,8,4,7,19,181,Sitio Arqueológico
20240315,2023,15,Lima,Sitio Arqueologico Caral,6,Junio,2,0,0,0,0,0,991,602,3583,5176,0,0,0,0,0,109,328,23,460,5636,Sitio Arqueológico
20240315,2023,15,Lima,Sitio Arqueologico Caral,7,Julio,0,0,0,0,0,0,2186,826,2905,5917,0,0,0,0,0,195,1126,9,1330,7247,Sitio Arqueológico
20240315,2023,15,Lima,Sitio Arqueologico Caral,7,Julio,1,0,0,0,0,0,318,40,0,358,0,0,0,0,0,7,8,4,19,377,Sitio Arqueológico
20240315,2023,15,Lima,Sitio Arqueologico Caral,7,Julio,2,0,0,0,0,0,2504,866,2905,6275,0,0,0,0,0,202,1134,13,1349,7624,Sitio Arqueológico
20240315,2023,15,Lima,Sitio Arqueologico Caral,8,Agosto,0,0,0,0,0,0,1388,517,2169,4074,0,0,0,0,0,47,773,9,829,4903,Sitio Arqueológico
20240315,2023,15,Lima,Sitio Arqueologico Caral,8,Agosto,1,0,0,0,0,0,122,31,19,172,0,0,0,0,0,12,6,5,23,195,Sitio Arqueológico
20240315,2023,15,Lima,Sitio Arqueologico Caral,8,Agosto,2,0,0,0,0,0,1510,548,2188,4246,0,0,0,0,0,59,779,14,852,5098,Sitio Arqueológico
20240315,2023,15,Lima,Sitio Arqueologico Caral,9,Setiembre,0,0,0,0,0,0,805,429,3612,4846,0,0,0,0,0,633,579,7,1219,6065,Sitio Arqueológico
20240315,2023,15,Lima,Sitio Arqueologico Caral,9,Setiembre,1,0,0,0,0,0,155,2,6,163,0,0,0,0,0,4,4,3,11,174,Sitio Arqueológico
20240315,2023,15,Lima,Sitio Arqueologico Caral,9,Setiembre,2,0,0,0,0,0,960,431,3618,5009,0,0,0,0,0,637,583,10,1230,6239,Sitio Arqueológico
20240315,2023,15,Lima,Sitio Arqueologico Caral,10,Octubre,0,0,0,0,0,0,1361,483,2281,4125,0,0,0,0,0,330,281,3,614,4739,Sitio Arqueológico
20240315,2023,15,Lima,Sitio Arqueologico Caral,10,Octubre,1,0,0,0,0,0,114,13,23,150,0,0,0,0,0,2,1,2,5,155,Sitio Arqueológico
20240315,2023,15,Lima,Sitio Arqueologico Caral,10,Octubre,2,0,0,0,0,0,1475,496,2304,4275,0,0,0,0,0,332,282,5,619,4894,Sitio Arqueológico
20240315,2023,15,Lima,Sitio Arqueologico Caral,11,Noviembre,0,0,0,0,0,0,758,424,1689,2871,0,0,0,0,0,94,643,11,748,3619,Sitio Arqueológico
20240315,2023,15,Lima,Sitio Arqueologico Caral,11,Noviembre,1,0,0,0,0,0,115,3,24,142,0,0,0,0,0,3,3,0,6,148,Sitio Arqueológico
20240315,2023,15,Lima,Sitio Arqueologico Caral,11,Noviembre,2,0,0,0,0,0,873,427,1713,3013,0,0,0,0,0,97,646,11,754,3767,Sitio Arqueológico
20240315,2023,15,Lima,Sitio Arqueologico Caral,12,Diciembre,0,0,0,0,0,0,610,245,562,1417,0,0,0,0,0,242,30,67,339,1756,Sitio Arqueológico
20240315,2023,15,Lima,Sitio Arqueologico Caral,12,Diciembre,1,0,0,0,0,0,80,0,25,105,0,0,0,0,0,5,1,0,6,111,Sitio Arqueológico
20240315,2023,15,Lima,Sitio Arqueologico Caral,12,Diciembre,2,0,0,0,0,0,690,245,587,1522,0,0,0,0,0,247,31,67,345,1867,Sitio Arqueológico
20240315,2023,15,Lima,Zona Arqueologica de Huaycan de Cieneguilla,1,Enero,0,0,0,0,0,93,354,46,133,626,0,0,0,0,7,59,0,19,85,711,Sitio Arqueológico
20240315,2023,15,Lima,Zona Arqueologica de Huaycan de Cieneguilla,1,Enero,1,0,0,0,0,0,4,0,0,4,0,0,0,0,0,0,0,0,0,4,Sitio Arqueológico
20240315,2023,15,Lima,Zona Arqueologica de Huaycan de Cieneguilla,1,Enero,2,0,0,0,0,93,358,46,133,630,0,0,0,0,7,59,0,19,85,715,Sitio Arqueológico
20240315,2023,15,Lima,Zona Arqueologica de Huaycan de Cieneguilla,2,Febrero,0,0,0,0,0,82,255,86,62,485,0,0,0,0,13,47,2,15,77,562,Sitio Arqueológico
20240315,2023,15,Lima,Zona Arqueologica de Huaycan de Cieneguilla,2,Febrero,1,0,0,0,0,0,17,0,0,17,0,0,0,0,0,2,0,1,3,20,Sitio Arqueológico
20240315,2023,15,Lima,Zona Arqueologica de Huaycan de Cieneguilla,2,Febrero,2,0,0,0,0,82,272,86,62,502,0,0,0,0,13,49,2,16,80,582,Sitio Arqueológico
20240315,2023,15,Lima,Zona Arqueologica de Huaycan de Cieneguilla,3,Marzo,0,0,0,0,0,29,56,7,14,106,0,0,0,0,5,64,13,12,94,200,Sitio Arqueológico
20240315,2023,15,Lima,Zona Arqueologica de Huaycan de Cieneguilla,3,Marzo,1,0,0,0,0,0,2,0,0,2,0,0,0,0,0,0,0,0,0,2,Sitio Arqueológico
20240315,2023,15,Lima,Zona Arqueologica de Huaycan de Cieneguilla,3,Marzo,2,0,0,0,0,29,58,7,14,108,0,0,0,0,5,64,13,12,94,202,Sitio Arqueológico
20240315,2023,15,Lima,Zona Arqueologica de Huaycan de Cieneguilla,4,Abril,0,0,0,0,0,0,0,0,0,0,0,0,0,0,0,0,0,0,0,0,Sitio Arqueológico
20240315,2023,15,Lima,Zona Arqueologica de Huaycan de Cieneguilla,4,Abril,1,0,0,0,0,0,0,0,0,0,0,0,0,0,0,0,0,0,0,0,Sitio Arqueológico
20240315,2023,15,Lima,Zona Arqueologica de Huaycan de Cieneguilla,4,Abril,2,0,0,0,0,0,0,0,0,0,0,0,0,0,0,0,0,0,0,0,Sitio Arqueológico
20240315,2023,15,Lima,Zona Arqueologica de Huaycan de Cieneguilla,5,Mayo,0,0,0,0,0,0,0,0,0,0,0,0,0,0,0,0,0,0,0,0,Sitio Arqueológico
20240315,2023,15,Lima,Zona Arqueologica de Huaycan de Cieneguilla,5,Mayo,1,0,0,0,0,0,0,0,0,0,0,0,0,0,0,0,0,0,0,0,Sitio Arqueológico
20240315,2023,15,Lima,Zona Arqueologica de Huaycan de Cieneguilla,5,Mayo,2,0,0,0,0,0,0,0,0,0,0,0,0,0,0,0,0,0,0,0,Sitio Arqueológico
20240315,2023,15,Lima,Zona Arqueologica de Huaycan de Cieneguilla,6,Junio,0,0,0,0,0,85,231,45,650,1011,0,0,1,0,9,50,37,88,185,1196,Sitio Arqueológico
20240315,2023,15,Lima,Zona Arqueologica de Huaycan de Cieneguilla,6,Junio,1,0,0,0,0,0,25,0,2,27,0,0,0,0,0,0,0,0,0,27,Sitio Arqueológico
20240315,2023,15,Lima,Zona Arqueologica de Huaycan de Cieneguilla,6,Junio,2,0,0,0,0,85,256,45,652,1038,0,0,1,0,9,50,37,88,185,1223,Sitio Arqueológico
20240315,2023,15,Lima,Zona Arqueologica de Huaycan de Cieneguilla,7,Julio,0,0,0,0,0,225,685,209,527,1646,0,0,0,0,57,42,58,32,189,1835,Sitio Arqueológico
20240315,2023,15,Lima,Zona Arqueologica de Huaycan de Cieneguilla,7,Julio,1,0,0,0,0,0,8,0,1,9,0,0,0,0,0,0,0,0,0,9,Sitio Arqueológico
20240315,2023,15,Lima,Zona Arqueologica de Huaycan de Cieneguilla,7,Julio,2,0,0,0,0,225,693,209,528,1655,0,0,0,0,57,42,58,32,189,1844,Sitio Arqueológico
20240315,2023,15,Lima,Zona Arqueologica de Huaycan de Cieneguilla,8,Agosto,0,0,0,0,0,207,465,56,379,1107,0,0,0,0,18,100,4,26,148,1255,Sitio Arqueológico
20240315,2023,15,Lima,Zona Arqueologica de Huaycan de Cieneguilla,8,Agosto,1,0,0,0,0,0,2,0,0,2,0,0,0,0,0,0,0,0,0,2,Sitio Arqueológico
20240315,2023,15,Lima,Zona Arqueologica de Huaycan de Cieneguilla,8,Agosto,2,0,0,0,0,207,467,56,379,1109,0,0,0,0,18,100,4,26,148,1257,Sitio Arqueológico
20240315,2023,15,Lima,Zona Arqueologica de Huaycan de Cieneguilla,9,Setiembre,0,0,0,0,0,220,315,66,1197,1798,0,0,0,0,7,81,0,10,98,1896,Sitio Arqueológico
20240315,2023,15,Lima,Zona Arqueologica de Huaycan de Cieneguilla,9,Setiembre,1,0,0,0,0,0,2,0,0,2,0,0,0,0,0,0,0,0,0,2,Sitio Arqueológico
20240315,2023,15,Lima,Zona Arqueologica de Huaycan de Cieneguilla,9,Setiembre,2,0,0,0,0,220,317,66,1197,1800,0,0,0,0,7,81,0,10,98,1898,Sitio Arqueológico
20240315,2023,15,Lima,Zona Arqueologica de Huaycan de Cieneguilla,10,Octubre,0,0,0,0,0,276,394,48,338,1056,0,0,0,0,16,23,0,1,40,1096,Sitio Arqueológico
20240315,2023,15,Lima,Zona Arqueologica de Huaycan de Cieneguilla,10,Octubre,1,0,0,0,0,0,0,0,0,0,0,0,0,0,0,0,0,0,0,0,Sitio Arqueológico
20240315,2023,15,Lima,Zona Arqueologica de Huaycan de Cieneguilla,10,Octubre,2,0,0,0,0,276,394,48,338,1056,0,0,0,0,16,23,0,1,40,1096,Sitio Arqueológico
20240315,2023,15,Lima,Zona Arqueologica de Huaycan de Cieneguilla,11,Noviembre,0,0,0,0,0,88,245,45,174,552,0,0,0,0,8,42,0,4,54,606,Sitio Arqueológico
20240315,2023,15,Lima,Zona Arqueologica de Huaycan de Cieneguilla,11,Noviembre,1,0,0,0,0,0,0,0,0,0,0,0,0,0,0,0,0,0,0,0,Sitio Arqueológico
20240315,2023,15,Lima,Zona Arqueologica de Huaycan de Cieneguilla,11,Noviembre,2,0,0,0,0,88,245,45,174,552,0,0,0,0,8,42,0,4,54,606,Sitio Arqueológico
20240315,2023,15,Lima,Zona Arqueologica de Huaycan de Cieneguilla,12,Diciembre,0,0,0,0,0,231,282,51,44,608,0,0,0,0,4,11,0,2,17,625,Sitio Arqueológico
20240315,2023,15,Lima,Zona Arqueologica de Huaycan de Cieneguilla,12,Diciembre,1,0,0,0,0,0,0,0,0,0,0,0,0,0,0,0,0,0,0,0,Sitio Arqueológico
20240315,2023,15,Lima,Zona Arqueologica de Huaycan de Cieneguilla,12,Diciembre,2,0,0,0,0,231,282,51,44,608,0,0,0,0,4,11,0,2,17,625,Sitio Arqueológico
20240315,2023,15,Lima,Complejo Arqueologico Mateo Salado,1,Enero,0,0,0,0,0,1,33,2,6,42,0,0,0,0,0,3,0,0,3,45,Sitio Arqueológico
20240315,2023,15,Lima,Complejo Arqueologico Mateo Salado,1,Enero,1,0,0,0,0,0,82,0,0,82,0,0,0,0,0,0,0,0,0,82,Sitio Arqueológico
20240315,2023,15,Lima,Complejo Arqueologico Mateo Salado,1,Enero,2,0,0,0,0,1,115,2,6,124,0,0,0,0,0,3,0,0,3,127,Sitio Arqueológico
20240315,2023,15,Lima,Complejo Arqueologico Mateo Salado,2,Febrero,0,0,0,0,0,4,39,16,27,86,0,0,0,0,17,101,0,36,154,240,Sitio Arqueológico
20240315,2023,15,Lima,Complejo Arqueologico Mateo Salado,2,Febrero,1,0,0,0,0,3,148,0,0,151,0,0,0,0,0,0,0,0,0,151,Sitio Arqueológico
20240315,2023,15,Lima,Complejo Arqueologico Mateo Salado,2,Febrero,2,0,0,0,0,7,187,16,27,237,0,0,0,0,17,101,0,36,154,391,Sitio Arqueológico
20240315,2023,15,Lima,Complejo Arqueologico Mateo Salado,3,Marzo,0,0,0,0,0,9,37,38,15,99,0,0,0,0,11,79,0,23,113,212,Sitio Arqueológico
20240315,2023,15,Lima,Complejo Arqueologico Mateo Salado,3,Marzo,1,0,0,0,0,4,77,0,0,81,0,0,0,0,0,0,0,0,0,81,Sitio Arqueológico
20240315,2023,15,Lima,Complejo Arqueologico Mateo Salado,3,Marzo,2,0,0,0,0,13,114,38,15,180,0,0,0,0,11,79,0,23,113,293,Sitio Arqueológico
20240315,2023,15,Lima,Complejo Arqueologico Mateo Salado,4,Abril,0,0,0,0,0,27,129,56,119,331,0,0,0,0,7,104,0,18,129,460,Sitio Arqueológico
20240315,2023,15,Lima,Complejo Arqueologico Mateo Salado,4,Abril,1,0,0,0,0,1,24,0,1,26,0,0,0,0,0,0,0,0,0,26,Sitio Arqueológico
20240315,2023,15,Lima,Complejo Arqueologico Mateo Salado,4,Abril,2,0,0,0,0,28,153,56,120,357,0,0,0,0,7,104,0,18,129,486,Sitio Arqueológico
20240315,2023,15,Lima,Complejo Arqueologico Mateo Salado,5,Mayo,0,0,0,0,0,23,36,20,257,336,0,0,0,0,8,85,119,30,242,578,Sitio Arqueológico
20240315,2023,15,Lima,Complejo Arqueologico Mateo Salado,5,Mayo,1,0,0,0,0,7,17,0,0,24,0,0,0,0,0,1,0,0,1,25,Sitio Arqueológico
20240315,2023,15,Lima,Complejo Arqueologico Mateo Salado,5,Mayo,2,0,0,0,0,30,53,20,257,360,0,0,0,0,8,86,119,30,243,603,Sitio Arqueológico
20240315,2023,15,Lima,Complejo Arqueologico Mateo Salado,6,Junio,0,0,0,0,0,62,74,81,475,692,0,0,0,0,12,59,23,22,116,808,Sitio Arqueológico
20240315,2023,15,Lima,Complejo Arqueologico Mateo Salado,6,Junio,1,0,0,0,0,0,26,0,1,27,0,0,0,0,0,0,0,0,0,27,Sitio Arqueológico
20240315,2023,15,Lima,Complejo Arqueologico Mateo Salado,6,Junio,2,0,0,0,0,62,100,81,476,719,0,0,0,0,12,59,23,22,116,835,Sitio Arqueológico
20240315,2023,15,Lima,Complejo Arqueologico Mateo Salado,7,Julio,0,0,0,0,0,35,81,2,527,645,0,0,0,0,8,40,13,17,78,723,Sitio Arqueológico
20240315,2023,15,Lima,Complejo Arqueologico Mateo Salado,7,Julio,1,0,0,0,0,0,37,2,6,45,0,0,0,0,0,0,0,0,0,45,Sitio Arqueológico
20240315,2023,15,Lima,Complejo Arqueologico Mateo Salado,7,Julio,2,0,0,0,0,35,118,4,533,690,0,0,0,0,8,40,13,17,78,768,Sitio Arqueológico
20240315,2023,15,Lima,Complejo Arqueologico Mateo Salado,8,Agosto,0,0,0,0,0,44,79,17,485,625,1,0,0,0,8,62,4,20,95,720,Sitio Arqueológico
20240315,2023,15,Lima,Complejo Arqueologico Mateo Salado,8,Agosto,1,0,0,0,0,0,32,0,0,32,0,0,0,0,0,0,0,0,0,32,Sitio Arqueológico
20240315,2023,15,Lima,Complejo Arqueologico Mateo Salado,8,Agosto,2,0,0,0,0,44,111,17,485,657,1,0,0,0,8,62,4,20,95,752,Sitio Arqueológico
20240315,2023,15,Lima,Complejo Arqueologico Mateo Salado,9,Setiembre,0,0,0,0,0,60,67,132,265,524,0,0,0,0,8,96,54,9,167,691,Sitio Arqueológico
20240315,2023,15,Lima,Complejo Arqueologico Mateo Salado,9,Setiembre,1,0,0,0,0,0,54,0,0,54,0,0,0,0,0,0,0,0,0,54,Sitio Arqueológico
20240315,2023,15,Lima,Complejo Arqueologico Mateo Salado,9,Setiembre,2,0,0,0,0,60,121,132,265,578,0,0,0,0,8,96,54,9,167,745,Sitio Arqueológico
20240315,2023,15,Lima,Complejo Arqueologico Mateo Salado,10,Octubre,0,0,0,0,0,31,45,17,355,448,1,0,0,0,7,62,17,17,104,552,Sitio Arqueológico
20240315,2023,15,Lima,Complejo Arqueologico Mateo Salado,10,Octubre,1,0,0,0,0,3,36,0,0,39,0,0,0,0,0,0,0,0,0,39,Sitio Arqueológico
20240315,2023,15,Lima,Complejo Arqueologico Mateo Salado,10,Octubre,2,0,0,0,0,34,81,17,355,487,1,0,0,0,7,62,17,17,104,591,Sitio Arqueológico
20240315,2023,15,Lima,Complejo Arqueologico Mateo Salado,11,Noviembre,0,0,0,0,0,26,56,10,314,406,1,0,1,0,18,74,0,13,107,513,Sitio Arqueológico
20240315,2023,15,Lima,Complejo Arqueologico Mateo Salado,11,Noviembre,1,0,0,0,0,0,45,0,2,47,0,0,0,0,0,0,0,0,0,47,Sitio Arqueológico
20240315,2023,15,Lima,Complejo Arqueologico Mateo Salado,11,Noviembre,2,0,0,0,0,26,101,10,316,453,1,0,1,0,18,74,0,13,107,560,Sitio Arqueológico
20240315,2023,15,Lima,Complejo Arqueologico Mateo Salado,12,Diciembre,0,0,0,0,0,5,24,24,9,62,0,0,0,0,12,56,0,15,83,145,Sitio Arqueológico
20240315,2023,15,Lima,Complejo Arqueologico Mateo Salado,12,Diciembre,1,0,0,0,0,2,170,0,1,173,0,0,0,0,0,0,0,0,0,173,Sitio Arqueológico
20240315,2023,15,Lima,Complejo Arqueologico Mateo Salado,12,Diciembre,2,0,0,0,0,7,194,24,10,235,0,0,0,0,12,56,0,15,83,318,Sitio Arqueológico
20240315,2023,18,Moquegua,Sitio Arqueologico de Cerro Baul,1,Enero,0,0,0,0,0,0,0,0,0,0,0,0,0,0,0,0,0,0,0,0,Sitio Arqueológico
20240315,2023,18,Moquegua,Sitio Arqueologico de Cerro Baul,1,Enero,1,0,0,0,0,0,0,0,0,0,0,0,0,0,0,0,0,0,0,0,Sitio Arqueológico
20240315,2023,18,Moquegua,Sitio Arqueologico de Cerro Baul,1,Enero,2,0,0,0,0,0,0,0,0,0,0,0,0,0,0,0,0,0,0,0,Sitio Arqueológico
20240315,2023,18,Moquegua,Sitio Arqueologico de Cerro Baul,2,Febrero,0,0,0,0,0,0,0,0,0,0,0,0,0,0,0,0,0,0,0,0,Sitio Arqueológico
20240315,2023,18,Moquegua,Sitio Arqueologico de Cerro Baul,2,Febrero,1,0,0,0,0,0,0,0,0,0,0,0,0,0,0,0,0,0,0,0,Sitio Arqueológico
20240315,2023,18,Moquegua,Sitio Arqueologico de Cerro Baul,2,Febrero,2,0,0,0,0,0,0,0,0,0,0,0,0,0,0,0,0,0,0,0,Sitio Arqueológico
20240315,2023,18,Moquegua,Sitio Arqueologico de Cerro Baul,3,Marzo,0,0,0,0,0,0,0,0,0,0,0,0,0,0,0,0,0,0,0,0,Sitio Arqueológico
20240315,2023,18,Moquegua,Sitio Arqueologico de Cerro Baul,3,Marzo,1,0,0,0,0,0,0,0,0,0,0,0,0,0,0,0,0,0,0,0,Sitio Arqueológico
20240315,2023,18,Moquegua,Sitio Arqueologico de Cerro Baul,3,Marzo,2,0,0,0,0,0,0,0,0,0,0,0,0,0,0,0,0,0,0,0,Sitio Arqueológico
20240315,2023,18,Moquegua,Sitio Arqueologico de Cerro Baul,4,Abril,0,0,0,0,0,0,0,0,0,0,0,0,0,0,0,0,0,0,0,0,Sitio Arqueológico
20240315,2023,18,Moquegua,Sitio Arqueologico de Cerro Baul,4,Abril,1,0,0,0,0,0,0,0,0,0,0,0,0,0,0,0,0,0,0,0,Sitio Arqueológico
20240315,2023,18,Moquegua,Sitio Arqueologico de Cerro Baul,4,Abril,2,0,0,0,0,0,0,0,0,0,0,0,0,0,0,0,0,0,0,0,Sitio Arqueológico
20240315,2023,18,Moquegua,Sitio Arqueologico de Cerro Baul,5,Mayo,0,0,0,0,0,0,0,0,0,0,0,0,0,0,0,0,0,0,0,0,Sitio Arqueológico
20240315,2023,18,Moquegua,Sitio Arqueologico de Cerro Baul,5,Mayo,1,0,0,0,0,0,0,0,0,0,0,0,0,0,0,0,0,0,0,0,Sitio Arqueológico
20240315,2023,18,Moquegua,Sitio Arqueologico de Cerro Baul,5,Mayo,2,0,0,0,0,0,0,0,0,0,0,0,0,0,0,0,0,0,0,0,Sitio Arqueológico
20240315,2023,18,Moquegua,Sitio Arqueologico de Cerro Baul,6,Junio,0,0,0,0,0,0,0,0,0,0,0,0,0,0,0,0,0,0,0,0,Sitio Arqueológico
20240315,2023,18,Moquegua,Sitio Arqueologico de Cerro Baul,6,Junio,1,0,0,0,0,0,0,0,0,0,0,0,0,0,0,0,0,0,0,0,Sitio Arqueológico
20240315,2023,18,Moquegua,Sitio Arqueologico de Cerro Baul,6,Junio,2,0,0,0,0,0,0,0,0,0,0,0,0,0,0,0,0,0,0,0,Sitio Arqueológico
20240315,2023,18,Moquegua,Sitio Arqueologico de Cerro Baul,7,Julio,0,0,0,0,0,0,0,0,0,0,0,0,0,0,0,0,0,0,0,0,Sitio Arqueológico
20240315,2023,18,Moquegua,Sitio Arqueologico de Cerro Baul,7,Julio,1,0,0,0,0,0,0,0,0,0,0,0,0,0,0,0,0,0,0,0,Sitio Arqueológico
20240315,2023,18,Moquegua,Sitio Arqueologico de Cerro Baul,7,Julio,2,0,0,0,0,0,0,0,0,0,0,0,0,0,0,0,0,0,0,0,Sitio Arqueológico
20240315,2023,18,Moquegua,Sitio Arqueologico de Cerro Baul,8,Agosto,0,0,0,0,0,0,0,0,0,0,0,0,0,0,0,0,0,0,0,0,Sitio Arqueológico
20240315,2023,18,Moquegua,Sitio Arqueologico de Cerro Baul,8,Agosto,1,0,0,0,0,0,0,0,0,0,0,0,0,0,0,0,0,0,0,0,Sitio Arqueológico
20240315,2023,18,Moquegua,Sitio Arqueologico de Cerro Baul,8,Agosto,2,0,0,0,0,0,0,0,0,0,0,0,0,0,0,0,0,0,0,0,Sitio Arqueológico
20240315,2023,18,Moquegua,Sitio Arqueologico de Cerro Baul,9,Setiembre,0,0,0,0,0,0,0,0,0,0,0,0,0,0,0,0,0,0,0,0,Sitio Arqueológico
20240315,2023,18,Moquegua,Sitio Arqueologico de Cerro Baul,9,Setiembre,1,0,0,0,0,0,0,0,0,0,0,0,0,0,0,0,0,0,0,0,Sitio Arqueológico
20240315,2023,18,Moquegua,Sitio Arqueologico de Cerro Baul,9,Setiembre,2,0,0,0,0,0,0,0,0,0,0,0,0,0,0,0,0,0,0,0,Sitio Arqueológico
20240315,2023,18,Moquegua,Sitio Arqueologico de Cerro Baul,10,Octubre,0,0,0,0,0,0,0,0,0,0,0,0,0,0,0,0,0,0,0,0,Sitio Arqueológico
20240315,2023,18,Moquegua,Sitio Arqueologico de Cerro Baul,10,Octubre,1,0,0,0,0,0,0,0,0,0,0,0,0,0,0,0,0,0,0,0,Sitio Arqueológico
20240315,2023,18,Moquegua,Sitio Arqueologico de Cerro Baul,10,Octubre,2,0,0,0,0,0,0,0,0,0,0,0,0,0,0,0,0,0,0,0,Sitio Arqueológico
20240315,2023,18,Moquegua,Sitio Arqueologico de Cerro Baul,11,Noviembre,0,0,0,0,0,0,0,0,0,0,0,0,0,0,0,0,0,0,0,0,Sitio Arqueológico
20240315,2023,18,Moquegua,Sitio Arqueologico de Cerro Baul,11,Noviembre,1,0,0,0,0,0,0,0,0,0,0,0,0,0,0,0,0,0,0,0,Sitio Arqueológico
20240315,2023,18,Moquegua,Sitio Arqueologico de Cerro Baul,11,Noviembre,2,0,0,0,0,0,0,0,0,0,0,0,0,0,0,0,0,0,0,0,Sitio Arqueológico
20240315,2023,18,Moquegua,Sitio Arqueologico de Cerro Baul,12,Diciembre,0,0,0,0,0,0,0,0,0,0,0,0,0,0,0,0,0,0,0,0,Sitio Arqueológico
20240315,2023,18,Moquegua,Sitio Arqueologico de Cerro Baul,12,Diciembre,1,0,0,0,0,0,0,0,0,0,0,0,0,0,0,0,0,0,0,0,Sitio Arqueológico
20240315,2023,18,Moquegua,Sitio Arqueologico de Cerro Baul,12,Diciembre,2,0,0,0,0,0,0,0,0,0,0,0,0,0,0,0,0,0,0,0,Sitio Arqueológico
20240315,2023,21,Puno,Monumento Arqueologico de Cutimbo,1,Enero,0,0,0,0,0,0,18,26,0,44,0,0,0,0,0,0,0,0,0,44,Sitio Arqueológico
20240315,2023,21,Puno,Monumento Arqueologico de Cutimbo,1,Enero,1,0,0,0,0,0,0,0,0,0,0,0,0,0,0,0,0,0,0,0,Sitio Arqueológico
20240315,2023,21,Puno,Monumento Arqueologico de Cutimbo,1,Enero,2,0,0,0,0,0,18,26,0,44,0,0,0,0,0,0,0,0,0,44,Sitio Arqueológico
20240315,2023,21,Puno,Monumento Arqueologico de Cutimbo,2,Febrero,0,0,0,0,0,0,0,0,0,0,0,0,0,0,0,0,0,0,0,0,Sitio Arqueológico
20240315,2023,21,Puno,Monumento Arqueologico de Cutimbo,2,Febrero,1,0,0,0,0,0,0,0,0,0,0,0,0,0,0,0,0,0,0,0,Sitio Arqueológico
20240315,2023,21,Puno,Monumento Arqueologico de Cutimbo,2,Febrero,2,0,0,0,0,0,0,0,0,0,0,0,0,0,0,0,0,0,0,0,Sitio Arqueológico
20240315,2023,21,Puno,Monumento Arqueologico de Cutimbo,3,Marzo,0,0,0,0,0,0,10,25,0,35,0,0,0,0,0,0,0,0,0,35,Sitio Arqueológico
20240315,2023,21,Puno,Monumento Arqueologico de Cutimbo,3,Marzo,1,0,0,0,0,0,8,0,0,8,0,0,0,0,0,0,0,0,0,8,Sitio Arqueológico
20240315,2023,21,Puno,Monumento Arqueologico de Cutimbo,3,Marzo,2,0,0,0,0,0,18,25,0,43,0,0,0,0,0,0,0,0,0,43,Sitio Arqueológico
20240315,2023,21,Puno,Monumento Arqueologico de Cutimbo,4,Abril,0,0,0,0,0,0,0,0,0,0,0,0,0,0,0,0,0,0,0,0,Sitio Arqueológico
20240315,2023,21,Puno,Monumento Arqueologico de Cutimbo,4,Abril,1,0,0,0,0,0,0,0,0,0,0,0,0,0,0,0,0,0,0,0,Sitio Arqueológico
20240315,2023,21,Puno,Monumento Arqueologico de Cutimbo,4,Abril,2,0,0,0,0,0,0,0,0,0,0,0,0,0,0,0,0,0,0,0,Sitio Arqueológico
20240315,2023,21,Puno,Monumento Arqueologico de Cutimbo,5,Mayo,0,0,0,0,0,0,7,28,0,35,0,0,0,0,0,0,0,0,0,35,Sitio Arqueológico
20240315,2023,21,Puno,Monumento Arqueologico de Cutimbo,5,Mayo,1,0,0,0,0,0,2,1,0,3,0,0,0,0,0,0,0,0,0,3,Sitio Arqueológico
20240315,2023,21,Puno,Monumento Arqueologico de Cutimbo,5,Mayo,2,0,0,0,0,0,9,29,0,38,0,0,0,0,0,0,0,0,0,38,Sitio Arqueológico
20240315,2023,21,Puno,Monumento Arqueologico de Cutimbo,6,Junio,0,0,0,0,0,0,16,40,0,56,0,0,0,0,0,10,6,2,18,74,Sitio Arqueológico
20240315,2023,21,Puno,Monumento Arqueologico de Cutimbo,6,Junio,1,0,0,0,0,0,11,0,0,11,0,0,0,0,0,0,0,0,0,11,Sitio Arqueológico
20240315,2023,21,Puno,Monumento Arqueologico de Cutimbo,6,Junio,2,0,0,0,0,0,27,40,0,67,0,0,0,0,0,10,6,2,18,85,Sitio Arqueológico
20240315,2023,21,Puno,Monumento Arqueologico de Cutimbo,7,Julio,0,0,0,0,0,0,17,45,0,62,0,0,0,0,0,0,5,0,5,67,Sitio Arqueológico
20240315,2023,21,Puno,Monumento Arqueologico de Cutimbo,7,Julio,1,0,0,0,0,0,10,3,0,13,0,0,0,0,0,0,0,0,0,13,Sitio Arqueológico
20240315,2023,21,Puno,Monumento Arqueologico de Cutimbo,7,Julio,2,0,0,0,0,0,27,48,0,75,0,0,0,0,0,0,5,0,5,80,Sitio Arqueológico
20240315,2023,21,Puno,Monumento Arqueologico de Cutimbo,8,Agosto,0,0,0,0,0,0,10,68,124,202,0,0,0,0,0,0,0,283,283,485,Sitio Arqueológico
20240315,2023,21,Puno,Monumento Arqueologico de Cutimbo,8,Agosto,1,0,0,0,0,0,2,3,0,5,0,0,0,0,0,0,0,0,0,5,Sitio Arqueológico
20240315,2023,21,Puno,Monumento Arqueologico de Cutimbo,8,Agosto,2,0,0,0,0,0,12,71,124,207,0,0,0,0,0,0,0,283,283,490,Sitio Arqueológico
20240315,2023,21,Puno,Monumento Arqueologico de Cutimbo,9,Setiembre,0,0,0,0,0,0,7,20,54,81,0,0,0,0,0,0,0,0,0,81,Sitio Arqueológico
20240315,2023,21,Puno,Monumento Arqueologico de Cutimbo,9,Setiembre,1,0,0,0,0,0,21,0,0,21,0,0,0,0,0,0,0,0,0,21,Sitio Arqueológico
20240315,2023,21,Puno,Monumento Arqueologico de Cutimbo,9,Setiembre,2,0,0,0,0,0,28,20,54,102,0,0,0,0,0,0,0,0,0,102,Sitio Arqueológico
20240315,2023,21,Puno,Monumento Arqueologico de Cutimbo,10,Octubre,0,0,0,0,0,0,9,42,32,83,0,0,0,0,0,0,0,0,0,83,Sitio Arqueológico
20240315,2023,21,Puno,Monumento Arqueologico de Cutimbo,10,Octubre,1,0,0,0,0,0,3,0,0,3,0,0,0,0,0,0,0,0,0,3,Sitio Arqueológico
20240315,2023,21,Puno,Monumento Arqueologico de Cutimbo,10,Octubre,2,0,0,0,0,0,12,42,32,86,0,0,0,0,0,0,0,0,0,86,Sitio Arqueológico
20240315,2023,21,Puno,Monumento Arqueologico de Cutimbo,11,Noviembre,0,0,0,0,0,0,25,31,0,56,0,0,0,0,0,6,0,0,6,62,Sitio Arqueológico
20240315,2023,21,Puno,Monumento Arqueologico de Cutimbo,11,Noviembre,1,0,0,0,0,0,17,0,0,17,0,0,0,0,0,0,0,0,0,17,Sitio Arqueológico
20240315,2023,21,Puno,Monumento Arqueologico de Cutimbo,11,Noviembre,2,0,0,0,0,0,42,31,0,73,0,0,0,0,0,6,0,0,6,79,Sitio Arqueológico
20240315,2023,21,Puno,Monumento Arqueologico de Cutimbo,12,Diciembre,0,0,0,0,0,0,9,47,21,77,0,0,0,0,0,0,0,0,0,77,Sitio Arqueológico
20240315,2023,21,Puno,Monumento Arqueologico de Cutimbo,12,Diciembre,1,0,0,0,0,0,8,3,0,11,0,0,0,0,0,0,0,0,0,11,Sitio Arqueológico
20240315,2023,21,Puno,Monumento Arqueologico de Cutimbo,12,Diciembre,2,0,0,0,0,0,17,50,21,88,0,0,0,0,0,0,0,0,0,88,Sitio Arqueológico
20240315,2023,21,Puno,Sitio Arqueologico de Sillustani,1,Enero,0,0,0,0,0,0,299,106,56,461,0,0,0,0,0,568,164,118,850,1311,Sitio Arqueológico
20240315,2023,21,Puno,Sitio Arqueologico de Sillustani,1,Enero,1,0,0,0,0,0,101,0,0,101,0,0,0,0,0,0,0,0,0,101,Sitio Arqueológico
20240315,2023,21,Puno,Sitio Arqueologico de Sillustani,1,Enero,2,0,0,0,0,0,400,106,56,562,0,0,0,0,0,568,164,118,850,1412,Sitio Arqueológico
20240315,2023,21,Puno,Sitio Arqueologico de Sillustani,2,Febrero,0,0,0,0,0,0,227,119,54,400,0,0,0,0,0,0,0,0,0,400,Sitio Arqueológico
20240315,2023,21,Puno,Sitio Arqueologico de Sillustani,2,Febrero,1,0,0,0,0,0,1,0,0,1,0,0,0,0,0,0,0,0,0,1,Sitio Arqueológico
20240315,2023,21,Puno,Sitio Arqueologico de Sillustani,2,Febrero,2,0,0,0,0,0,228,119,54,401,0,0,0,0,0,0,0,0,0,401,Sitio Arqueológico
20240315,2023,21,Puno,Sitio Arqueologico de Sillustani,3,Marzo,0,0,0,0,0,0,390,131,33,554,0,0,0,0,0,39,21,16,76,630,Sitio Arqueológico
20240315,2023,21,Puno,Sitio Arqueologico de Sillustani,3,Marzo,1,0,0,0,0,0,10,0,0,10,0,0,0,0,0,0,0,0,0,10,Sitio Arqueológico
20240315,2023,21,Puno,Sitio Arqueologico de Sillustani,3,Marzo,2,0,0,0,0,0,400,131,33,564,0,0,0,0,0,39,21,16,76,640,Sitio Arqueológico
20240315,2023,21,Puno,Sitio Arqueologico de Sillustani,4,Abril,0,3,0,0,0,0,1057,472,153,1685,0,0,0,0,0,497,142,66,705,2390,Sitio Arqueológico
20240315,2023,21,Puno,Sitio Arqueologico de Sillustani,4,Abril,1,0,0,0,0,0,228,0,0,228,0,0,0,0,0,0,0,0,0,228,Sitio Arqueológico
20240315,2023,21,Puno,Sitio Arqueologico de Sillustani,4,Abril,2,3,0,0,0,0,1285,472,153,1913,0,0,0,0,0,497,142,66,705,2618,Sitio Arqueológico
20240315,2023,21,Puno,Sitio Arqueologico de Sillustani,5,Mayo,0,0,0,0,0,0,1225,477,166,1868,0,0,0,0,0,122,39,31,192,2060,Sitio Arqueológico
20240315,2023,21,Puno,Sitio Arqueologico de Sillustani,5,Mayo,1,0,0,0,0,0,905,0,0,905,0,0,0,0,0,0,0,0,0,905,Sitio Arqueológico
20240315,2023,21,Puno,Sitio Arqueologico de Sillustani,5,Mayo,2,0,0,0,0,0,2130,477,166,2773,0,0,0,0,0,122,39,31,192,2965,Sitio Arqueológico
20240315,2023,21,Puno,Sitio Arqueologico de Sillustani,6,Junio,0,0,0,0,0,0,793,474,119,1386,0,0,0,0,0,131,67,37,235,1621,Sitio Arqueológico
20240315,2023,21,Puno,Sitio Arqueologico de Sillustani,6,Junio,1,0,0,0,0,0,1029,0,0,1029,0,0,0,0,0,0,0,0,0,1029,Sitio Arqueológico
20240315,2023,21,Puno,Sitio Arqueologico de Sillustani,6,Junio,2,0,0,0,0,0,1822,474,119,2415,0,0,0,0,0,131,67,37,235,2650,Sitio Arqueológico
20240315,2023,21,Puno,Sitio Arqueologico de Sillustani,7,Julio,0,0,0,0,0,0,1437,558,954,2949,0,0,0,0,0,272,59,52,383,3332,Sitio Arqueológico
20240315,2023,21,Puno,Sitio Arqueologico de Sillustani,7,Julio,1,0,0,0,0,0,1151,71,4,1226,0,0,0,0,0,0,0,0,0,1226,Sitio Arqueológico
20240315,2023,21,Puno,Sitio Arqueologico de Sillustani,7,Julio,2,0,0,0,0,0,2588,629,958,4175,0,0,0,0,0,272,59,52,383,4558,Sitio Arqueológico
20240315,2023,21,Puno,Sitio Arqueologico de Sillustani,8,Agosto,0,1,0,0,0,0,1870,746,525,3142,0,0,0,0,0,311,95,112,518,3660,Sitio Arqueológico
20240315,2023,21,Puno,Sitio Arqueologico de Sillustani,8,Agosto,1,0,0,0,0,0,1781,66,17,1864,0,0,0,0,0,0,0,0,0,1864,Sitio Arqueológico
20240315,2023,21,Puno,Sitio Arqueologico de Sillustani,8,Agosto,2,1,0,0,0,0,3651,812,542,5006,0,0,0,0,0,311,95,112,518,5524,Sitio Arqueológico
20240315,2023,21,Puno,Sitio Arqueologico de Sillustani,9,Setiembre,0,2,0,0,0,0,999,441,789,2231,0,0,0,0,0,287,86,61,434,2665,Sitio Arqueológico
20240315,2023,21,Puno,Sitio Arqueologico de Sillustani,9,Setiembre,1,0,0,0,0,0,1843,21,0,1864,0,0,0,0,0,0,0,0,0,1864,Sitio Arqueológico
20240315,2023,21,Puno,Sitio Arqueologico de Sillustani,9,Setiembre,2,2,0,0,0,0,2842,462,789,4095,0,0,0,0,0,287,86,61,434,4529,Sitio Arqueológico
20240315,2023,21,Puno,Sitio Arqueologico de Sillustani,10,Octubre,0,4,0,0,0,0,1481,792,686,2963,0,0,0,0,0,233,60,76,369,3332,Sitio Arqueológico
20240315,2023,21,Puno,Sitio Arqueologico de Sillustani,10,Octubre,1,0,0,0,0,0,2104,0,5,2109,0,0,0,0,0,0,0,0,0,2109,Sitio Arqueológico
20240315,2023,21,Puno,Sitio Arqueologico de Sillustani,10,Octubre,2,4,0,0,0,0,3585,792,691,5072,0,0,0,0,0,233,60,76,369,5441,Sitio Arqueológico
20240315,2023,21,Puno,Sitio Arqueologico de Sillustani,11,Noviembre,0,2,0,0,0,0,1244,413,1248,2907,0,0,0,0,0,162,32,70,264,3171,Sitio Arqueológico
20240315,2023,21,Puno,Sitio Arqueologico de Sillustani,11,Noviembre,1,0,0,0,0,0,2191,0,0,2191,0,0,0,0,0,0,0,0,0,2191,Sitio Arqueológico
20240315,2023,21,Puno,Sitio Arqueologico de Sillustani,11,Noviembre,2,2,0,0,0,0,3435,413,1248,5098,0,0,0,0,0,162,32,70,264,5362,Sitio Arqueológico
20240315,2023,21,Puno,Sitio Arqueologico de Sillustani,12,Diciembre,0,0,0,0,0,0,1340,310,900,2550,0,0,0,0,0,265,55,28,348,2898,Sitio Arqueológico
20240315,2023,21,Puno,Sitio Arqueologico de Sillustani,12,Diciembre,1,0,0,0,0,0,937,0,0,937,0,0,0,0,0,0,0,0,0,937,Sitio Arqueológico
20240315,2023,21,Puno,Sitio Arqueologico de Sillustani,12,Diciembre,2,0,0,0,0,0,2277,310,900,3487,0,0,0,0,0,265,55,28,348,3835,Sitio Arqueológico
20240315,2023,24,Tumbes,Zona Arqueologica Monumental Cabeza de Vaca,1,Enero,0,4,0,0,0,0,108,0,36,148,27,0,0,0,0,15,0,92,134,282,Sitio Arqueológico
20240315,2023,24,Tumbes,Zona Arqueologica Monumental Cabeza de Vaca,1,Enero,1,0,0,0,0,0,3,0,0,3,0,0,0,0,0,0,0,0,0,3,Sitio Arqueológico
20240315,2023,24,Tumbes,Zona Arqueologica Monumental Cabeza de Vaca,1,Enero,2,4,0,0,0,0,111,0,36,151,27,0,0,0,0,15,0,92,134,285,Sitio Arqueológico
20240315,2023,24,Tumbes,Zona Arqueologica Monumental Cabeza de Vaca,2,Febrero,0,0,0,0,0,8,60,1,23,92,0,0,0,0,5,88,6,44,143,235,Sitio Arqueológico
20240315,2023,24,Tumbes,Zona Arqueologica Monumental Cabeza de Vaca,2,Febrero,1,0,0,0,0,0,4,0,0,4,0,0,0,0,0,0,0,0,0,4,Sitio Arqueológico
20240315,2023,24,Tumbes,Zona Arqueologica Monumental Cabeza de Vaca,2,Febrero,2,0,0,0,0,8,64,1,23,96,0,0,0,0,5,88,6,44,143,239,Sitio Arqueológico
20240315,2023,24,Tumbes,Zona Arqueologica Monumental Cabeza de Vaca,3,Marzo,0,0,0,0,0,3,21,0,6,30,0,0,0,0,3,28,2,10,43,73,Sitio Arqueológico
20240315,2023,24,Tumbes,Zona Arqueologica Monumental Cabeza de Vaca,3,Marzo,1,0,0,0,0,0,0,0,0,0,0,0,0,0,0,0,0,0,0,0,Sitio Arqueológico
20240315,2023,24,Tumbes,Zona Arqueologica Monumental Cabeza de Vaca,3,Marzo,2,0,0,0,0,3,21,0,6,30,0,0,0,0,3,28,2,10,43,73,Sitio Arqueológico
20240315,2023,24,Tumbes,Zona Arqueologica Monumental Cabeza de Vaca,4,Abril,0,0,0,0,0,2,16,0,69,87,0,0,0,0,5,37,17,96,155,242,Sitio Arqueológico
20240315,2023,24,Tumbes,Zona Arqueologica Monumental Cabeza de Vaca,4,Abril,1,0,0,0,0,0,0,0,0,0,0,0,0,0,0,0,0,0,0,0,Sitio Arqueológico
20240315,2023,24,Tumbes,Zona Arqueologica Monumental Cabeza de Vaca,4,Abril,2,0,0,0,0,2,16,0,69,87,0,0,0,0,5,37,17,96,155,242,Sitio Arqueológico
20240315,2023,24,Tumbes,Zona Arqueologica Monumental Cabeza de Vaca,5,Mayo,0,0,0,0,0,30,25,0,88,143,0,0,0,0,184,163,225,150,722,865,Sitio Arqueológico
20240315,2023,24,Tumbes,Zona Arqueologica Monumental Cabeza de Vaca,5,Mayo,1,0,0,0,0,0,0,0,0,0,0,0,0,0,0,0,0,0,0,0,Sitio Arqueológico
20240315,2023,24,Tumbes,Zona Arqueologica Monumental Cabeza de Vaca,5,Mayo,2,0,0,0,0,30,25,0,88,143,0,0,0,0,184,163,225,150,722,865,Sitio Arqueológico
20240315,2023,24,Tumbes,Zona Arqueologica Monumental Cabeza de Vaca,6,Junio,0,0,0,0,0,6,19,2,73,100,0,0,0,0,0,3,27,0,30,130,Sitio Arqueológico
20240315,2023,24,Tumbes,Zona Arqueologica Monumental Cabeza de Vaca,6,Junio,1,0,0,0,0,0,0,0,0,0,0,0,0,0,0,0,0,0,0,0,Sitio Arqueológico
20240315,2023,24,Tumbes,Zona Arqueologica Monumental Cabeza de Vaca,6,Junio,2,0,0,0,0,6,19,2,73,100,0,0,0,0,0,3,27,0,30,130,Sitio Arqueológico
20240315,2023,24,Tumbes,Zona Arqueologica Monumental Cabeza de Vaca,7,Julio,0,0,0,0,0,12,84,35,193,324,0,0,0,0,2,3,0,39,44,368,Sitio Arqueológico
20240315,2023,24,Tumbes,Zona Arqueologica Monumental Cabeza de Vaca,7,Julio,1,0,0,0,0,0,0,0,0,0,0,0,0,0,0,0,0,0,0,0,Sitio Arqueológico
20240315,2023,24,Tumbes,Zona Arqueologica Monumental Cabeza de Vaca,7,Julio,2,0,0,0,0,12,84,35,193,324,0,0,0,0,2,3,0,39,44,368,Sitio Arqueológico
20240315,2023,24,Tumbes,Zona Arqueologica Monumental Cabeza de Vaca,8,Agosto,0,0,0,0,0,39,78,27,448,592,0,0,0,0,0,84,0,0,84,676,Sitio Arqueológico
20240315,2023,24,Tumbes,Zona Arqueologica Monumental Cabeza de Vaca,8,Agosto,1,0,0,0,0,0,0,0,0,0,0,0,0,0,0,0,0,0,0,0,Sitio Arqueológico
20240315,2023,24,Tumbes,Zona Arqueologica Monumental Cabeza de Vaca,8,Agosto,2,0,0,0,0,39,78,27,448,592,0,0,0,0,0,84,0,0,84,676,Sitio Arqueológico
20240315,2023,24,Tumbes,Zona Arqueologica Monumental Cabeza de Vaca,9,Setiembre,0,0,0,0,0,24,58,31,221,334,0,0,0,0,1,25,2,66,94,428,Sitio Arqueológico
20240315,2023,24,Tumbes,Zona Arqueologica Monumental Cabeza de Vaca,9,Setiembre,1,0,0,0,0,0,0,0,0,0,0,0,0,0,0,0,0,0,0,0,Sitio Arqueológico
20240315,2023,24,Tumbes,Zona Arqueologica Monumental Cabeza de Vaca,9,Setiembre,2,0,0,0,0,24,58,31,221,334,0,0,0,0,1,25,2,66,94,428,Sitio Arqueológico
20240315,2023,24,Tumbes,Zona Arqueologica Monumental Cabeza de Vaca,10,Octubre,0,0,0,0,0,18,34,0,162,214,0,0,0,0,3,29,24,59,115,329,Sitio Arqueológico
20240315,2023,24,Tumbes,Zona Arqueologica Monumental Cabeza de Vaca,10,Octubre,1,0,0,0,0,0,0,0,0,0,0,0,0,0,0,0,0,0,0,0,Sitio Arqueológico
20240315,2023,24,Tumbes,Zona Arqueologica Monumental Cabeza de Vaca,10,Octubre,2,0,0,0,0,18,34,0,162,214,0,0,0,0,3,29,24,59,115,329,Sitio Arqueológico
20240315,2023,24,Tumbes,Zona Arqueologica Monumental Cabeza de Vaca,11,Noviembre,0,0,0,0,0,30,18,1,216,265,0,0,0,0,4,46,18,171,239,504,Sitio Arqueológico
20240315,2023,24,Tumbes,Zona Arqueologica Monumental Cabeza de Vaca,11,Noviembre,1,0,0,0,0,0,0,0,0,0,0,0,0,0,0,0,0,0,0,0,Sitio Arqueológico
20240315,2023,24,Tumbes,Zona Arqueologica Monumental Cabeza de Vaca,11,Noviembre,2,0,0,0,0,30,18,1,216,265,0,0,0,0,4,46,18,171,239,504,Sitio Arqueológico
20240315,2023,24,Tumbes,Zona Arqueologica Monumental Cabeza de Vaca,12,Diciembre,0,0,0,0,0,0,7,0,0,7,0,0,0,0,0,0,0,150,150,157,Sitio Arqueológico
20240315,2023,24,Tumbes,Zona Arqueologica Monumental Cabeza de Vaca,12,Diciembre,1,0,0,0,0,0,0,0,0,0,0,0,0,0,0,0,0,0,0,0,Sitio Arqueológico
20240315,2023,24,Tumbes,Zona Arqueologica Monumental Cabeza de Vaca,12,Diciembre,2,0,0,0,0,0,7,0,0,7,0,0,0,0,0,0,0,150,150,157,Sitio Arqueológico
20240315,2024,1,Amazonas,Zona Arqueologica Monumental Kuelap,1,Enero,0,12,0,0,7,271,1584,139,395,2408,0,0,0,0,0,12,0,0,12,2420,Sitio Arqueológico
20240315,2024,1,Amazonas,Zona Arqueologica Monumental Kuelap,1,Enero,1,0,0,0,0,0,303,0,0,303,0,0,0,0,0,0,0,0,0,303,Sitio Arqueológico
20240315,2024,1,Amazonas,Zona Arqueologica Monumental Kuelap,1,Enero,2,12,0,0,7,271,1887,139,395,2711,0,0,0,0,0,12,0,0,12,2723,Sitio Arqueológico
20240315,2024,1,Amazonas,Zona Arqueologica Monumental Kuelap,2,Febrero,0,6,0,0,2,396,1751,169,487,2811,0,0,0,0,0,105,0,0,105,2916,Sitio Arqueológico
20240315,2024,1,Amazonas,Zona Arqueologica Monumental Kuelap,2,Febrero,1,0,0,0,0,0,258,0,0,258,0,0,0,0,0,0,0,0,0,258,Sitio Arqueológico
20240315,2024,1,Amazonas,Zona Arqueologica Monumental Kuelap,2,Febrero,2,6,0,0,2,396,2009,169,487,3069,0,0,0,0,0,105,0,0,105,3174,Sitio Arqueológico
20240315,2024,2,Ancash,Zona Arqueologica Monumental Chavin de Huantar,1,Enero,0,0,0,0,0,586,2931,386,855,4758,0,0,0,6,68,407,52,148,681,5439,Sitio Arqueológico
20240315,2024,2,Ancash,Zona Arqueologica Monumental Chavin de Huantar,1,Enero,1,0,0,0,0,13,332,7,13,365,0,0,0,0,0,0,0,0,0,365,Sitio Arqueológico
20240315,2024,2,Ancash,Zona Arqueologica Monumental Chavin de Huantar,1,Enero,2,0,0,0,0,599,3263,393,868,5123,0,0,0,6,68,407,52,148,681,5804,Sitio Arqueológico
20240315,2024,2,Ancash,Sitio Arqueologico Pañamarca,1,Enero,0,0,0,0,0,0,51,23,20,94,0,0,0,0,3,17,10,26,56,150,Sitio Arqueológico
20240315,2024,2,Ancash,Sitio Arqueologico Pañamarca,1,Enero,1,0,0,0,0,0,0,0,0,0,0,0,0,0,0,0,0,0,0,0,Sitio Arqueológico
20240315,2024,2,Ancash,Sitio Arqueologico Pañamarca,1,Enero,2,0,0,0,0,0,51,23,20,94,0,0,0,0,3,17,10,26,56,150,Sitio Arqueológico
20240315,2024,3,Apurimac,Sitio Arqueologico Saihuite,1,Enero,0,0,0,0,0,56,315,155,54,580,0,0,0,0,1,33,9,6,49,629,Sitio Arqueológico
20240315,2024,3,Apurimac,Sitio Arqueologico Saihuite,1,Enero,1,0,0,0,0,0,0,0,0,0,0,0,0,0,0,0,0,0,0,0,Sitio Arqueológico
20240315,2024,3,Apurimac,Sitio Arqueologico Saihuite,1,Enero,2,0,0,0,0,56,315,155,54,580,0,0,0,0,1,33,9,6,49,629,Sitio Arqueológico
20240315,2024,4,Arequipa,Complejo Arqueologico Toro Muerto,1,Enero,0,0,0,0,0,0,63,8,9,80,0,0,0,0,0,14,0,2,16,96,Sitio Arqueológico
20240315,2024,4,Arequipa,Complejo Arqueologico Toro Muerto,1,Enero,1,0,0,0,0,0,0,0,0,0,0,0,0,0,0,0,0,0,0,0,Sitio Arqueológico
20240315,2024,4,Arequipa,Complejo Arqueologico Toro Muerto,1,Enero,2,0,0,0,0,0,63,8,9,80,0,0,0,0,0,14,0,2,16,96,Sitio Arqueológico
20240315,2024,4,Arequipa,Complejo Arqueologico Toro Muerto,2,Febrero,0,0,0,0,0,0,53,2,0,55,10,5,3,0,2,10,0,3,33,88,Sitio Arqueológico
20240315,2024,4,Arequipa,Complejo Arqueologico Toro Muerto,2,Febrero,1,0,0,0,0,0,0,0,0,0,0,0,0,0,0,0,0,0,0,0,Sitio Arqueológico
20240315,2024,4,Arequipa,Complejo Arqueologico Toro Muerto,2,Febrero,2,0,0,0,0,0,53,2,0,55,10,5,3,0,2,10,0,3,33,88,Sitio Arqueológico
20240315,2024,4,Arequipa,Complejo Arqueologico de Uyo Uyo,1,Enero,0,0,0,0,0,0,50,0,0,50,0,0,0,0,0,10,0,0,10,60,Sitio Arqueológico
20240315,2024,4,Arequipa,Complejo Arqueologico de Uyo Uyo,1,Enero,1,0,0,0,0,0,0,0,0,0,0,0,0,0,0,0,0,0,0,0,Sitio Arqueológico
20240315,2024,4,Arequipa,Complejo Arqueologico de Uyo Uyo,1,Enero,2,0,0,0,0,0,50,0,0,50,0,0,0,0,0,10,0,0,10,60,Sitio Arqueológico
20240315,2024,4,Arequipa,Complejo Arqueologico de Uyo Uyo,2,Febrero,0,0,0,0,0,0,32,0,53,85,0,0,0,0,0,4,0,2,6,91,Sitio Arqueológico
20240315,2024,4,Arequipa,Complejo Arqueologico de Uyo Uyo,2,Febrero,1,0,0,0,0,0,0,0,0,0,0,0,0,0,0,0,0,0,0,0,Sitio Arqueológico
20240315,2024,4,Arequipa,Complejo Arqueologico de Uyo Uyo,2,Febrero,2,0,0,0,0,0,32,0,53,85,0,0,0,0,0,4,0,2,6,91,Sitio Arqueológico
20240315,2024,5,Ayacucho,Sitio Arqueologico Intihuatana,1,Enero,0,0,0,0,0,0,1805,738,262,2805,0,0,0,0,0,123,29,39,191,2996,Sitio Arqueológico
20240315,2024,5,Ayacucho,Sitio Arqueologico Intihuatana,1,Enero,1,0,0,0,0,0,0,0,0,0,0,0,0,0,0,0,0,0,0,0,Sitio Arqueológico
20240315,2024,5,Ayacucho,Sitio Arqueologico Intihuatana,1,Enero,2,0,0,0,0,0,1805,738,262,2805,0,0,0,0,0,123,29,39,191,2996,Sitio Arqueológico
20240315,2024,6,Cajamarca,Paisaje Cultural Arqueologico Cumbemayo,1,Enero,0,0,0,0,33,446,1337,453,585,2854,0,0,0,0,31,173,40,60,304,3158,Sitio Arqueológico
20240315,2024,6,Cajamarca,Paisaje Cultural Arqueologico Cumbemayo,1,Enero,1,0,0,0,0,12,80,37,1,130,0,0,0,0,0,0,0,0,0,130,Sitio Arqueológico
20240315,2024,6,Cajamarca,Paisaje Cultural Arqueologico Cumbemayo,1,Enero,2,0,0,0,33,458,1417,490,586,2984,0,0,0,0,31,173,40,60,304,3288,Sitio Arqueológico
20240315,2024,6,Cajamarca,Paisaje Cultural Arqueologico Cumbemayo,2,Febrero,0,0,0,0,63,435,2664,655,798,4615,0,0,0,0,18,86,28,35,167,4782,Sitio Arqueológico
20240315,2024,6,Cajamarca,Paisaje Cultural Arqueologico Cumbemayo,2,Febrero,1,0,0,0,0,12,146,72,0,230,0,0,0,0,0,0,0,0,0,230,Sitio Arqueológico
20240315,2024,6,Cajamarca,Paisaje Cultural Arqueologico Cumbemayo,2,Febrero,2,0,0,0,63,447,2810,727,798,4845,0,0,0,0,18,86,28,35,167,5012,Sitio Arqueológico
20240315,2024,6,Cajamarca,Centro Arqueologico Ventanilla de Otuzco,1,Enero,0,0,0,0,67,321,3802,551,1434,6175,0,0,0,0,53,506,63,179,801,6976,Sitio Arqueológico
20240315,2024,6,Cajamarca,Centro Arqueologico Ventanilla de Otuzco,1,Enero,1,0,0,0,0,29,143,34,0,206,0,0,0,0,0,0,0,0,0,206,Sitio Arqueológico
20240315,2024,6,Cajamarca,Centro Arqueologico Ventanilla de Otuzco,1,Enero,2,0,0,0,67,350,3945,585,1434,6381,0,0,0,0,53,506,63,179,801,7182,Sitio Arqueológico
20240315,2024,6,Cajamarca,Centro Arqueologico Ventanilla de Otuzco,2,Febrero,0,0,0,0,86,816,14224,1512,3011,19649,0,0,0,4,60,451,52,156,723,20372,Sitio Arqueológico
20240315,2024,6,Cajamarca,Centro Arqueologico Ventanilla de Otuzco,2,Febrero,1,0,0,0,0,187,196,28,13,424,0,0,0,0,0,0,0,0,0,424,Sitio Arqueológico
20240315,2024,6,Cajamarca,Centro Arqueologico Ventanilla de Otuzco,2,Febrero,2,0,0,0,86,1003,14420,1540,3024,20073,0,0,0,4,60,451,52,156,723,20796,Sitio Arqueológico
20240315,2024,6,Cajamarca,Monumento Arqueologico Kuntur Wasi,1,Enero,0,0,0,0,1,6,165,75,36,283,0,0,0,0,0,25,14,7,46,329,Sitio Arqueológico
20240315,2024,6,Cajamarca,Monumento Arqueologico Kuntur Wasi,1,Enero,1,0,0,0,0,0,11,3,0,14,0,0,0,0,0,0,0,0,0,14,Sitio Arqueológico
20240315,2024,6,Cajamarca,Monumento Arqueologico Kuntur Wasi,1,Enero,2,0,0,0,1,6,176,78,36,297,0,0,0,0,0,25,14,7,46,343,Sitio Arqueológico
20240315,2024,6,Cajamarca,Monumento Arqueologico Kuntur Wasi,2,Febrero,0,0,0,0,0,16,193,76,53,338,0,0,0,0,0,3,15,21,39,377,Sitio Arqueológico
20240315,2024,6,Cajamarca,Monumento Arqueologico Kuntur Wasi,2,Febrero,1,0,0,0,0,0,6,0,0,6,0,0,0,0,0,0,0,0,0,6,Sitio Arqueológico
20240315,2024,6,Cajamarca,Monumento Arqueologico Kuntur Wasi,2,Febrero,2,0,0,0,0,16,199,76,53,344,0,0,0,0,0,3,15,21,39,383,Sitio Arqueológico
20240315,2024,8,Cusco,Parque Arqueologico Macchu Picchu (Ruta 1: Camino Inka: Piscacucho Km. 82),1,Enero,0,0,0,0,0,0,19,0,1,20,0,0,0,0,0,0,0,0,0,20,Sitio Arqueológico
20240315,2024,8,Cusco,Parque Arqueologico Macchu Picchu (Ruta 1: Camino Inka: Piscacucho Km. 82),1,Enero,1,0,0,0,0,0,1544,3,9,1556,0,0,0,0,0,0,0,0,0,1556,Sitio Arqueológico
20240315,2024,8,Cusco,Parque Arqueologico Macchu Picchu (Ruta 1: Camino Inka: Piscacucho Km. 82),1,Enero,2,0,0,0,0,0,1563,3,10,1576,0,0,0,0,0,0,0,0,0,1576,Sitio Arqueológico
20240315,2024,8,Cusco,Parque Arqueologico Macchu Picchu (Ruta 2: Camino Inka: Km. 88),1,Enero,0,0,0,0,0,0,0,0,0,0,0,0,0,0,0,0,0,0,0,0,Sitio Arqueológico
20240315,2024,8,Cusco,Parque Arqueologico Macchu Picchu (Ruta 2: Camino Inka: Km. 88),1,Enero,1,0,0,0,0,0,7,0,0,7,0,0,0,0,0,0,0,0,0,7,Sitio Arqueológico
20240315,2024,8,Cusco,Parque Arqueologico Macchu Picchu (Ruta 2: Camino Inka: Km. 88),1,Enero,2,0,0,0,0,0,7,0,0,7,0,0,0,0,0,0,0,0,0,7,Sitio Arqueológico
20240315,2024,8,Cusco,Parque Arqueologico Macchu Picchu (Ruta 5: Camino Iinka: Chanchabamba Km. 104),1,Enero,0,0,0,0,0,0,27,0,5,32,0,0,0,0,0,0,0,0,0,32,Sitio Arqueológico
20240315,2024,8,Cusco,Parque Arqueologico Macchu Picchu (Ruta 5: Camino Iinka: Chanchabamba Km. 104),1,Enero,1,0,0,0,0,0,806,14,18,838,0,0,0,0,0,0,0,0,0,838,Sitio Arqueológico
20240315,2024,8,Cusco,Parque Arqueologico Macchu Picchu (Ruta 5: Camino Iinka: Chanchabamba Km. 104),1,Enero,2,0,0,0,0,0,833,14,23,870,0,0,0,0,0,0,0,0,0,870,Sitio Arqueológico
20240315,2024,8,Cusco,Monumento Arqueologico de Raqchi,1,Enero,0,0,0,0,0,0,218,214,0,432,0,0,0,0,0,1126,228,94,1448,1880,Sitio Arqueológico
20240315,2024,8,Cusco,Monumento Arqueologico de Raqchi,1,Enero,1,0,0,0,0,0,2116,87,0,2203,0,0,0,0,0,0,0,0,0,2203,Sitio Arqueológico
20240315,2024,8,Cusco,Monumento Arqueologico de Raqchi,1,Enero,2,0,0,0,0,0,2334,301,0,2635,0,0,0,0,0,1126,228,94,1448,4083,Sitio Arqueológico
20240315,2024,8,Cusco,Monumento Arqueologico de Raqchi,2,Febrero,0,0,0,0,0,0,338,298,0,636,0,0,0,0,0,1358,450,97,1905,2541,Sitio Arqueológico
20240315,2024,8,Cusco,Monumento Arqueologico de Raqchi,2,Febrero,1,0,0,0,0,0,1890,162,0,2052,0,0,0,0,0,0,0,0,0,2052,Sitio Arqueológico
20240315,2024,8,Cusco,Monumento Arqueologico de Raqchi,2,Febrero,2,0,0,0,0,0,2228,460,0,2688,0,0,0,0,0,1358,450,97,1905,4593,Sitio Arqueológico
20240315,2024,8,Cusco,Monumento Arqueologico de Moray,1,Enero,0,0,0,0,0,699,15517,1684,161,18061,0,0,0,0,347,2117,758,145,3367,21428,Sitio Arqueológico
20240315,2024,8,Cusco,Monumento Arqueologico de Moray,1,Enero,1,0,0,0,0,1081,20483,1134,92,22790,0,0,0,0,0,0,0,0,0,22790,Sitio Arqueológico
20240315,2024,8,Cusco,Monumento Arqueologico de Moray,1,Enero,2,0,0,0,0,1780,36000,2818,253,40851,0,0,0,0,347,2117,758,145,3367,44218,Sitio Arqueológico
20240315,2024,8,Cusco,Monumento Arqueologico de Moray,2,Febrero,0,0,0,0,0,868,12588,2064,273,15793,0,0,0,0,335,2195,420,133,3083,18876,Sitio Arqueológico
20240315,2024,8,Cusco,Monumento Arqueologico de Moray,2,Febrero,1,0,0,0,0,1102,15620,1011,84,17817,0,0,0,0,0,0,0,0,0,17817,Sitio Arqueológico
20240315,2024,8,Cusco,Monumento Arqueologico de Moray,2,Febrero,2,0,0,0,0,1970,28208,3075,357,33610,0,0,0,0,335,2195,420,133,3083,36693,Sitio Arqueológico
20240315,2024,8,Cusco,Parque Arqueologico Tipon,1,Enero,0,0,0,0,0,0,3715,730,0,4445,0,0,0,0,366,1383,462,108,2319,6764,Sitio Arqueológico
20240315,2024,8,Cusco,Parque Arqueologico Tipon,1,Enero,1,0,0,0,0,0,1374,170,0,1544,0,0,0,0,0,0,0,0,0,1544,Sitio Arqueológico
20240315,2024,8,Cusco,Parque Arqueologico Tipon,1,Enero,2,0,0,0,0,0,5089,900,0,5989,0,0,0,0,366,1383,462,108,2319,8308,Sitio Arqueológico
20240315,2024,8,Cusco,Parque Arqueologico Tipon,2,Febrero,0,0,0,0,0,0,2677,461,0,3138,0,0,0,0,272,1052,365,121,1810,4948,Sitio Arqueológico
20240315,2024,8,Cusco,Parque Arqueologico Tipon,2,Febrero,1,0,0,0,0,0,1077,99,0,1176,0,0,0,0,0,0,0,0,0,1176,Sitio Arqueológico
20240315,2024,8,Cusco,Parque Arqueologico Tipon,2,Febrero,2,0,0,0,0,0,3754,560,0,4314,0,0,0,0,272,1052,365,121,1810,6124,Sitio Arqueológico
20240315,2024,8,Cusco,Parque Arqueologico Nacional de Vilcabamba (Choquequirao),1,Enero,0,0,0,0,0,0,56,117,0,173,0,0,0,0,0,6,2,0,8,181,Sitio Arqueológico
20240315,2024,8,Cusco,Parque Arqueologico Nacional de Vilcabamba (Choquequirao),1,Enero,1,0,0,0,0,0,101,16,0,117,0,0,0,0,0,0,0,0,0,117,Sitio Arqueológico
20240315,2024,8,Cusco,Parque Arqueologico Nacional de Vilcabamba (Choquequirao),1,Enero,2,0,0,0,0,0,157,133,0,290,0,0,0,0,0,6,2,0,8,298,Sitio Arqueológico
20240315,2024,8,Cusco,Parque Arqueologico Nacional de Vilcabamba (Choquequirao),2,Febrero,0,0,0,0,0,0,31,89,0,120,0,0,0,0,0,14,47,0,61,181,Sitio Arqueológico
20240315,2024,8,Cusco,Parque Arqueologico Nacional de Vilcabamba (Choquequirao),2,Febrero,1,0,0,0,0,0,92,25,0,117,0,0,0,0,0,0,0,0,0,117,Sitio Arqueológico
20240315,2024,8,Cusco,Parque Arqueologico Nacional de Vilcabamba (Choquequirao),2,Febrero,2,0,0,0,0,0,123,114,0,237,0,0,0,0,0,14,47,0,61,298,Sitio Arqueológico
20240315,2024,8,Cusco,Parque Arqueologico Machu Picchu,1,Enero,0,0,0,0,0,0,19669,667,4423,24759,0,0,0,0,0,2526,0,0,2526,27285,Sitio Arqueológico
20240315,2024,8,Cusco,Parque Arqueologico Machu Picchu,1,Enero,1,0,0,0,0,0,46352,918,2563,49833,0,0,0,0,0,0,0,0,0,49833,Sitio Arqueológico
20240315,2024,8,Cusco,Parque Arqueologico Machu Picchu,1,Enero,2,0,0,0,0,0,66021,1585,6986,74592,0,0,0,0,0,2526,0,0,2526,77118,Sitio Arqueológico
20240315,2024,8,Cusco,Santuario Historico de Machu Picchu,1,Enero,0,0,0,0,0,0,32,2,0,34,0,0,0,0,0,348,105,3,456,490,Sitio Arqueológico
20240315,2024,8,Cusco,Santuario Historico de Machu Picchu,1,Enero,1,0,0,0,0,0,77,3,0,80,0,0,0,0,0,475,10,0,485,565,Sitio Arqueológico
20240315,2024,8,Cusco,Santuario Historico de Machu Picchu,1,Enero,2,0,0,0,0,0,109,5,0,114,0,0,0,0,0,823,115,3,941,1055,Sitio Arqueológico
20240315,2024,8,Cusco,Santuario Historico de Machu Picchu,2,Febrero,0,0,0,0,0,0,9,0,0,9,0,0,0,0,0,306,93,1,400,409,Sitio Arqueológico
20240315,2024,8,Cusco,Santuario Historico de Machu Picchu,2,Febrero,1,0,0,0,0,0,87,4,0,91,0,0,0,0,0,529,9,0,538,629,Sitio Arqueológico
20240315,2024,8,Cusco,Santuario Historico de Machu Picchu,2,Febrero,2,0,0,0,0,0,96,4,0,100,0,0,0,0,0,835,102,1,938,1038,Sitio Arqueológico
20240315,2024,8,Cusco,Parque Arqueologico Macchu Picchu (Ingreso Salkantay-Paucarcancha),1,Enero,0,0,0,0,0,0,0,0,0,0,0,0,0,0,0,0,0,0,0,0,Sitio Arqueológico
20240315,2024,8,Cusco,Parque Arqueologico Macchu Picchu (Ingreso Salkantay-Paucarcancha),1,Enero,1,0,0,0,0,0,2,0,0,2,0,0,0,0,0,0,0,0,0,2,Sitio Arqueológico
20240315,2024,8,Cusco,Parque Arqueologico Macchu Picchu (Ingreso Salkantay-Paucarcancha),1,Enero,2,0,0,0,0,0,2,0,0,2,0,0,0,0,0,0,0,0,0,2,Sitio Arqueológico
20240315,2024,8,Cusco,Parque Arqueologico Macchu Picchu (Ingreso Salkantay-Paucarcancha),2,Febrero,0,0,0,0,0,0,0,0,0,0,0,0,0,0,0,0,0,0,0,0,Sitio Arqueológico
20240315,2024,8,Cusco,Parque Arqueologico Macchu Picchu (Ingreso Salkantay-Paucarcancha),2,Febrero,1,0,0,0,0,0,2,0,0,2,0,0,0,0,0,0,0,0,0,2,Sitio Arqueológico
20240315,2024,8,Cusco,Parque Arqueologico Macchu Picchu (Ingreso Salkantay-Paucarcancha),2,Febrero,2,0,0,0,0,0,2,0,0,2,0,0,0,0,0,0,0,0,0,2,Sitio Arqueológico
20240315,2024,10,Huanuco,Zona Arqueologica Monumental de Garu,1,Enero,0,0,0,0,0,0,39,0,0,39,0,0,0,0,0,6,0,0,6,45,Sitio Arqueológico
20240315,2024,10,Huanuco,Zona Arqueologica Monumental de Garu,1,Enero,1,0,0,0,0,0,0,0,0,0,0,0,0,0,0,0,0,0,0,0,Sitio Arqueológico
20240315,2024,10,Huanuco,Zona Arqueologica Monumental de Garu,1,Enero,2,0,0,0,0,0,39,0,0,39,0,0,0,0,0,6,0,0,6,45,Sitio Arqueológico
20240315,2024,10,Huanuco,Zona Arqueologica Monumental de Garu,2,Febrero,0,0,0,0,0,0,46,0,0,46,0,0,0,0,0,22,0,8,30,76,Sitio Arqueológico
20240315,2024,10,Huanuco,Zona Arqueologica Monumental de Garu,2,Febrero,1,0,0,0,0,0,0,0,0,0,0,0,0,0,0,0,0,0,0,0,Sitio Arqueológico
20240315,2024,10,Huanuco,Zona Arqueologica Monumental de Garu,2,Febrero,2,0,0,0,0,0,46,0,0,46,0,0,0,0,0,22,0,8,30,76,Sitio Arqueológico
20240315,2024,10,Huanuco,Huanucopampa,1,Enero,0,0,0,0,0,0,372,267,171,810,0,0,0,0,0,82,27,14,123,933,Sitio Arqueológico
20240315,2024,10,Huanuco,Huanucopampa,1,Enero,1,0,0,0,0,0,0,0,0,0,0,0,0,0,0,0,0,0,0,0,Sitio Arqueológico
20240315,2024,10,Huanuco,Huanucopampa,1,Enero,2,0,0,0,0,0,372,267,171,810,0,0,0,0,0,82,27,14,123,933,Sitio Arqueológico
20240315,2024,10,Huanuco,Huanucopampa,2,Febrero,0,0,0,0,0,0,281,210,87,578,0,0,0,0,0,78,16,13,107,685,Sitio Arqueológico
20240315,2024,10,Huanuco,Huanucopampa,2,Febrero,1,0,0,0,0,0,0,0,0,0,0,0,0,0,0,0,0,0,0,0,Sitio Arqueológico
20240315,2024,10,Huanuco,Huanucopampa,2,Febrero,2,0,0,0,0,0,281,210,87,578,0,0,0,0,0,78,16,13,107,685,Sitio Arqueológico
20240315,2024,11,Ica,Sitio Arqueologico Pampas de Huayuri,1,Enero,0,0,0,0,0,0,7,3,2,12,0,0,0,0,0,6,2,1,9,21,Sitio Arqueológico
20240315,2024,11,Ica,Sitio Arqueologico Pampas de Huayuri,1,Enero,1,0,0,0,0,0,0,0,0,0,0,0,0,0,0,0,0,0,0,0,Sitio Arqueológico
20240315,2024,11,Ica,Sitio Arqueologico Pampas de Huayuri,1,Enero,2,0,0,0,0,0,7,3,2,12,0,0,0,0,0,6,2,1,9,21,Sitio Arqueológico
20240315,2024,11,Ica,Sitio Arqueologico Pampas de Huayuri,2,Febrero,0,0,0,0,0,0,10,0,1,11,0,0,0,0,0,10,2,2,14,25,Sitio Arqueológico
20240315,2024,11,Ica,Sitio Arqueologico Pampas de Huayuri,2,Febrero,1,0,0,0,0,0,0,0,0,0,0,0,0,0,0,0,0,0,0,0,Sitio Arqueológico
20240315,2024,11,Ica,Sitio Arqueologico Pampas de Huayuri,2,Febrero,2,0,0,0,0,0,10,0,1,11,0,0,0,0,0,10,2,2,14,25,Sitio Arqueológico
20240315,2024,11,Ica,Monumento Arqueologico de Palpa (Lineas y Geoglifos de Sacramento),1,Enero,0,0,0,0,0,0,20,3,0,23,0,0,0,0,0,8,1,5,14,37,Sitio Arqueológico
20240315,2024,11,Ica,Monumento Arqueologico de Palpa (Lineas y Geoglifos de Sacramento),1,Enero,1,0,0,0,0,0,0,0,0,0,0,0,0,0,0,0,0,0,0,0,Sitio Arqueológico
20240315,2024,11,Ica,Monumento Arqueologico de Palpa (Lineas y Geoglifos de Sacramento),1,Enero,2,0,0,0,0,0,20,3,0,23,0,0,0,0,0,8,1,5,14,37,Sitio Arqueológico
20240315,2024,11,Ica,Monumento Arqueologico de Palpa (Lineas y Geoglifos de Sacramento),2,Febrero,0,0,0,0,0,0,30,0,8,38,0,0,0,0,0,8,2,2,12,50,Sitio Arqueológico
20240315,2024,11,Ica,Monumento Arqueologico de Palpa (Lineas y Geoglifos de Sacramento),2,Febrero,1,0,0,0,0,0,0,0,0,0,0,0,0,0,0,0,0,0,0,0,Sitio Arqueológico
20240315,2024,11,Ica,Monumento Arqueologico de Palpa (Lineas y Geoglifos de Sacramento),2,Febrero,2,0,0,0,0,0,30,0,8,38,0,0,0,0,0,8,2,2,12,50,Sitio Arqueológico
20240315,2024,11,Ica,Reserva Arqueologica Lineas y Geoglifos de Nazca,1,Enero,0,0,0,0,0,0,2862,237,2978,6077,0,0,0,0,0,205,40,150,395,6472,Sitio Arqueológico
20240315,2024,11,Ica,Reserva Arqueologica Lineas y Geoglifos de Nazca,1,Enero,1,0,0,0,0,0,3076,0,1844,4920,0,0,0,0,0,0,0,0,0,4920,Sitio Arqueológico
20240315,2024,11,Ica,Reserva Arqueologica Lineas y Geoglifos de Nazca,1,Enero,2,0,0,0,0,0,5938,237,4822,10997,0,0,0,0,0,205,40,150,395,11392,Sitio Arqueológico
20240315,2024,11,Ica,Reserva Arqueologica Lineas y Geoglifos de Nazca,2,Febrero,0,0,0,0,0,0,2761,780,2036,5577,0,0,0,0,0,135,20,55,210,5787,Sitio Arqueológico
20240315,2024,11,Ica,Reserva Arqueologica Lineas y Geoglifos de Nazca,2,Febrero,1,0,0,0,0,0,3106,83,978,4167,0,0,0,0,0,0,0,0,0,4167,Sitio Arqueológico
20240315,2024,11,Ica,Reserva Arqueologica Lineas y Geoglifos de Nazca,2,Febrero,2,0,0,0,0,0,5867,863,3014,9744,0,0,0,0,0,135,20,55,210,9954,Sitio Arqueológico
20240315,2024,13,La Libertad,Complejo Arqueologico Chan Chan (Palacio Nik-An),1,Enero,0,0,0,0,0,0,4214,1533,1627,7374,0,0,0,0,0,830,588,260,1678,9052,Sitio Arqueológico
20240315,2024,13,La Libertad,Complejo Arqueologico Chan Chan (Palacio Nik-An),1,Enero,1,0,0,0,0,0,1016,121,80,1217,0,0,0,0,0,0,0,0,0,1217,Sitio Arqueológico
20240315,2024,13,La Libertad,Complejo Arqueologico Chan Chan (Palacio Nik-An),1,Enero,2,0,0,0,0,0,5230,1654,1707,8591,0,0,0,0,0,830,588,260,1678,10269,Sitio Arqueológico
20240315,2024,13,La Libertad,Complejo Arqueologico Chan Chan (Palacio Nik-An),2,Febrero,0,0,0,0,0,0,2616,1452,969,5037,0,0,0,0,0,1008,468,537,2013,7050,Sitio Arqueológico
20240315,2024,13,La Libertad,Complejo Arqueologico Chan Chan (Palacio Nik-An),2,Febrero,1,0,0,0,0,0,440,93,23,556,0,0,0,0,0,0,0,0,0,556,Sitio Arqueológico
20240315,2024,13,La Libertad,Complejo Arqueologico Chan Chan (Palacio Nik-An),2,Febrero,2,0,0,0,0,0,3056,1545,992,5593,0,0,0,0,0,1008,468,537,2013,7606,Sitio Arqueológico
20240315,2024,13,La Libertad,Zona Arqueologica Monumental Huaca del Sol y de La Luna,1,Enero,0,0,0,0,0,0,4018,1610,1516,7144,0,0,0,0,0,388,138,91,617,7761,Sitio Arqueológico
20240315,2024,13,La Libertad,Zona Arqueologica Monumental Huaca del Sol y de La Luna,1,Enero,1,0,0,0,0,0,1576,384,79,2039,0,0,0,0,0,0,0,0,0,2039,Sitio Arqueológico
20240315,2024,13,La Libertad,Zona Arqueologica Monumental Huaca del Sol y de La Luna,1,Enero,2,0,0,0,0,0,5594,1994,1595,9183,0,0,0,0,0,388,138,91,617,9800,Sitio Arqueológico
20240315,2024,13,La Libertad,Zona Arqueologica Monumental Huaca del Sol y de La Luna,2,Febrero,0,0,0,0,0,0,3539,1334,1414,6287,0,0,0,0,0,568,109,135,812,7099,Sitio Arqueológico
20240315,2024,13,La Libertad,Zona Arqueologica Monumental Huaca del Sol y de La Luna,2,Febrero,1,0,0,0,0,0,1052,379,84,1515,0,0,0,0,0,0,0,0,0,1515,Sitio Arqueológico
20240315,2024,13,La Libertad,Zona Arqueologica Monumental Huaca del Sol y de La Luna,2,Febrero,2,0,0,0,0,0,4591,1713,1498,7802,0,0,0,0,0,568,109,135,812,8614,Sitio Arqueológico
20240315,2024,13,La Libertad,Zona Arqueologica Monumental El Brujo,1,Enero,0,0,0,0,0,0,888,528,272,1688,0,0,0,0,0,129,75,46,250,1938,Sitio Arqueológico
20240315,2024,13,La Libertad,Zona Arqueologica Monumental El Brujo,1,Enero,1,0,0,0,0,0,273,50,2,325,0,0,0,0,0,0,0,0,0,325,Sitio Arqueológico
20240315,2024,13,La Libertad,Zona Arqueologica Monumental El Brujo,1,Enero,2,0,0,0,0,0,1161,578,274,2013,0,0,0,0,0,129,75,46,250,2263,Sitio Arqueológico
20240315,2024,13,La Libertad,Zona Arqueologica Monumental El Brujo,2,Febrero,0,0,0,0,0,0,852,498,374,1724,0,0,0,0,0,219,121,93,433,2157,Sitio Arqueológico
20240315,2024,13,La Libertad,Zona Arqueologica Monumental El Brujo,2,Febrero,1,0,0,0,0,0,119,57,11,187,0,0,0,0,0,0,0,0,0,187,Sitio Arqueológico
20240315,2024,13,La Libertad,Zona Arqueologica Monumental El Brujo,2,Febrero,2,0,0,0,0,0,971,555,385,1911,0,0,0,0,0,219,121,93,433,2344,Sitio Arqueológico
20240315,2024,13,La Libertad,Sitio Arqueologico Huaca Arco Iris (Huaca El Dragon),1,Enero,0,0,0,0,0,0,0,0,0,0,0,0,0,0,0,0,0,0,0,0,Sitio Arqueológico
20240315,2024,13,La Libertad,Sitio Arqueologico Huaca Arco Iris (Huaca El Dragon),1,Enero,1,0,0,0,0,0,0,0,0,0,0,0,0,0,0,0,0,0,0,0,Sitio Arqueológico
20240315,2024,13,La Libertad,Sitio Arqueologico Huaca Arco Iris (Huaca El Dragon),1,Enero,2,0,0,0,0,0,0,0,0,0,0,0,0,0,0,0,0,0,0,0,Sitio Arqueológico
20240315,2024,13,La Libertad,Sitio Arqueologico Huaca Arco Iris (Huaca El Dragon),2,Febrero,0,0,0,0,0,0,0,0,0,0,0,0,0,0,0,0,0,0,0,0,Sitio Arqueológico
20240315,2024,13,La Libertad,Sitio Arqueologico Huaca Arco Iris (Huaca El Dragon),2,Febrero,1,0,0,0,0,0,0,0,0,0,0,0,0,0,0,0,0,0,0,0,Sitio Arqueológico
20240315,2024,13,La Libertad,Sitio Arqueologico Huaca Arco Iris (Huaca El Dragon),2,Febrero,2,0,0,0,0,0,0,0,0,0,0,0,0,0,0,0,0,0,0,0,Sitio Arqueológico
20240315,2024,14,Lambayeque,Sitio Arqueologico Cerro Ventarron,1,Enero,0,0,0,0,0,0,13,9,8,30,0,0,0,0,3,3,0,2,8,38,Sitio Arqueológico
20240315,2024,14,Lambayeque,Sitio Arqueologico Cerro Ventarron,1,Enero,1,0,0,0,0,0,7,0,0,7,0,0,0,0,0,0,0,0,0,7,Sitio Arqueológico
20240315,2024,14,Lambayeque,Sitio Arqueologico Cerro Ventarron,1,Enero,2,0,0,0,0,0,20,9,8,37,0,0,0,0,3,3,0,2,8,45,Sitio Arqueológico
20240315,2024,14,Lambayeque,Sitio Arqueologico Cerro Ventarron,2,Febrero,0,0,0,0,0,0,7,5,4,16,0,0,0,0,0,2,0,0,2,18,Sitio Arqueológico
20240315,2024,14,Lambayeque,Sitio Arqueologico Cerro Ventarron,2,Febrero,1,0,0,0,0,0,2,0,0,2,0,0,0,0,0,0,0,0,0,2,Sitio Arqueológico
20240315,2024,14,Lambayeque,Sitio Arqueologico Cerro Ventarron,2,Febrero,2,0,0,0,0,0,9,5,4,18,0,0,0,0,0,2,0,0,2,20,Sitio Arqueológico
20240315,2024,15,Lima,Sitio Arqueologico Caral,1,Enero,0,0,0,0,0,0,1037,219,452,1708,0,0,0,0,0,163,10,0,173,1881,Sitio Arqueológico
20240315,2024,15,Lima,Sitio Arqueologico Caral,1,Enero,1,0,0,0,0,0,105,20,56,181,0,0,0,0,0,0,0,0,0,181,Sitio Arqueológico
20240315,2024,15,Lima,Sitio Arqueologico Caral,1,Enero,2,0,0,0,0,0,1142,239,508,1889,0,0,0,0,0,163,10,0,173,2062,Sitio Arqueológico
20240315,2024,15,Lima,Sitio Arqueologico Caral,2,Febrero,0,0,0,0,0,0,831,221,472,1524,0,0,0,0,0,178,67,3,248,1772,Sitio Arqueológico
20240315,2024,15,Lima,Sitio Arqueologico Caral,2,Febrero,1,0,0,0,0,0,94,3,25,122,0,0,0,0,0,3,2,2,7,129,Sitio Arqueológico
20240315,2024,15,Lima,Sitio Arqueologico Caral,2,Febrero,2,0,0,0,0,0,925,224,497,1646,0,0,0,0,0,181,69,5,255,1901,Sitio Arqueológico
20240315,2024,15,Lima,Zona Arqueologica de Huaycan de Cieneguilla,1,Enero,0,0,0,0,0,121,374,39,52,586,0,0,0,0,16,42,0,10,68,654,Sitio Arqueológico
20240315,2024,15,Lima,Zona Arqueologica de Huaycan de Cieneguilla,1,Enero,1,0,0,0,0,1,2,0,0,3,0,0,0,0,0,0,0,0,0,3,Sitio Arqueológico
20240315,2024,15,Lima,Zona Arqueologica de Huaycan de Cieneguilla,1,Enero,2,0,0,0,0,122,376,39,52,589,0,0,0,0,16,42,0,10,68,657,Sitio Arqueológico
20240315,2024,15,Lima,Complejo Arqueologico Mateo Salado,1,Enero,0,0,0,0,0,8,36,21,18,83,0,0,0,0,3,44,0,14,61,144,Sitio Arqueológico
20240315,2024,15,Lima,Complejo Arqueologico Mateo Salado,1,Enero,1,0,0,0,0,8,191,0,6,205,0,0,0,0,0,0,0,0,0,205,Sitio Arqueológico
20240315,2024,15,Lima,Complejo Arqueologico Mateo Salado,1,Enero,2,0,0,0,0,16,227,21,24,288,0,0,0,0,3,44,0,14,61,349,Sitio Arqueológico
20240315,2024,15,Lima,Complejo Arqueologico Mateo Salado,2,Febrero,0,0,0,0,0,6,33,2,45,86,0,0,0,0,4,44,0,23,71,157,Sitio Arqueológico
20240315,2024,15,Lima,Complejo Arqueologico Mateo Salado,2,Febrero,1,0,0,0,0,3,172,0,2,177,0,0,0,0,0,0,0,0,0,177,Sitio Arqueológico
20240315,2024,15,Lima,Complejo Arqueologico Mateo Salado,2,Febrero,2,0,0,0,0,9,205,2,47,263,0,0,0,0,4,44,0,23,71,334,Sitio Arqueológico
20240315,2024,18,Moquegua,Sitio Arqueologico de Cerro Baul,1,Enero,0,0,0,0,0,0,0,0,0,0,0,0,0,0,0,0,0,0,0,0,Sitio Arqueológico
20240315,2024,18,Moquegua,Sitio Arqueologico de Cerro Baul,1,Enero,1,0,0,0,0,0,0,0,0,0,0,0,0,0,0,0,0,0,0,0,Sitio Arqueológico
20240315,2024,18,Moquegua,Sitio Arqueologico de Cerro Baul,1,Enero,2,0,0,0,0,0,0,0,0,0,0,0,0,0,0,0,0,0,0,0,Sitio Arqueológico
20240315,2024,18,Moquegua,Sitio Arqueologico de Cerro Baul,2,Febrero,0,0,0,0,0,0,0,0,0,0,0,0,0,0,0,0,0,0,0,0,Sitio Arqueológico
20240315,2024,18,Moquegua,Sitio Arqueologico de Cerro Baul,2,Febrero,1,0,0,0,0,0,0,0,0,0,0,0,0,0,0,0,0,0,0,0,Sitio Arqueológico
20240315,2024,18,Moquegua,Sitio Arqueologico de Cerro Baul,2,Febrero,2,0,0,0,0,0,0,0,0,0,0,0,0,0,0,0,0,0,0,0,Sitio Arqueológico
20240315,2024,21,Puno,Monumento Arqueologico de Cutimbo,1,Enero,0,0,0,0,0,0,32,64,5,101,0,0,0,0,0,0,0,0,0,101,Sitio Arqueológico
20240315,2024,21,Puno,Monumento Arqueologico de Cutimbo,1,Enero,1,0,0,0,0,0,5,0,0,5,0,0,0,0,0,0,0,0,0,5,Sitio Arqueológico
20240315,2024,21,Puno,Monumento Arqueologico de Cutimbo,1,Enero,2,0,0,0,0,0,37,64,5,106,0,0,0,0,0,0,0,0,0,106,Sitio Arqueológico
20240315,2024,21,Puno,Sitio Arqueologico de Sillustani,1,Enero,0,0,0,0,0,0,2649,604,592,3845,0,0,0,0,0,388,108,99,595,4440,Sitio Arqueológico
20240315,2024,21,Puno,Sitio Arqueologico de Sillustani,1,Enero,1,0,0,0,0,0,1076,0,0,1076,0,0,0,0,0,0,0,0,0,1076,Sitio Arqueológico
20240315,2024,21,Puno,Sitio Arqueologico de Sillustani,1,Enero,2,0,0,0,0,0,3725,604,592,4921,0,0,0,0,0,388,108,99,595,5516,Sitio Arqueológico
20240315,2024,24,Tumbes,Zona Arqueologica Monumental Cabeza de Vaca,1,Enero,0,0,0,0,0,11,55,3,10,79,0,0,0,0,1,12,0,35,48,127,Sitio Arqueológico
20240315,2024,24,Tumbes,Zona Arqueologica Monumental Cabeza de Vaca,1,Enero,1,0,0,0,0,0,0,0,0,0,0,0,0,0,0,0,0,0,0,0,Sitio Arqueológico
20240315,2024,24,Tumbes,Zona Arqueologica Monumental Cabeza de Vaca,1,Enero,2,0,0,0,0,11,55,3,10,79,0,0,0,0,1,12,0,35,48,127,Sitio Arqueológico
20240315,2024,24,Tumbes,Zona Arqueologica Monumental Cabeza de Vaca,2,Febrero,0,0,0,0,0,7,34,0,6,47,0,0,0,0,4,64,24,24,116,163,Sitio Arqueológico
20240315,2024,24,Tumbes,Zona Arqueologica Monumental Cabeza de Vaca,2,Febrero,1,0,0,0,0,0,6,0,3,9,0,0,0,0,0,0,0,0,0,9,Sitio Arqueológico
20240315,2024,24,Tumbes,Zona Arqueologica Monumental Cabeza de Vaca,2,Febrero,2,0,0,0,0,7,40,0,9,56,0,0,0,0,4,64,24,24,116,172,Sitio Arqueológico
